year,season,time,total_pedestrian,to_manhattan,to_brooklyn,weather,event
2019,Spring,12:00:00 AM,3,3,0,,
2019,Winter,10:00:00 PM,10,9,1,cloudy,
2019,Winter,11:00:00 PM,2,0,2,cloudy,
2019,Winter,09:00:00 PM,12,0,12,cloudy,
2019,Spring,03:00:00 AM,1,0,1,clear night,
2019,Winter,02:00:00 PM,3171,1685,1486,clear day,Christmas Day
2019,Winter,09:00:00 PM,13,5,8,partly cloudy night,
2019,Winter,04:00:00 AM,0,0,0,cloudy,
2019,Winter,09:00:00 PM,9,7,2,partly cloudy night,
2019,Summer,09:00:00 AM,520,281,239,partly cloudy day,
2019,Summer,02:00:00 AM,2,1,1,clear night,
2019,Fall,06:00:00 AM,125,66,59,clear night,
2019,Summer,07:00:00 PM,2627,1142,1485,partly cloudy day,
2019,Spring,03:00:00 PM,1601,730,871,partly cloudy day,
2019,Winter,09:00:00 PM,22,21,1,cloudy,
2019,Spring,09:00:00 PM,36,15,21,cloudy,
2019,Winter,03:00:00 PM,2708,1447,1261,clear day,
2019,Summer,01:00:00 PM,2270,1020,1250,partly cloudy day,
2019,Winter,02:00:00 AM,3,1,2,partly cloudy night,
2019,Spring,09:00:00 AM,1151,666,485,clear day,
2019,Summer,01:00:00 PM,1557,707,850,partly cloudy day,
2019,Summer,10:00:00 PM,79,65,14,partly cloudy night,
2019,Winter,04:00:00 AM,0,0,0,cloudy,
2019,Spring,02:00:00 PM,1805,754,1051,cloudy,
2019,Fall,08:00:00 AM,442,188,254,clear day,
2019,Spring,02:00:00 PM,2826,1425,1401,cloudy,
2019,Fall,01:00:00 PM,1554,637,917,partly cloudy day,
2019,Summer,09:00:00 AM,610,386,224,partly cloudy day,
2019,Summer,12:00:00 PM,1773,894,879,partly cloudy day,
2019,Spring,02:00:00 AM,0,0,0,clear night,
2019,Winter,01:00:00 AM,0,0,0,partly cloudy night,
2019,Spring,01:00:00 PM,1532,726,806,partly cloudy day,
2019,Summer,01:00:00 AM,4,2,2,partly cloudy night,
2019,Spring,04:00:00 AM,0,0,0,cloudy,
2019,Winter,05:00:00 PM,1120,449,671,partly cloudy day,
2019,Fall,04:00:00 AM,0,0,0,clear night,
2019,Summer,12:00:00 AM,8,4,4,clear night,
2019,Fall,01:00:00 PM,1080,463,617,partly cloudy day,
2019,Summer,07:00:00 AM,186,83,103,cloudy,
2019,Summer,02:00:00 AM,0,0,0,clear night,
2019,Spring,07:00:00 AM,199,70,129,clear night,
2019,Summer,10:00:00 PM,23,14,9,partly cloudy night,
2019,Winter,05:00:00 PM,741,409,332,clear day,
2019,Spring,02:00:00 PM,1394,609,785,clear day,
2019,Spring,06:00:00 AM,58,36,22,partly cloudy night,
2019,Fall,08:00:00 PM,41,38,3,partly cloudy night,
2019,Summer,09:00:00 PM,27,16,11,partly cloudy night,
2019,Summer,08:00:00 AM,482,197,285,clear day,
2019,Winter,07:00:00 PM,21,19,2,clear night,
2019,Fall,10:00:00 AM,1275,722,553,clear day,
2019,Summer,01:00:00 PM,2023,868,1155,partly cloudy day,
2019,Fall,03:00:00 AM,0,0,0,partly cloudy night,
2019,Winter,05:00:00 AM,0,0,0,clear night,
2019,Winter,01:00:00 AM,3,0,3,clear night,
2019,Summer,07:00:00 PM,1473,823,650,clear day,
2019,Summer,04:00:00 AM,0,0,0,partly cloudy night,
2019,Fall,09:00:00 PM,20,14,6,partly cloudy night,
2019,Summer,05:00:00 PM,1773,936,837,partly cloudy day,
2019,Fall,07:00:00 PM,38,27,11,partly cloudy night,
2019,Spring,08:00:00 PM,126,75,51,partly cloudy night,
2019,Summer,02:00:00 PM,1757,771,986,cloudy,
2019,Fall,11:00:00 PM,56,48,8,cloudy,
2019,Winter,04:00:00 PM,160,81,79,fog,
2019,Fall,02:00:00 PM,1329,619,710,partly cloudy day,
2019,Spring,05:00:00 AM,1,0,1,partly cloudy night,
2019,Fall,12:00:00 AM,13,11,2,cloudy,Halloween
2019,Winter,09:00:00 PM,12,0,12,rain,
2019,Winter,05:00:00 AM,4,1,3,clear night,
2019,Summer,12:00:00 AM,2,0,2,clear night,
2019,Spring,08:00:00 AM,535,219,316,clear day,
2019,Winter,01:00:00 AM,0,0,0,cloudy,
2019,Summer,11:00:00 AM,1779,810,969,partly cloudy day,
2019,Winter,06:00:00 PM,77,62,15,partly cloudy night,
2019,Fall,09:00:00 PM,65,50,15,partly cloudy night,
2019,Fall,07:00:00 PM,592,217,375,partly cloudy night,
2019,Spring,09:00:00 AM,568,262,306,cloudy,
2019,Spring,11:00:00 PM,1,0,1,clear night,St. Patrick's Day
2019,Winter,02:00:00 PM,1286,1286,0,clear day,
2019,Winter,04:00:00 PM,1439,622,817,partly cloudy day,Presidents' Day (regional holiday)
2019,Spring,03:00:00 PM,3514,1854,1660,clear day,
2019,Spring,02:00:00 AM,0,0,0,clear night,
2019,Fall,05:00:00 PM,71,62,9,clear night,
2019,Summer,11:00:00 AM,1642,900,742,partly cloudy day,
2019,Spring,05:00:00 AM,29,20,9,cloudy,
2019,Summer,09:00:00 PM,139,66,73,rain,
2019,Summer,10:00:00 AM,1683,981,702,cloudy,
2019,Spring,09:00:00 AM,686,353,333,partly cloudy day,
2019,Winter,04:00:00 PM,668,305,363,partly cloudy day,
2019,Summer,09:00:00 PM,66,29,37,partly cloudy night,
2019,Fall,01:00:00 AM,0,0,0,partly cloudy night,Labor Day
2019,Summer,12:00:00 AM,8,3,5,cloudy,
2019,Spring,01:00:00 PM,1641,749,892,partly cloudy day,
2019,Winter,05:00:00 AM,0,0,0,rain,
2019,Spring,08:00:00 AM,311,108,203,cloudy,
2019,Spring,08:00:00 AM,665,273,392,partly cloudy day,
2019,Spring,09:00:00 PM,5,0,5,cloudy,
2019,Summer,12:00:00 AM,11,4,7,partly cloudy night,
2019,Summer,01:00:00 AM,0,0,0,partly cloudy night,
2019,Spring,07:00:00 PM,1189,439,750,clear day,
2019,Spring,02:00:00 PM,1694,847,847,rain,
2019,Fall,05:00:00 AM,0,0,0,rain,
2019,Summer,01:00:00 PM,2152,975,1177,partly cloudy day,
2019,Spring,03:00:00 PM,1597,753,844,clear day,
2019,Summer,12:00:00 AM,5,3,2,clear night,
2019,Winter,05:00:00 PM,70,65,5,cloudy,
2019,Fall,04:00:00 AM,0,0,0,clear night,Black Friday
2019,Fall,02:00:00 AM,0,0,0,partly cloudy night,
2019,Fall,08:00:00 AM,132,48,84,rain,
2019,Fall,04:00:00 PM,1895,889,1006,partly cloudy day,
2019,Spring,01:00:00 AM,36,25,11,partly cloudy night,Daylight Saving Time starts
2019,Fall,03:00:00 PM,1916,908,1008,clear day,
2019,Spring,06:00:00 PM,703,371,332,cloudy,
2019,Winter,07:00:00 AM,180,92,88,clear night,
2019,Fall,10:00:00 AM,1000,524,476,partly cloudy day,
2019,Spring,08:00:00 AM,284,106,178,clear day,
2019,Summer,04:00:00 AM,0,0,0,partly cloudy night,
2019,Summer,02:00:00 PM,1299,583,716,partly cloudy day,
2019,Summer,01:00:00 AM,2,1,1,clear night,
2019,Winter,10:00:00 PM,30,29,1,clear night,
2019,Winter,08:00:00 AM,260,102,158,cloudy,
2019,Fall,04:00:00 PM,2352,1031,1321,partly cloudy day,
2019,Summer,01:00:00 PM,2387,1005,1382,partly cloudy day,
2019,Fall,04:00:00 AM,0,0,0,partly cloudy night,
2019,Summer,06:00:00 AM,139,48,91,cloudy,
2019,Spring,03:00:00 PM,1833,840,993,partly cloudy day,
2019,Spring,03:00:00 PM,1954,890,1064,clear day,
2019,Spring,03:00:00 AM,0,0,0,cloudy,
2019,Spring,07:00:00 AM,137,55,82,partly cloudy day,
2019,Fall,04:00:00 PM,2056,887,1169,cloudy,
2019,Summer,06:00:00 PM,1323,733,590,cloudy,
2019,Summer,05:00:00 PM,2337,1043,1294,clear day,
2019,Winter,11:00:00 PM,8,4,4,partly cloudy night,
2019,Summer,03:00:00 AM,0,0,0,cloudy,
2019,Summer,06:00:00 AM,150,70,80,clear day,
2019,Spring,11:00:00 PM,0,0,0,partly cloudy night,
2019,Fall,04:00:00 PM,2239,1073,1166,partly cloudy day,
2019,Winter,01:00:00 AM,1,0,1,partly cloudy night,
2019,Winter,11:00:00 AM,522,292,230,clear day,
2019,Summer,06:00:00 PM,1044,598,446,partly cloudy day,
2019,Summer,01:00:00 AM,3,1,2,partly cloudy night,
2019,Summer,02:00:00 PM,1877,885,992,cloudy,
2019,Spring,01:00:00 AM,2,0,2,partly cloudy night,
2019,Fall,10:00:00 PM,11,6,5,partly cloudy night,
2019,Fall,03:00:00 AM,0,0,0,clear night,
2019,Spring,02:00:00 AM,1,0,1,clear night,
2019,Spring,11:00:00 PM,7,0,7,cloudy,
2019,Fall,01:00:00 AM,1,0,1,clear night,
2019,Winter,01:00:00 AM,2,1,1,partly cloudy night,
2019,Winter,05:00:00 PM,30,23,7,partly cloudy night,
2019,Spring,12:00:00 PM,1600,702,898,cloudy,
2019,Spring,08:00:00 PM,261,157,104,partly cloudy night,
2019,Winter,01:00:00 PM,1958,856,1102,rain,
2019,Fall,04:00:00 PM,2358,1006,1352,clear day,
2019,Winter,06:00:00 AM,69,42,27,partly cloudy night,
2019,Summer,04:00:00 PM,3116,1370,1746,partly cloudy day,
2019,Fall,07:00:00 PM,608,264,344,clear night,
2019,Summer,07:00:00 AM,263,120,143,clear day,
2019,Winter,09:00:00 PM,78,76,2,cloudy,
2019,Spring,05:00:00 PM,1926,897,1029,partly cloudy day,
2019,Summer,06:00:00 PM,1511,848,663,partly cloudy day,
2019,Winter,09:00:00 AM,396,237,159,partly cloudy day,
2019,Spring,09:00:00 PM,32,11,21,partly cloudy night,
2019,Summer,02:00:00 AM,1,0,1,clear night,
2019,Winter,09:00:00 PM,5,4,1,clear night,
2019,Winter,04:00:00 AM,1,0,1,clear night,
2019,Summer,07:00:00 PM,2296,945,1351,partly cloudy day,
2019,Winter,11:00:00 PM,3,0,3,rain,
2019,Winter,09:00:00 AM,257,123,134,clear day,
2019,Fall,03:00:00 AM,1,0,1,clear night,
2019,Fall,08:00:00 PM,61,60,1,clear night,
2019,Summer,02:00:00 PM,1589,663,926,rain,
2019,Fall,09:00:00 PM,59,54,5,clear night,
2019,Winter,02:00:00 AM,1,0,1,clear night,
2019,Spring,03:00:00 PM,3524,1647,1877,clear day,
2019,Fall,09:00:00 PM,3,2,1,partly cloudy night,
2019,Spring,01:00:00 PM,1481,676,805,clear day,
2019,Winter,10:00:00 AM,900,524,376,partly cloudy day,
2019,Spring,03:00:00 AM,0,0,0,cloudy,
2019,Winter,05:00:00 AM,1,0,1,cloudy,
2019,Spring,04:00:00 PM,1632,739,893,cloudy,
2019,Spring,05:00:00 AM,28,12,16,cloudy,
2019,Fall,03:00:00 PM,3335,1431,1904,partly cloudy day,
2019,Summer,04:00:00 AM,0,0,0,partly cloudy night,
2019,Fall,03:00:00 PM,2353,1099,1254,partly cloudy day,
2019,Winter,07:00:00 PM,15,14,1,partly cloudy night,
2019,Summer,11:00:00 PM,1,0,1,cloudy,
2019,Summer,02:00:00 PM,2818,1218,1600,partly cloudy day,
2019,Fall,11:00:00 PM,9,1,8,clear night,
2019,Spring,03:00:00 AM,1,0,1,rain,
2019,Summer,02:00:00 PM,3157,1394,1763,partly cloudy day,
2019,Summer,12:00:00 PM,2521,1174,1347,partly cloudy day,
2019,Spring,03:00:00 AM,2,1,1,partly cloudy night,
2019,Fall,05:00:00 AM,0,0,0,clear night,
2019,Winter,02:00:00 PM,959,416,543,clear day,
2019,Fall,09:00:00 PM,8,0,8,clear night,
2019,Spring,02:00:00 AM,1,0,1,partly cloudy night,
2019,Spring,03:00:00 AM,0,0,0,partly cloudy night,Tax Day
2019,Fall,08:00:00 AM,368,217,151,partly cloudy day,
2019,Spring,03:00:00 AM,1,0,1,cloudy,
2019,Spring,08:00:00 AM,311,196,115,partly cloudy day,
2019,Summer,09:00:00 AM,881,548,333,partly cloudy day,
2019,Winter,01:00:00 PM,354,138,216,sleet,
2019,Winter,03:00:00 AM,0,0,0,clear night,
2019,Winter,02:00:00 AM,0,0,0,clear night,
2019,Spring,02:00:00 PM,2928,1354,1574,clear day,
2019,Winter,12:00:00 PM,663,374,289,rain,
2019,Winter,09:00:00 AM,269,142,127,snow,
2019,Spring,03:00:00 PM,2745,1181,1564,clear day,
2019,Summer,09:00:00 PM,43,17,26,clear night,
2019,Fall,01:00:00 AM,1,0,1,cloudy,
2019,Spring,05:00:00 PM,2513,1256,1257,partly cloudy day,
2019,Fall,04:00:00 AM,0,0,0,partly cloudy night,
2019,Summer,07:00:00 AM,279,136,143,partly cloudy day,
2019,Fall,02:00:00 AM,1,0,1,clear night,
2019,Fall,03:00:00 AM,0,0,0,cloudy,
2019,Winter,06:00:00 PM,105,97,8,clear night,
2019,Spring,12:00:00 AM,2,0,2,cloudy,
2019,Fall,04:00:00 PM,1354,540,814,cloudy,
2019,Fall,11:00:00 PM,4,4,0,partly cloudy night,
2019,Summer,06:00:00 PM,1973,1087,886,clear day,
2019,Winter,05:00:00 AM,0,0,0,clear night,
2019,Fall,03:00:00 AM,1,0,1,cloudy,
2019,Winter,12:00:00 AM,144,24,120,rain,New Year's Day
2019,Summer,03:00:00 PM,1395,708,687,cloudy,
2019,Fall,05:00:00 AM,0,0,0,clear night,
2019,Fall,02:00:00 AM,2,1,1,clear night,
2019,Fall,04:00:00 PM,703,251,452,cloudy,
2019,Winter,05:00:00 AM,1,0,1,cloudy,
2019,Winter,03:00:00 AM,0,0,0,clear night,
2019,Fall,06:00:00 PM,1084,388,696,cloudy,
2019,Fall,06:00:00 PM,1885,1062,823,partly cloudy day,
2019,Winter,02:00:00 PM,255,145,110,rain,
2019,Spring,03:00:00 AM,0,0,0,rain,
2019,Summer,02:00:00 AM,0,0,0,clear night,
2019,Summer,09:00:00 PM,19,8,11,partly cloudy night,
2019,Winter,10:00:00 PM,5,3,2,cloudy,
2019,Fall,11:00:00 PM,55,53,2,clear night,
2019,Winter,02:00:00 AM,1,0,1,partly cloudy night,
2019,Winter,09:00:00 AM,0,0,0,clear day,
2019,Spring,02:00:00 PM,1842,796,1046,cloudy,
2019,Winter,03:00:00 AM,0,0,0,cloudy,
2019,Summer,12:00:00 PM,1590,674,916,partly cloudy day,
2019,Fall,02:00:00 PM,1900,818,1082,partly cloudy day,
2019,Summer,12:00:00 AM,13,7,6,clear night,
2019,Fall,06:00:00 PM,786,413,373,partly cloudy day,
2019,Fall,01:00:00 PM,798,341,457,rain,Halloween
2019,Winter,06:00:00 PM,124,119,5,clear night,
2019,Summer,05:00:00 AM,9,4,5,rain,
2019,Winter,06:00:00 PM,6,5,1,partly cloudy night,New Year's Eve
2019,Spring,06:00:00 PM,1563,679,884,clear day,St. Patrick's Day
2019,Fall,03:00:00 AM,0,0,0,clear night,
2019,Fall,02:00:00 PM,2587,1058,1529,partly cloudy day,
2019,Winter,11:00:00 PM,15,15,0,cloudy,
2019,Fall,11:00:00 PM,8,5,3,clear night,
2019,Spring,12:00:00 PM,2341,1231,1110,clear day,
2019,Summer,02:00:00 PM,1570,736,834,partly cloudy day,
2019,Spring,06:00:00 AM,29,25,4,partly cloudy night,
2019,Summer,12:00:00 AM,28,22,6,clear night,
2019,Summer,07:00:00 PM,1990,1033,957,partly cloudy day,
2019,Fall,02:00:00 PM,1456,690,766,clear day,
2019,Winter,04:00:00 PM,2111,910,1201,clear day,
2019,Winter,12:00:00 PM,1321,479,842,partly cloudy day,
2019,Fall,06:00:00 AM,116,81,35,clear night,
2019,Spring,01:00:00 PM,819,379,440,partly cloudy day,
2019,Spring,12:00:00 AM,14,14,0,rain,
2019,Fall,12:00:00 PM,1787,820,967,clear day,Veterans Day
2019,Spring,06:00:00 PM,128,51,77,partly cloudy night,
2019,Summer,08:00:00 AM,543,233,310,partly cloudy day,
2019,Winter,03:00:00 PM,2566,1206,1360,clear day,
2019,Winter,06:00:00 AM,46,32,14,clear night,
2019,Spring,04:00:00 AM,0,0,0,cloudy,
2019,Spring,06:00:00 AM,35,29,6,partly cloudy night,
2019,Winter,01:00:00 AM,2,1,1,partly cloudy night,Martin Luther King Jr. Day
2019,Summer,02:00:00 PM,2720,1124,1596,clear day,
2019,Winter,04:00:00 PM,897,420,477,clear day,
2019,Fall,04:00:00 PM,2192,1044,1148,cloudy,
2019,Spring,06:00:00 PM,1576,784,792,clear day,
2019,Spring,11:00:00 AM,1220,576,644,cloudy,
2019,Spring,07:00:00 AM,186,71,115,clear night,
2019,Summer,08:00:00 AM,499,161,338,clear day,
2019,Winter,12:00:00 AM,17,17,0,clear night,
2019,Summer,08:00:00 PM,571,225,346,partly cloudy night,
2019,Spring,01:00:00 PM,1598,641,957,clear day,
2019,Summer,11:00:00 AM,1057,577,480,cloudy,
2019,Spring,06:00:00 AM,158,79,79,clear day,
2019,Fall,10:00:00 PM,56,48,8,partly cloudy night,
2019,Summer,11:00:00 AM,1832,882,950,clear day,
2019,Fall,04:00:00 PM,949,398,551,clear day,
2019,Summer,06:00:00 AM,185,84,101,partly cloudy night,
2019,Fall,09:00:00 AM,521,263,258,cloudy,
2019,Spring,10:00:00 PM,22,0,22,clear night,
2019,Spring,05:00:00 PM,223,109,114,rain,
2019,Winter,12:00:00 AM,17,9,8,cloudy,
2019,Winter,05:00:00 PM,1035,451,584,partly cloudy day,
2019,Fall,12:00:00 PM,2328,1145,1183,clear day,
2019,Winter,02:00:00 AM,3,1,2,partly cloudy night,
2019,Fall,06:00:00 PM,1657,993,664,clear day,
2019,Fall,10:00:00 PM,35,13,22,partly cloudy night,
2019,Summer,09:00:00 AM,639,305,334,clear day,
2019,Fall,11:00:00 AM,1225,577,648,clear day,
2019,Fall,08:00:00 AM,449,199,250,clear day,
2019,Fall,11:00:00 PM,33,0,33,cloudy,
2019,Winter,04:00:00 PM,172,109,63,rain,
2019,Winter,11:00:00 AM,788,387,401,cloudy,
2019,Summer,06:00:00 AM,66,40,26,rain,Father's Day
2019,Fall,03:00:00 PM,2286,1060,1226,partly cloudy day,
2019,Fall,03:00:00 PM,1900,818,1082,cloudy,
2019,Summer,10:00:00 AM,1020,611,409,clear day,
2019,Winter,07:00:00 PM,142,126,16,clear night,
2019,Summer,05:00:00 AM,61,29,32,cloudy,
2019,Fall,01:00:00 PM,2015,856,1159,clear day,
2019,Winter,06:00:00 AM,24,16,8,rain,Presidents' Day (regional holiday)
2019,Spring,05:00:00 AM,0,0,0,clear night,
2019,Spring,04:00:00 PM,1702,814,888,partly cloudy day,Tax Day
2019,Winter,06:00:00 AM,16,10,6,partly cloudy night,
2019,Spring,12:00:00 AM,25,23,2,cloudy,Cinco de Mayo
2019,Winter,06:00:00 PM,60,55,5,partly cloudy night,
2019,Summer,08:00:00 AM,447,175,272,clear day,
2019,Fall,12:00:00 AM,0,0,0,clear night,
2019,Fall,12:00:00 PM,1588,647,941,partly cloudy day,
2019,Spring,12:00:00 AM,3,2,1,partly cloudy night,
2019,Fall,08:00:00 AM,397,154,243,clear day,
2019,Winter,01:00:00 AM,0,0,0,clear night,
2019,Spring,04:00:00 AM,0,0,0,rain,
2019,Winter,09:00:00 PM,2,1,1,partly cloudy night,
2019,Spring,02:00:00 AM,0,0,0,cloudy,
2019,Fall,11:00:00 AM,818,373,445,clear day,
2019,Winter,04:00:00 PM,1215,545,670,cloudy,
2019,Spring,05:00:00 AM,0,0,0,cloudy,
2019,Fall,07:00:00 PM,5,2,3,cloudy,Thanksgiving Day
2019,Fall,09:00:00 AM,927,568,359,partly cloudy day,
2019,Spring,12:00:00 PM,2386,1111,1275,cloudy,
2019,Fall,02:00:00 PM,1712,729,983,cloudy,
2019,Spring,12:00:00 PM,1318,594,724,clear day,
2019,Summer,05:00:00 AM,38,19,19,partly cloudy night,
2019,Winter,02:00:00 PM,1200,511,689,clear day,
2019,Winter,07:00:00 PM,34,25,9,cloudy,
2019,Spring,04:00:00 PM,1461,654,807,cloudy,
2019,Summer,05:00:00 PM,2110,1069,1041,partly cloudy day,
2019,Fall,03:00:00 AM,2,1,1,cloudy,
2019,Fall,08:00:00 AM,297,120,177,cloudy,
2019,Spring,05:00:00 AM,63,47,16,partly cloudy night,
2019,Winter,03:00:00 AM,1,0,1,cloudy,
2019,Summer,08:00:00 AM,395,194,201,partly cloudy day,
2019,Summer,02:00:00 AM,0,0,0,clear night,
2019,Fall,01:00:00 PM,2180,959,1221,partly cloudy day,Daylight Saving Time ends
2019,Fall,06:00:00 AM,49,29,20,partly cloudy night,
2019,Fall,04:00:00 AM,0,0,0,partly cloudy night,
2019,Summer,12:00:00 PM,2354,1133,1221,partly cloudy day,
2019,Winter,10:00:00 AM,558,306,252,rain,
2019,Winter,09:00:00 AM,556,313,243,clear day,
2019,Fall,12:00:00 PM,3001,1416,1585,partly cloudy day,
2019,Fall,04:00:00 PM,1644,777,867,clear day,
2019,Summer,12:00:00 PM,2913,1336,1577,partly cloudy day,
2019,Summer,07:00:00 PM,1884,982,902,partly cloudy day,
2019,Summer,06:00:00 AM,162,82,80,partly cloudy night,
2019,Winter,11:00:00 AM,519,249,270,cloudy,
2019,Winter,10:00:00 AM,177,89,88,clear day,
2019,Summer,07:00:00 PM,723,298,425,cloudy,
2019,Winter,06:00:00 PM,82,35,47,partly cloudy night,
2019,Spring,10:00:00 AM,970,487,483,clear day,
2019,Winter,01:00:00 AM,0,0,0,partly cloudy night,
2019,Winter,12:00:00 PM,0,0,0,partly cloudy day,
2019,Fall,04:00:00 AM,0,0,0,cloudy,Columbus Day (regional holiday)
2019,Spring,11:00:00 PM,17,0,17,clear night,
2019,Spring,06:00:00 AM,34,13,21,rain,
2019,Fall,06:00:00 PM,2203,897,1306,cloudy,
2019,Fall,03:00:00 PM,3031,1391,1640,partly cloudy day,
2019,Winter,12:00:00 PM,1142,553,589,clear day,Valentine's Day
2019,Summer,06:00:00 PM,455,242,213,fog,
2019,Fall,08:00:00 AM,422,164,258,clear day,
2019,Fall,12:00:00 AM,29,0,29,clear night,
2019,Summer,03:00:00 PM,1664,676,988,partly cloudy day,
2019,Spring,12:00:00 AM,20,17,3,clear night,
2019,Summer,05:00:00 PM,2042,1011,1031,clear day,
2019,Spring,10:00:00 AM,794,437,357,clear day,
2019,Fall,10:00:00 AM,844,453,391,partly cloudy day,
2019,Summer,08:00:00 AM,313,128,185,cloudy,
2019,Summer,06:00:00 PM,1704,1010,694,partly cloudy day,
2019,Spring,04:00:00 AM,0,0,0,partly cloudy night,Easter Sunday
2019,Fall,11:00:00 PM,3,2,1,cloudy,
2019,Summer,03:00:00 AM,0,0,0,partly cloudy night,
2019,Summer,09:00:00 PM,137,82,55,clear night,
2019,Spring,11:00:00 PM,2,1,1,cloudy,Tax Day
2019,Spring,02:00:00 PM,2385,1175,1210,partly cloudy day,
2019,Spring,05:00:00 AM,2,0,2,clear night,
2019,Winter,05:00:00 PM,50,48,2,clear night,
2019,Summer,12:00:00 PM,2035,950,1085,clear day,
2019,Fall,07:00:00 PM,12,6,6,clear night,Columbus Day (regional holiday)
2019,Fall,08:00:00 AM,340,131,209,clear day,
2019,Fall,12:00:00 AM,0,0,0,partly cloudy night,
2019,Summer,05:00:00 AM,57,40,17,clear night,
2019,Summer,04:00:00 AM,0,0,0,partly cloudy night,
2019,Fall,01:00:00 PM,1854,983,871,cloudy,Thanksgiving Day
2019,Spring,07:00:00 PM,855,433,422,clear day,
2019,Spring,04:00:00 AM,0,0,0,fog,
2019,Fall,10:00:00 AM,1768,1034,734,partly cloudy day,
2019,Spring,10:00:00 PM,0,0,0,clear night,
2019,Spring,09:00:00 PM,100,84,16,partly cloudy night,
2019,Fall,07:00:00 AM,291,126,165,clear day,
2019,Spring,03:00:00 AM,6,1,5,snow,
2019,Summer,08:00:00 AM,404,244,160,partly cloudy day,
2019,Winter,08:00:00 PM,40,40,0,rain,
2019,Spring,04:00:00 PM,753,391,362,rain,
2019,Spring,08:00:00 AM,210,95,115,clear day,St. Patrick's Day
2019,Spring,07:00:00 PM,2150,797,1353,partly cloudy day,Easter Sunday
2019,Spring,09:00:00 AM,214,107,107,rain,
2019,Fall,03:00:00 AM,0,0,0,partly cloudy night,
2019,Spring,05:00:00 AM,68,55,13,clear night,Memorial Day
2019,Summer,10:00:00 AM,1160,720,440,partly cloudy day,
2019,Winter,01:00:00 AM,0,0,0,rain,
2019,Spring,10:00:00 AM,1260,737,523,clear day,
2019,Fall,04:00:00 AM,1,0,1,clear night,
2019,Fall,07:00:00 PM,81,70,11,rain,
2019,Spring,09:00:00 PM,92,23,69,partly cloudy night,
2019,Fall,07:00:00 AM,281,130,151,cloudy,
2019,Fall,09:00:00 PM,12,8,4,cloudy,
2019,Spring,05:00:00 PM,1883,983,900,clear day,
2019,Winter,10:00:00 AM,618,333,285,cloudy,
2019,Spring,07:00:00 AM,254,99,155,clear day,
2019,Spring,04:00:00 PM,2191,969,1222,clear day,
2019,Summer,11:00:00 PM,8,5,3,cloudy,
2019,Spring,09:00:00 AM,202,117,85,rain,Mother's Day
2019,Fall,02:00:00 AM,0,0,0,clear night,
2019,Spring,01:00:00 AM,5,5,0,rain,
2019,Spring,10:00:00 PM,46,42,4,clear night,
2019,Fall,02:00:00 AM,0,0,0,clear night,
2019,Summer,05:00:00 PM,2124,1048,1076,partly cloudy day,
2019,Winter,09:00:00 AM,334,175,159,clear day,
2019,Winter,05:00:00 PM,58,55,3,clear night,
2019,Spring,04:00:00 AM,0,0,0,clear night,
2019,Spring,06:00:00 AM,40,19,21,snow,
2019,Winter,08:00:00 PM,10,7,3,clear night,
2019,Fall,12:00:00 PM,1968,842,1126,clear day,
2019,Winter,02:00:00 PM,987,421,566,clear day,
2019,Spring,07:00:00 PM,932,461,471,cloudy,
2019,Spring,09:00:00 AM,306,158,148,clear day,
2019,Spring,07:00:00 PM,457,195,262,partly cloudy day,
2019,Summer,05:00:00 PM,1686,931,755,clear day,
2019,Summer,11:00:00 PM,3,2,1,clear night,
2019,Fall,04:00:00 AM,0,0,0,partly cloudy night,
2019,Spring,04:00:00 PM,1811,868,943,clear day,
2019,Winter,05:00:00 AM,4,1,3,partly cloudy night,
2019,Summer,07:00:00 AM,282,127,155,partly cloudy day,
2019,Fall,10:00:00 PM,12,4,8,partly cloudy night,
2019,Fall,06:00:00 AM,84,50,34,clear night,
2019,Summer,12:00:00 AM,13,11,2,partly cloudy night,
2019,Spring,02:00:00 AM,1,0,1,cloudy,
2019,Winter,09:00:00 PM,2,1,1,clear night,
2019,Winter,06:00:00 AM,18,17,1,partly cloudy night,
2019,Winter,05:00:00 PM,1129,490,639,partly cloudy day,Valentine's Day
2019,Summer,09:00:00 AM,256,141,115,rain,
2019,Fall,09:00:00 PM,8,6,2,rain,
2019,Spring,07:00:00 AM,244,103,141,partly cloudy day,Easter Monday
2019,Fall,09:00:00 AM,585,296,289,clear day,
2019,Spring,08:00:00 AM,179,60,119,clear day,
2019,Spring,12:00:00 PM,2242,949,1293,cloudy,Easter Monday
2019,Spring,10:00:00 PM,3,2,1,cloudy,
2019,Summer,10:00:00 PM,44,31,13,clear night,
2019,Summer,09:00:00 AM,664,415,249,clear day,
2019,Summer,01:00:00 PM,2765,1174,1591,partly cloudy day,
2019,Winter,10:00:00 AM,893,415,478,cloudy,
2019,Summer,04:00:00 PM,2072,996,1076,partly cloudy day,
2019,Fall,11:00:00 AM,2363,1190,1173,clear day,
2019,Fall,11:00:00 PM,0,0,0,clear night,
2019,Fall,08:00:00 AM,384,167,217,partly cloudy day,
2019,Winter,05:00:00 AM,3,2,1,cloudy,New Year's Day
2019,Spring,12:00:00 AM,1,0,1,cloudy,
2019,Fall,05:00:00 AM,0,0,0,cloudy,
2019,Winter,10:00:00 PM,34,23,11,cloudy,
2019,Spring,12:00:00 PM,1714,846,868,partly cloudy day,
2019,Fall,02:00:00 AM,2,1,1,clear night,
2019,Fall,10:00:00 PM,5,2,3,clear night,
2019,Winter,02:00:00 PM,1311,636,675,partly cloudy day,
2019,Summer,07:00:00 AM,291,119,172,clear day,
2019,Fall,02:00:00 PM,3615,1632,1983,partly cloudy day,
2019,Summer,07:00:00 PM,320,145,175,rain,
2019,Fall,06:00:00 AM,188,108,80,clear night,
2019,Winter,09:00:00 AM,333,166,167,clear day,
2019,Spring,12:00:00 PM,2574,1080,1494,clear day,
2019,Winter,05:00:00 AM,3,3,0,clear night,
2019,Winter,05:00:00 PM,607,279,328,cloudy,
2019,Winter,12:00:00 AM,3,3,0,,
2019,Spring,11:00:00 AM,1708,838,870,cloudy,
2019,Winter,08:00:00 AM,389,197,192,clear day,
2019,Summer,04:00:00 PM,1942,889,1053,partly cloudy day,
2019,Spring,02:00:00 AM,0,0,0,cloudy,
2019,Winter,07:00:00 AM,133,64,69,clear night,
2019,Spring,07:00:00 AM,95,42,53,clear day,
2019,Summer,05:00:00 AM,17,14,3,partly cloudy night,
2019,Fall,12:00:00 PM,2590,1167,1423,clear day,
2019,Fall,06:00:00 PM,1535,858,677,clear day,
2019,Spring,02:00:00 AM,0,0,0,partly cloudy night,
2019,Summer,05:00:00 AM,23,10,13,partly cloudy night,
2019,Spring,05:00:00 AM,20,18,2,clear night,
2019,Winter,02:00:00 PM,2336,1193,1143,clear day,
2019,Winter,07:00:00 PM,137,97,40,partly cloudy night,
2019,Winter,09:00:00 PM,2,1,1,clear night,
2019,Fall,01:00:00 AM,1,0,1,rain,
2019,Winter,02:00:00 PM,794,380,414,cloudy,
2019,Summer,06:00:00 AM,124,53,71,clear day,
2019,Summer,09:00:00 AM,695,392,303,partly cloudy day,
2019,Winter,08:00:00 AM,247,131,116,partly cloudy day,
2019,Winter,07:00:00 AM,132,48,84,clear night,
2019,Spring,06:00:00 PM,1120,393,727,cloudy,
2019,Winter,07:00:00 AM,85,41,44,clear night,
2019,Summer,03:00:00 PM,1299,624,675,cloudy,
2019,Spring,04:00:00 AM,1,0,1,clear night,
2019,Fall,06:00:00 AM,1,0,1,cloudy,
2019,Spring,03:00:00 AM,0,0,0,clear night,
2019,Fall,04:00:00 AM,0,0,0,clear night,
2019,Fall,03:00:00 AM,0,0,0,partly cloudy night,
2019,Summer,03:00:00 AM,0,0,0,clear night,
2019,Spring,05:00:00 PM,2160,1016,1144,partly cloudy day,
2019,Summer,06:00:00 AM,167,63,104,partly cloudy day,
2019,Spring,06:00:00 PM,1764,978,786,clear day,
2019,Spring,10:00:00 PM,14,3,11,cloudy,
2019,Spring,09:00:00 PM,12,6,6,partly cloudy night,
2019,Summer,05:00:00 AM,37,20,17,partly cloudy night,
2019,Winter,06:00:00 PM,103,102,1,clear night,
2019,Winter,02:00:00 PM,1552,710,842,partly cloudy day,
2019,Spring,12:00:00 PM,1203,495,708,partly cloudy day,
2019,Summer,03:00:00 PM,2397,1147,1250,partly cloudy day,
2019,Summer,04:00:00 PM,2268,1125,1143,partly cloudy day,
2019,Fall,07:00:00 AM,341,134,207,partly cloudy day,
2019,Summer,09:00:00 AM,671,397,274,partly cloudy day,
2019,Summer,05:00:00 AM,59,46,13,clear night,
2019,Winter,05:00:00 AM,0,0,0,clear night,
2019,Winter,05:00:00 AM,0,0,0,clear night,
2019,Winter,04:00:00 AM,0,0,0,cloudy,
2019,Fall,02:00:00 AM,0,0,0,cloudy,
2019,Fall,09:00:00 PM,14,11,3,cloudy,Daylight Saving Time ends
2019,Summer,08:00:00 PM,1059,419,640,partly cloudy night,
2019,Summer,07:00:00 AM,229,100,129,cloudy,
2019,Fall,05:00:00 PM,2393,1051,1342,partly cloudy day,
2019,Fall,08:00:00 AM,525,201,324,partly cloudy day,
2019,Winter,09:00:00 AM,104,70,34,rain,
2019,Winter,10:00:00 AM,580,344,236,clear day,
2019,Winter,01:00:00 PM,2518,1200,1318,partly cloudy day,
2019,Winter,09:00:00 PM,24,23,1,clear night,
2019,Summer,10:00:00 PM,47,36,11,rain,
2019,Summer,07:00:00 PM,1204,611,593,partly cloudy day,
2019,Spring,09:00:00 PM,13,7,6,cloudy,
2019,Summer,11:00:00 PM,27,12,15,partly cloudy night,
2019,Fall,12:00:00 AM,5,0,5,clear night,
2019,Fall,12:00:00 PM,1675,749,926,cloudy,
2019,Summer,08:00:00 AM,418,176,242,clear day,
2019,Fall,10:00:00 PM,14,10,4,partly cloudy night,
2019,Winter,09:00:00 AM,319,180,139,clear day,
2019,Winter,09:00:00 PM,17,12,5,clear night,
2019,Spring,10:00:00 PM,13,8,5,clear night,
2019,Summer,03:00:00 PM,2703,1046,1657,rain,
2019,Fall,02:00:00 AM,1,0,1,partly cloudy night,
2019,Winter,09:00:00 PM,120,120,0,clear night,Presidents' Day (regional holiday)
2019,Spring,10:00:00 PM,3,2,1,snow,
2019,Summer,08:00:00 PM,1382,620,762,clear day,
2019,Fall,07:00:00 AM,281,124,157,clear day,
2019,Fall,12:00:00 PM,973,398,575,cloudy,
2019,Summer,05:00:00 AM,16,11,5,cloudy,
2019,Summer,01:00:00 AM,2,0,2,partly cloudy night,
2019,Fall,04:00:00 PM,1531,697,834,clear day,
2019,Summer,08:00:00 AM,198,65,133,cloudy,
2019,Winter,03:00:00 PM,942,396,546,cloudy,
2019,Spring,09:00:00 AM,441,228,213,cloudy,
2019,Winter,10:00:00 AM,1200,638,562,partly cloudy day,New Year's Day
2019,Spring,11:00:00 AM,1136,558,578,partly cloudy day,
2019,Spring,01:00:00 AM,0,0,0,clear night,
2019,Spring,05:00:00 PM,1862,792,1070,cloudy,
2019,Summer,07:00:00 AM,311,128,183,clear day,
2019,Fall,06:00:00 PM,2327,1003,1324,clear day,
2019,Fall,03:00:00 PM,352,113,239,cloudy,
2019,Summer,01:00:00 AM,1,0,1,partly cloudy night,
2019,Summer,06:00:00 AM,182,98,84,clear night,
2019,Winter,10:00:00 PM,21,20,1,partly cloudy night,Valentine's Day
2019,Spring,12:00:00 PM,1969,953,1016,partly cloudy day,
2019,Summer,08:00:00 AM,364,163,201,partly cloudy day,
2019,Spring,10:00:00 AM,612,367,245,cloudy,
2019,Fall,11:00:00 AM,2377,1241,1136,partly cloudy day,
2019,Spring,01:00:00 AM,0,0,0,cloudy,
2019,Spring,02:00:00 AM,0,0,0,clear night,
2019,Fall,02:00:00 PM,2035,878,1157,clear day,
2019,Summer,06:00:00 AM,200,125,75,partly cloudy night,
2019,Summer,10:00:00 AM,964,520,444,clear day,
2019,Spring,03:00:00 PM,1981,996,985,clear day,
2019,Winter,08:00:00 PM,5,0,5,cloudy,New Year's Eve
2019,Summer,09:00:00 PM,43,16,27,partly cloudy night,
2019,Summer,02:00:00 AM,0,0,0,clear night,
2019,Fall,07:00:00 AM,327,138,189,clear day,
2019,Spring,12:00:00 AM,48,46,2,partly cloudy night,
2019,Winter,09:00:00 PM,55,54,1,clear night,
2019,Winter,12:00:00 PM,1275,514,761,cloudy,
2019,Summer,01:00:00 AM,3,1,2,clear night,
2019,Summer,11:00:00 AM,1740,927,813,partly cloudy day,
2019,Spring,07:00:00 AM,281,134,147,clear day,
2019,Winter,01:00:00 AM,7,2,5,clear night,
2019,Fall,08:00:00 PM,8,3,5,cloudy,
2019,Winter,12:00:00 AM,24,12,12,clear night,
2019,Winter,08:00:00 AM,294,93,201,partly cloudy day,
2019,Summer,10:00:00 AM,1077,613,464,cloudy,
2019,Spring,11:00:00 PM,1,1,0,cloudy,Daylight Saving Time starts
2019,Summer,09:00:00 AM,711,410,301,partly cloudy day,
2019,Spring,12:00:00 AM,58,56,2,partly cloudy night,
2019,Fall,01:00:00 AM,0,0,0,clear night,
2019,Spring,09:00:00 PM,17,14,3,partly cloudy night,
2019,Winter,06:00:00 AM,0,0,0,rain,
2019,Fall,03:00:00 AM,0,0,0,clear night,
2019,Fall,05:00:00 PM,1751,956,795,partly cloudy day,
2019,Summer,09:00:00 PM,63,18,45,partly cloudy night,
2019,Winter,06:00:00 AM,13,11,2,clear night,
2019,Spring,01:00:00 AM,0,0,0,partly cloudy night,
2019,Summer,01:00:00 AM,7,4,3,cloudy,
2019,Fall,04:00:00 PM,1870,839,1031,partly cloudy day,Thanksgiving Day
2019,Summer,02:00:00 AM,0,0,0,clear night,Independence Day
2019,Summer,11:00:00 AM,1314,638,676,clear day,
2019,Winter,09:00:00 AM,488,283,205,clear day,
2019,Fall,02:00:00 PM,1553,708,845,clear day,
2019,Summer,09:00:00 PM,13,3,10,partly cloudy night,
2019,Spring,03:00:00 PM,3243,1483,1760,partly cloudy day,
2019,Spring,10:00:00 PM,20,10,10,cloudy,
2019,Fall,03:00:00 AM,0,0,0,cloudy,
2019,Winter,06:00:00 PM,70,66,4,cloudy,
2019,Spring,04:00:00 AM,0,0,0,clear night,
2019,Summer,03:00:00 PM,1560,761,799,partly cloudy day,
2019,Winter,01:00:00 PM,2086,930,1156,partly cloudy day,
2019,Winter,05:00:00 AM,0,0,0,clear night,
2019,Fall,04:00:00 PM,1487,632,855,cloudy,
2019,Fall,12:00:00 PM,450,207,243,cloudy,
2019,Fall,02:00:00 PM,1606,697,909,cloudy,
2019,Fall,02:00:00 AM,1,0,1,clear night,
2019,Winter,02:00:00 PM,1016,497,519,cloudy,
2019,Winter,05:00:00 AM,3,0,3,clear night,
2019,Spring,04:00:00 AM,0,0,0,partly cloudy night,
2019,Spring,07:00:00 PM,524,240,284,clear day,
2019,Fall,12:00:00 PM,1484,658,826,cloudy,
2019,Summer,03:00:00 PM,828,374,454,partly cloudy day,
2019,Fall,03:00:00 AM,1,0,1,partly cloudy night,
2019,Spring,08:00:00 PM,914,372,542,partly cloudy day,
2019,Summer,03:00:00 PM,2895,1249,1646,clear day,
2019,Fall,06:00:00 AM,165,89,76,partly cloudy night,
2019,Spring,07:00:00 AM,270,114,156,partly cloudy day,
2019,Summer,07:00:00 PM,573,290,283,rain,
2019,Summer,12:00:00 AM,69,58,11,partly cloudy night,
2019,Spring,03:00:00 PM,3724,1713,2011,clear day,
2019,Summer,05:00:00 PM,755,387,368,cloudy,
2019,Summer,06:00:00 AM,156,82,74,clear day,
2019,Winter,11:00:00 PM,1,0,1,clear night,Christmas Eve
2019,Summer,03:00:00 AM,0,0,0,cloudy,
2019,Winter,10:00:00 PM,9,8,1,partly cloudy night,
2019,Summer,01:00:00 AM,22,19,3,partly cloudy night,
2019,Summer,12:00:00 PM,1515,758,757,cloudy,
2019,Spring,05:00:00 AM,56,38,18,partly cloudy night,
2019,Fall,07:00:00 PM,5,0,5,clear night,
2019,Winter,10:00:00 PM,3,2,1,partly cloudy night,
2019,Summer,10:00:00 PM,18,7,11,rain,
2019,Spring,04:00:00 AM,0,0,0,clear night,
2019,Fall,05:00:00 PM,2963,1253,1710,clear day,
2019,Fall,11:00:00 PM,40,39,1,clear night,
2019,Spring,02:00:00 PM,2342,958,1384,partly cloudy day,
2019,Winter,05:00:00 AM,1,1,0,partly cloudy night,
2019,Summer,06:00:00 PM,1432,804,628,partly cloudy day,
2019,Spring,08:00:00 PM,335,161,174,partly cloudy night,
2019,Summer,08:00:00 AM,355,159,196,clear day,
2019,Spring,07:00:00 AM,176,81,95,partly cloudy night,
2019,Fall,12:00:00 AM,0,0,0,clear night,
2019,Fall,11:00:00 AM,2584,989,1595,partly cloudy day,
2019,Fall,11:00:00 PM,1,0,1,clear night,
2019,Fall,07:00:00 AM,295,126,169,partly cloudy day,
2019,Fall,11:00:00 AM,1824,864,960,clear day,
2019,Summer,06:00:00 AM,47,28,19,rain,
2019,Spring,07:00:00 PM,376,161,215,partly cloudy day,
2019,Winter,08:00:00 PM,8,5,3,clear night,Martin Luther King Jr. Day
2019,Summer,08:00:00 PM,946,468,478,partly cloudy day,
2019,Summer,04:00:00 PM,2194,1037,1157,partly cloudy day,
2019,Spring,12:00:00 AM,1,0,1,clear night,
2019,Spring,07:00:00 AM,117,55,62,cloudy,
2019,Winter,04:00:00 PM,98,60,38,snow,
2019,Winter,10:00:00 AM,2231,1203,1028,cloudy,New Year's Eve
2019,Winter,12:00:00 PM,1323,590,733,cloudy,Presidents' Day (regional holiday)
2019,Spring,07:00:00 AM,220,100,120,partly cloudy day,
2019,Fall,04:00:00 PM,2214,1187,1027,clear day,
2019,Winter,05:00:00 AM,0,0,0,clear night,
2019,Winter,12:00:00 AM,3,1,2,partly cloudy night,
2019,Spring,12:00:00 PM,2468,1117,1351,clear day,
2019,Spring,02:00:00 PM,2534,1194,1340,partly cloudy day,
2019,Winter,02:00:00 AM,3,0,3,clear night,
2019,Winter,05:00:00 PM,115,111,4,clear night,
2019,Winter,10:00:00 PM,33,33,0,clear night,
2019,Winter,07:00:00 PM,4,3,1,clear night,
2019,Spring,12:00:00 AM,24,0,24,rain,
2019,Fall,05:00:00 PM,1664,964,700,partly cloudy day,
2019,Spring,02:00:00 AM,0,0,0,rain,
2019,Spring,05:00:00 AM,44,36,8,cloudy,
2019,Fall,12:00:00 PM,1892,888,1004,clear day,
2019,Fall,07:00:00 AM,206,95,111,cloudy,
2019,Winter,03:00:00 AM,0,0,0,clear night,
2019,Spring,05:00:00 AM,0,0,0,clear night,
2019,Summer,12:00:00 PM,3006,1600,1406,clear day,
2019,Fall,07:00:00 PM,11,9,2,clear night,
2019,Fall,07:00:00 AM,266,119,147,clear night,
2019,Summer,01:00:00 AM,2,1,1,partly cloudy night,
2019,Summer,06:00:00 AM,159,71,88,clear day,
2019,Fall,01:00:00 AM,0,0,0,,Daylight Saving Time ends
2019,Spring,10:00:00 AM,1236,625,611,cloudy,
2019,Winter,05:00:00 PM,83,82,1,clear night,
2019,Fall,08:00:00 AM,447,156,291,clear day,
2019,Winter,01:00:00 PM,1494,767,727,cloudy,
2019,Summer,10:00:00 AM,1749,972,777,partly cloudy day,
2019,Fall,04:00:00 AM,0,0,0,partly cloudy night,Thanksgiving Day
2019,Spring,12:00:00 AM,0,0,0,clear night,
2019,Spring,12:00:00 AM,6,3,3,partly cloudy night,
2019,Winter,04:00:00 PM,1026,465,561,partly cloudy day,
2019,Summer,01:00:00 PM,2039,880,1159,partly cloudy day,
2019,Spring,04:00:00 PM,2504,1191,1313,partly cloudy day,
2019,Winter,09:00:00 AM,442,263,179,partly cloudy day,
2019,Fall,11:00:00 AM,1998,1019,979,partly cloudy day,
2019,Summer,07:00:00 AM,237,97,140,partly cloudy day,
2019,Fall,11:00:00 AM,2749,1473,1276,partly cloudy day,
2019,Fall,02:00:00 AM,0,0,0,partly cloudy night,
2019,Summer,01:00:00 PM,2044,958,1086,clear day,
2019,Summer,08:00:00 AM,356,166,190,partly cloudy day,
2019,Summer,12:00:00 AM,1,0,1,clear night,
2019,Winter,10:00:00 PM,6,4,2,clear night,
2019,Winter,07:00:00 AM,90,38,52,partly cloudy day,
2019,Fall,10:00:00 AM,2000,1018,982,partly cloudy day,
2019,Summer,09:00:00 PM,37,14,23,clear night,
2019,Summer,04:00:00 AM,0,0,0,clear night,
2019,Fall,06:00:00 AM,183,96,87,partly cloudy night,
2019,Summer,06:00:00 PM,2251,1083,1168,clear day,
2019,Winter,05:00:00 PM,48,44,4,clear night,
2019,Summer,01:00:00 AM,6,3,3,clear night,
2019,Spring,04:00:00 AM,1,0,1,partly cloudy night,
2019,Summer,03:00:00 AM,0,0,0,clear night,
2019,Spring,11:00:00 AM,981,669,312,rain,
2019,Fall,07:00:00 PM,59,58,1,partly cloudy night,
2019,Spring,08:00:00 AM,302,120,182,clear day,
2019,Winter,12:00:00 PM,1558,689,869,cloudy,
2019,Winter,02:00:00 AM,0,0,0,partly cloudy night,
2019,Summer,02:00:00 AM,3,1,2,cloudy,
2019,Summer,10:00:00 AM,1365,850,515,partly cloudy day,
2019,Spring,11:00:00 PM,5,0,5,rain,
2019,Spring,01:00:00 PM,2116,962,1154,partly cloudy day,
2019,Spring,08:00:00 PM,22,20,2,clear night,
2019,Summer,10:00:00 AM,1526,918,608,clear day,
2019,Fall,05:00:00 AM,0,0,0,clear night,
2019,Spring,11:00:00 AM,2483,1406,1077,cloudy,
2019,Winter,01:00:00 AM,0,0,0,cloudy,
2019,Fall,01:00:00 AM,2,1,1,clear night,
2019,Spring,06:00:00 AM,43,19,24,rain,
2019,Spring,09:00:00 AM,379,179,200,partly cloudy day,
2019,Winter,10:00:00 PM,1,0,1,clear night,
2019,Spring,01:00:00 AM,13,5,8,cloudy,
2019,Fall,12:00:00 PM,71,35,36,rain,
2019,Summer,01:00:00 AM,5,0,5,rain,
2019,Summer,10:00:00 PM,24,7,17,partly cloudy night,
2019,Winter,03:00:00 AM,0,0,0,clear night,
2019,Winter,01:00:00 AM,4,0,4,cloudy,
2019,Fall,11:00:00 PM,10,6,4,cloudy,
2019,Spring,01:00:00 AM,2,1,1,cloudy,
2019,Fall,08:00:00 AM,559,390,169,cloudy,
2019,Winter,08:00:00 AM,294,134,160,cloudy,
2019,Summer,11:00:00 PM,9,2,7,partly cloudy night,
2019,Summer,01:00:00 PM,1055,491,564,clear day,
2019,Spring,10:00:00 AM,1442,797,645,cloudy,
2019,Fall,12:00:00 PM,2977,1434,1543,clear day,
2019,Spring,08:00:00 AM,184,40,144,rain,Daylight Saving Time starts
2019,Spring,12:00:00 PM,1948,835,1113,cloudy,
2019,Fall,03:00:00 PM,582,305,277,rain,
2019,Fall,12:00:00 PM,1079,482,597,cloudy,
2019,Spring,09:00:00 PM,82,0,82,cloudy,
2019,Fall,10:00:00 PM,0,0,0,clear night,
2019,Winter,09:00:00 AM,381,219,162,clear day,
2019,Fall,11:00:00 AM,1112,513,599,cloudy,
2019,Spring,01:00:00 AM,10,7,3,clear night,
2019,Summer,10:00:00 PM,51,35,16,clear night,
2019,Fall,12:00:00 AM,42,41,1,clear night,
2019,Summer,06:00:00 PM,2589,1060,1529,partly cloudy day,
2019,Fall,09:00:00 PM,98,94,4,rain,
2019,Winter,07:00:00 AM,168,67,101,cloudy,Valentine's Day
2019,Summer,08:00:00 PM,107,44,63,partly cloudy night,
2019,Fall,10:00:00 AM,1026,568,458,partly cloudy day,
2019,Winter,09:00:00 AM,782,455,327,partly cloudy day,
2019,Spring,10:00:00 AM,1131,651,480,partly cloudy day,
2019,Fall,11:00:00 AM,658,331,327,cloudy,
2019,Summer,08:00:00 PM,311,134,177,partly cloudy night,
2019,Spring,12:00:00 PM,2446,1107,1339,clear day,
2019,Winter,04:00:00 AM,1,0,1,clear night,
2019,Fall,12:00:00 PM,2064,991,1073,cloudy,
2019,Fall,07:00:00 PM,202,109,93,clear night,
2019,Summer,07:00:00 PM,9,6,3,clear day,Independence Day
2019,Spring,01:00:00 AM,0,0,0,cloudy,
2019,Fall,06:00:00 AM,51,34,17,clear night,
2019,Spring,02:00:00 AM,2,0,2,clear night,
2019,Winter,07:00:00 PM,57,0,57,clear night,
2019,Winter,10:00:00 AM,387,201,186,cloudy,
2019,Winter,10:00:00 AM,692,364,328,clear day,
2019,Winter,09:00:00 AM,204,104,100,clear day,
2019,Fall,11:00:00 AM,1771,762,1009,clear day,Black Friday
2019,Spring,10:00:00 AM,812,390,422,partly cloudy day,
2019,Summer,12:00:00 PM,2615,1338,1277,partly cloudy day,
2019,Fall,01:00:00 PM,2292,969,1323,clear day,Columbus Day (regional holiday)
2019,Fall,07:00:00 PM,52,50,2,partly cloudy night,
2019,Spring,07:00:00 PM,9,4,5,partly cloudy night,
2019,Winter,10:00:00 PM,68,0,68,cloudy,
2019,Winter,06:00:00 PM,86,75,11,clear night,
2019,Summer,07:00:00 AM,301,121,180,clear day,
2019,Summer,09:00:00 PM,43,16,27,clear night,
2019,Summer,08:00:00 AM,439,183,256,partly cloudy day,
2019,Spring,08:00:00 AM,390,129,261,cloudy,
2019,Fall,04:00:00 PM,2576,1198,1378,partly cloudy day,
2019,Summer,10:00:00 AM,542,279,263,rain,
2019,Spring,06:00:00 PM,184,54,130,cloudy,
2019,Winter,03:00:00 PM,3587,1955,1632,partly cloudy day,New Year's Eve
2019,Fall,08:00:00 PM,55,50,5,partly cloudy night,
2019,Summer,12:00:00 PM,1799,852,947,cloudy,
2019,Winter,10:00:00 PM,4,1,3,clear night,
2019,Fall,10:00:00 PM,10,7,3,partly cloudy night,
2019,Spring,12:00:00 PM,2044,912,1132,partly cloudy day,
2019,Spring,07:00:00 AM,194,71,123,cloudy,
2019,Winter,10:00:00 PM,34,33,1,clear night,
2019,Fall,07:00:00 AM,235,100,135,cloudy,
2019,Summer,09:00:00 PM,77,67,10,clear night,
2019,Winter,01:00:00 PM,1325,633,692,clear day,
2019,Fall,08:00:00 PM,47,0,47,clear night,
2019,Spring,10:00:00 AM,1182,682,500,clear day,
2019,Fall,09:00:00 AM,143,80,63,rain,
2019,Winter,06:00:00 AM,7,3,4,cloudy,
2019,Winter,03:00:00 PM,1429,698,731,partly cloudy day,
2019,Winter,08:00:00 PM,89,69,20,partly cloudy night,
2019,Fall,08:00:00 PM,73,72,1,rain,
2019,Spring,11:00:00 PM,22,9,13,partly cloudy night,
2019,Winter,08:00:00 PM,152,152,0,clear night,
2019,Fall,02:00:00 PM,2728,1228,1500,clear day,
2019,Fall,06:00:00 PM,1945,995,950,partly cloudy day,
2019,Summer,03:00:00 PM,491,269,222,cloudy,
2019,Fall,04:00:00 PM,3388,1304,2084,partly cloudy day,
2019,Spring,06:00:00 PM,1195,641,554,partly cloudy day,
2019,Spring,07:00:00 AM,204,87,117,cloudy,
2019,Winter,10:00:00 AM,431,234,197,cloudy,
2019,Winter,05:00:00 PM,247,175,72,cloudy,
2019,Fall,08:00:00 PM,65,53,12,clear night,
2019,Summer,04:00:00 PM,1906,873,1033,partly cloudy day,
2019,Spring,11:00:00 AM,1286,640,646,clear day,
2019,Summer,08:00:00 PM,1500,596,904,clear day,
2019,Spring,08:00:00 AM,381,128,253,clear day,
2019,Fall,10:00:00 AM,2110,1181,929,partly cloudy day,
2019,Fall,06:00:00 PM,1582,850,732,clear day,
2019,Summer,11:00:00 PM,25,18,7,partly cloudy night,
2019,Spring,08:00:00 PM,672,316,356,partly cloudy day,
2019,Summer,05:00:00 AM,85,63,22,clear night,
2019,Spring,08:00:00 PM,38,32,6,clear night,
2019,Spring,02:00:00 PM,1629,715,914,partly cloudy day,
2019,Summer,07:00:00 PM,1920,1011,909,partly cloudy day,
2019,Fall,10:00:00 AM,1353,727,626,clear day,
2019,Winter,05:00:00 PM,745,396,349,cloudy,
2019,Summer,04:00:00 AM,0,0,0,partly cloudy night,
2019,Fall,02:00:00 AM,1,0,1,clear night,
2019,Spring,05:00:00 PM,1301,692,609,cloudy,
2019,Spring,11:00:00 AM,2451,1212,1239,clear day,
2019,Fall,11:00:00 PM,41,40,1,cloudy,Thanksgiving Day
2019,Spring,08:00:00 PM,710,349,361,partly cloudy night,Cinco de Mayo
2019,Summer,10:00:00 AM,1915,1195,720,clear day,
2019,Summer,02:00:00 PM,3351,1561,1790,partly cloudy day,
2019,Spring,06:00:00 AM,83,51,32,clear night,
2019,Summer,08:00:00 PM,58,34,24,rain,
2019,Fall,01:00:00 AM,2,1,1,cloudy,
2019,Fall,11:00:00 AM,1521,697,824,partly cloudy day,
2019,Fall,08:00:00 AM,382,152,230,cloudy,
2019,Fall,09:00:00 PM,14,13,1,clear night,
2019,Summer,10:00:00 PM,46,39,7,clear night,
2019,Spring,08:00:00 AM,292,108,184,cloudy,
2019,Summer,10:00:00 AM,1280,771,509,partly cloudy day,Father's Day
2019,Spring,06:00:00 PM,219,122,97,rain,
2019,Spring,07:00:00 PM,919,355,564,cloudy,
2019,Winter,07:00:00 PM,33,23,10,clear night,
2019,Summer,05:00:00 PM,1661,844,817,partly cloudy day,
2019,Winter,09:00:00 PM,1,0,1,clear night,
2019,Winter,11:00:00 PM,22,0,22,clear night,
2019,Fall,04:00:00 AM,0,0,0,clear night,
2019,Spring,03:00:00 AM,0,0,0,partly cloudy night,
2019,Summer,03:00:00 AM,0,0,0,partly cloudy night,
2019,Fall,04:00:00 AM,0,0,0,clear night,
2019,Spring,04:00:00 AM,0,0,0,cloudy,
2019,Summer,02:00:00 PM,2159,978,1181,partly cloudy day,
2019,Spring,06:00:00 AM,33,22,11,clear night,
2019,Winter,08:00:00 PM,10,0,10,rain,
2019,Spring,10:00:00 PM,44,10,34,partly cloudy night,Memorial Day
2019,Winter,06:00:00 PM,184,143,41,partly cloudy night,
2019,Spring,09:00:00 AM,159,74,85,rain,Cinco de Mayo
2019,Summer,08:00:00 AM,357,222,135,cloudy,
2019,Fall,07:00:00 AM,275,104,171,partly cloudy day,
2019,Spring,07:00:00 PM,817,372,445,clear day,
2019,Winter,11:00:00 PM,3,2,1,cloudy,
2019,Fall,11:00:00 PM,18,0,18,rain,
2019,Spring,04:00:00 PM,997,447,550,cloudy,
2019,Summer,11:00:00 AM,1879,898,981,partly cloudy day,
2019,Winter,06:00:00 PM,35,34,1,clear night,
2019,Summer,10:00:00 PM,50,43,7,partly cloudy night,
2019,Spring,09:00:00 AM,566,277,289,partly cloudy day,
2019,Summer,03:00:00 AM,1,0,1,clear night,
2019,Summer,11:00:00 PM,13,6,7,cloudy,
2019,Winter,02:00:00 PM,0,0,0,clear day,
2019,Spring,01:00:00 AM,1,1,0,cloudy,
2019,Fall,08:00:00 AM,394,174,220,cloudy,Columbus Day (regional holiday)
2019,Summer,06:00:00 PM,1642,942,700,partly cloudy day,
2019,Fall,10:00:00 AM,1383,792,591,clear day,
2019,Fall,09:00:00 PM,17,9,8,partly cloudy night,
2019,Winter,01:00:00 PM,724,334,390,clear day,
2019,Fall,11:00:00 PM,3,2,1,clear night,
2019,Winter,09:00:00 AM,680,408,272,clear day,Christmas Eve
2019,Spring,04:00:00 AM,0,0,0,clear night,
2019,Winter,01:00:00 AM,0,0,0,clear night,
2019,Spring,09:00:00 AM,1158,657,501,clear day,Memorial Day
2019,Winter,09:00:00 AM,248,141,107,cloudy,
2019,Winter,12:00:00 AM,10,3,7,partly cloudy night,
2019,Fall,11:00:00 PM,8,0,8,rain,
2019,Summer,09:00:00 AM,556,294,262,cloudy,
2019,Fall,05:00:00 AM,1,0,1,cloudy,
2019,Summer,11:00:00 AM,1967,1103,864,partly cloudy day,
2019,Fall,08:00:00 AM,429,197,232,clear day,
2019,Winter,08:00:00 PM,30,0,30,clear night,
2019,Summer,11:00:00 PM,10,1,9,clear night,
2019,Fall,11:00:00 AM,1601,728,873,cloudy,
2019,Winter,01:00:00 PM,1580,705,875,clear day,
2019,Winter,09:00:00 PM,40,38,2,rain,
2019,Summer,10:00:00 AM,1303,715,588,partly cloudy day,
2019,Spring,04:00:00 PM,1674,734,940,cloudy,
2019,Summer,09:00:00 AM,786,430,356,clear day,
2019,Winter,02:00:00 PM,868,369,499,partly cloudy day,
2019,Summer,04:00:00 AM,0,0,0,cloudy,
2019,Fall,07:00:00 AM,354,149,205,partly cloudy day,
2019,Fall,09:00:00 AM,942,628,314,partly cloudy day,
2019,Winter,12:00:00 AM,9,1,8,cloudy,
2019,Winter,06:00:00 AM,24,15,9,cloudy,
2019,Fall,05:00:00 PM,1143,662,481,partly cloudy day,
2019,Spring,05:00:00 AM,3,3,0,cloudy,
2019,Fall,12:00:00 AM,2,0,2,rain,
2019,Spring,08:00:00 PM,1231,438,793,clear day,
2019,Spring,06:00:00 PM,954,496,458,cloudy,
2019,Fall,04:00:00 PM,1186,529,657,cloudy,
2019,Fall,04:00:00 PM,2057,878,1179,clear day,
2019,Spring,03:00:00 PM,1917,950,967,partly cloudy day,
2019,Summer,11:00:00 AM,2036,1039,997,partly cloudy day,
2019,Summer,03:00:00 AM,0,0,0,clear night,
2019,Summer,08:00:00 PM,1410,622,788,clear day,
2019,Spring,06:00:00 PM,120,77,43,cloudy,Daylight Saving Time starts
2019,Fall,06:00:00 AM,0,0,0,clear night,
2019,Summer,10:00:00 AM,1458,836,622,partly cloudy day,
2019,Summer,05:00:00 PM,3022,1373,1649,partly cloudy day,
2019,Summer,11:00:00 AM,1701,862,839,partly cloudy day,
2019,Fall,10:00:00 AM,1153,601,552,partly cloudy day,
2019,Spring,01:00:00 PM,717,367,350,rain,Daylight Saving Time starts
2019,Spring,01:00:00 AM,0,0,0,rain,
2019,Summer,04:00:00 PM,1588,726,862,partly cloudy day,
2019,Summer,10:00:00 AM,1195,680,515,clear day,
2019,Winter,11:00:00 PM,20,19,1,partly cloudy night,
2019,Winter,06:00:00 AM,5,0,5,clear night,
2019,Winter,11:00:00 PM,3,0,3,cloudy,
2019,Spring,06:00:00 AM,110,53,57,cloudy,
2019,Summer,08:00:00 PM,1292,543,749,partly cloudy day,
2019,Fall,11:00:00 PM,16,13,3,clear night,
2019,Winter,09:00:00 AM,565,281,284,partly cloudy day,
2019,Winter,03:00:00 PM,1118,503,615,partly cloudy day,
2019,Spring,05:00:00 PM,1368,631,737,partly cloudy day,
2019,Fall,07:00:00 PM,2,1,1,clear night,
2019,Winter,06:00:00 PM,92,65,27,cloudy,
2019,Spring,05:00:00 PM,2007,925,1082,partly cloudy day,
2019,Spring,10:00:00 AM,1985,1235,750,clear day,
2019,Summer,09:00:00 PM,42,17,25,partly cloudy night,
2019,Summer,10:00:00 PM,27,12,15,partly cloudy night,
2019,Winter,01:00:00 PM,951,446,505,partly cloudy day,
2019,Winter,04:00:00 PM,1621,776,845,cloudy,
2019,Summer,10:00:00 AM,1288,755,533,clear day,
2019,Spring,06:00:00 PM,1076,577,499,partly cloudy day,
2019,Winter,04:00:00 AM,0,0,0,clear night,
2019,Fall,07:00:00 AM,55,37,18,rain,
2019,Spring,08:00:00 PM,494,225,269,partly cloudy night,Mother's Day
2019,Summer,10:00:00 PM,12,3,9,partly cloudy night,
2019,Summer,09:00:00 AM,1104,631,473,clear day,
2019,Spring,08:00:00 PM,15,13,2,clear night,
2019,Spring,11:00:00 AM,1559,800,759,partly cloudy day,
2019,Fall,11:00:00 PM,28,27,1,partly cloudy night,Daylight Saving Time ends
2019,Winter,02:00:00 PM,1388,636,752,clear day,
2019,Winter,08:00:00 AM,192,56,136,partly cloudy day,
2019,Summer,05:00:00 PM,2541,1098,1443,partly cloudy day,
2019,Fall,06:00:00 AM,118,87,31,clear night,
2019,Spring,01:00:00 PM,1564,721,843,clear day,
2019,Fall,10:00:00 AM,394,187,207,cloudy,
2019,Winter,01:00:00 PM,3371,2061,1310,clear day,
2019,Winter,01:00:00 PM,127,61,66,rain,
2019,Fall,06:00:00 PM,2122,1152,970,clear day,
2019,Summer,11:00:00 PM,15,12,3,cloudy,
2019,Winter,08:00:00 AM,197,99,98,partly cloudy day,
2019,Winter,10:00:00 PM,0,0,0,clear night,
2019,Winter,01:00:00 AM,4,0,4,rain,
2019,Fall,06:00:00 PM,1486,838,648,partly cloudy day,Labor Day
2019,Fall,06:00:00 AM,121,63,58,partly cloudy night,
2019,Winter,01:00:00 AM,0,0,0,clear night,
2019,Spring,08:00:00 PM,71,46,25,partly cloudy night,
2019,Winter,10:00:00 AM,2059,1284,775,partly cloudy day,
2019,Spring,12:00:00 AM,2,1,1,clear night,
2019,Winter,07:00:00 AM,129,63,66,partly cloudy night,
2019,Summer,08:00:00 AM,305,158,147,cloudy,
2019,Summer,07:00:00 PM,1993,1001,992,partly cloudy day,
2019,Fall,08:00:00 AM,284,114,170,partly cloudy day,
2019,Spring,03:00:00 AM,0,0,0,clear night,
2019,Spring,05:00:00 PM,1613,581,1032,cloudy,
2019,Spring,05:00:00 PM,1089,539,550,clear day,
2019,Spring,11:00:00 PM,14,14,0,clear night,
2019,Fall,03:00:00 AM,3,2,1,clear night,
2019,Summer,09:00:00 AM,731,418,313,clear day,
2019,Summer,02:00:00 AM,1,0,1,clear night,
2019,Spring,11:00:00 AM,1585,633,952,cloudy,
2019,Summer,04:00:00 AM,4,0,4,clear night,
2019,Winter,04:00:00 AM,1,1,0,clear night,
2019,Summer,01:00:00 PM,2362,1123,1239,partly cloudy day,
2019,Spring,03:00:00 AM,0,0,0,clear night,St. Patrick's Day
2019,Fall,08:00:00 AM,152,40,112,rain,
2019,Summer,04:00:00 PM,2100,952,1148,clear day,
2019,Summer,02:00:00 PM,2155,937,1218,clear day,
2019,Spring,12:00:00 AM,21,0,21,clear night,
2019,Winter,01:00:00 PM,2991,1336,1655,partly cloudy day,
2019,Summer,02:00:00 PM,1263,621,642,cloudy,
2019,Spring,08:00:00 AM,101,34,67,cloudy,
2019,Fall,03:00:00 AM,0,0,0,clear night,
2019,Spring,06:00:00 AM,99,54,45,clear night,
2019,Fall,09:00:00 PM,22,21,1,clear night,
2019,Winter,05:00:00 PM,1318,662,656,clear day,
2019,Summer,02:00:00 AM,1,0,1,cloudy,
2019,Spring,11:00:00 PM,1,0,1,clear night,
2019,Fall,11:00:00 AM,2370,1136,1234,clear day,
2019,Summer,04:00:00 AM,2,0,2,clear night,
2019,Spring,11:00:00 AM,2553,1281,1272,clear day,
2019,Fall,02:00:00 PM,2606,1182,1424,partly cloudy day,
2019,Fall,02:00:00 AM,3,2,1,partly cloudy night,
2019,Winter,03:00:00 PM,510,254,256,rain,
2019,Fall,07:00:00 AM,111,50,61,clear day,
2019,Summer,03:00:00 AM,1,0,1,cloudy,
2019,Spring,05:00:00 AM,0,0,0,clear night,
2019,Winter,04:00:00 AM,1,0,1,cloudy,
2019,Spring,03:00:00 PM,2590,1196,1394,clear day,
2019,Spring,06:00:00 PM,33,27,6,cloudy,
2019,Spring,09:00:00 PM,94,93,1,rain,
2019,Winter,01:00:00 AM,1,0,1,partly cloudy night,
2019,Winter,06:00:00 AM,58,32,26,clear night,
2019,Summer,04:00:00 PM,2231,1080,1151,clear day,
2019,Fall,03:00:00 PM,2138,950,1188,clear day,
2019,Summer,11:00:00 PM,24,8,16,cloudy,
2019,Fall,07:00:00 PM,81,0,81,clear night,
2019,Summer,05:00:00 AM,8,5,3,cloudy,
2019,Spring,01:00:00 PM,1559,710,849,cloudy,
2019,Fall,12:00:00 AM,4,2,2,clear night,
2019,Summer,11:00:00 PM,11,7,4,partly cloudy night,
2019,Summer,08:00:00 AM,430,166,264,clear day,
2019,Summer,01:00:00 AM,8,5,3,clear night,
2019,Summer,12:00:00 AM,4,1,3,clear night,
2019,Summer,01:00:00 PM,2134,922,1212,clear day,
2019,Summer,02:00:00 PM,2702,1160,1542,partly cloudy day,
2019,Spring,03:00:00 PM,1855,851,1004,clear day,
2019,Winter,10:00:00 AM,1385,899,486,clear day,Christmas Day
2019,Fall,09:00:00 PM,4,3,1,clear night,
2019,Summer,01:00:00 PM,1961,764,1197,clear day,
2019,Summer,06:00:00 PM,1733,974,759,partly cloudy day,
2019,Winter,03:00:00 AM,0,0,0,clear night,
2019,Winter,02:00:00 PM,1852,775,1077,clear day,Christmas Eve
2019,Spring,05:00:00 AM,9,7,2,partly cloudy night,
2019,Winter,05:00:00 PM,410,224,186,clear night,
2019,Fall,11:00:00 AM,1805,872,933,partly cloudy day,
2019,Fall,05:00:00 PM,527,269,258,partly cloudy night,
2019,Winter,05:00:00 PM,56,54,2,clear night,
2019,Fall,07:00:00 AM,145,66,79,clear day,
2019,Summer,04:00:00 AM,2,0,2,clear night,
2019,Summer,03:00:00 AM,0,0,0,clear night,
2019,Summer,09:00:00 AM,723,420,303,partly cloudy day,
2019,Summer,05:00:00 AM,64,55,9,clear night,
2019,Spring,02:00:00 PM,3894,1604,2290,cloudy,Easter Sunday
2019,Winter,05:00:00 AM,5,2,3,clear night,
2019,Spring,08:00:00 PM,27,24,3,clear night,
2019,Spring,08:00:00 AM,447,164,283,partly cloudy day,
2019,Winter,04:00:00 AM,3,0,3,cloudy,
2019,Winter,11:00:00 PM,14,12,2,clear night,
2019,Winter,05:00:00 PM,912,410,502,partly cloudy day,
2019,Winter,04:00:00 AM,0,0,0,clear night,
2019,Summer,02:00:00 PM,1035,465,570,clear day,
2019,Spring,12:00:00 PM,1741,741,1000,cloudy,
2019,Fall,01:00:00 AM,3,3,0,partly cloudy night,
2019,Winter,05:00:00 PM,38,36,2,clear night,Christmas Day
2019,Summer,03:00:00 AM,0,0,0,clear night,
2019,Spring,10:00:00 AM,1609,877,732,clear day,
2019,Summer,05:00:00 AM,16,12,4,partly cloudy night,
2019,Spring,11:00:00 PM,85,80,5,clear night,
2019,Summer,11:00:00 PM,0,0,0,clear night,
2019,Winter,03:00:00 PM,2219,1039,1180,clear day,
2019,Fall,05:00:00 PM,855,400,455,rain,
2019,Fall,01:00:00 PM,1190,436,754,clear day,
2019,Spring,05:00:00 AM,48,26,22,partly cloudy night,
2019,Summer,10:00:00 AM,1023,610,413,clear day,
2019,Fall,11:00:00 AM,1109,474,635,cloudy,
2019,Winter,02:00:00 PM,4008,1994,2014,partly cloudy day,New Year's Day
2019,Fall,10:00:00 PM,10,6,4,cloudy,
2019,Spring,05:00:00 AM,0,0,0,clear night,
2019,Summer,05:00:00 AM,35,20,15,cloudy,
2019,Fall,04:00:00 AM,0,0,0,clear night,
2019,Summer,05:00:00 PM,1597,686,911,rain,
2019,Summer,04:00:00 PM,3308,1434,1874,partly cloudy day,
2019,Spring,11:00:00 AM,3166,1165,2001,partly cloudy day,
2019,Spring,12:00:00 AM,1,0,1,cloudy,
2019,Spring,12:00:00 PM,2276,987,1289,clear day,
2019,Summer,12:00:00 PM,1323,689,634,rain,
2019,Summer,02:00:00 AM,1,0,1,cloudy,
2019,Spring,03:00:00 AM,0,0,0,cloudy,
2019,Fall,05:00:00 AM,1,0,1,rain,Halloween
2019,Spring,05:00:00 AM,38,26,12,cloudy,
2019,Winter,03:00:00 AM,0,0,0,clear night,
2019,Summer,04:00:00 AM,5,0,5,clear night,
2019,Winter,06:00:00 PM,160,158,2,partly cloudy night,
2019,Fall,07:00:00 AM,75,35,40,rain,Halloween
2019,Summer,03:00:00 PM,1271,635,636,partly cloudy day,
2019,Fall,05:00:00 PM,67,61,6,clear night,
2019,Spring,05:00:00 PM,1180,613,567,rain,
2019,Summer,02:00:00 AM,1,1,0,clear night,
2019,Summer,06:00:00 PM,656,329,327,rain,
2019,Summer,12:00:00 AM,5,0,5,cloudy,
2019,Fall,12:00:00 AM,2,0,2,cloudy,
2019,Fall,02:00:00 AM,1,0,1,clear night,
2019,Spring,04:00:00 PM,2612,1150,1462,partly cloudy day,
2019,Spring,02:00:00 PM,1139,534,605,cloudy,
2019,Summer,08:00:00 PM,1254,479,775,clear day,
2019,Fall,02:00:00 PM,1734,787,947,cloudy,
2019,Spring,11:00:00 PM,28,21,7,clear night,
2019,Spring,06:00:00 AM,81,39,42,partly cloudy night,
2019,Summer,03:00:00 AM,0,0,0,partly cloudy night,
2019,Fall,08:00:00 PM,84,0,84,cloudy,
2019,Spring,05:00:00 PM,2090,849,1241,clear day,
2019,Summer,06:00:00 AM,166,60,106,clear day,Independence Day
2019,Spring,11:00:00 PM,9,9,0,clear night,
2019,Spring,11:00:00 AM,1898,979,919,partly cloudy day,
2019,Winter,04:00:00 PM,813,358,455,cloudy,
2019,Winter,09:00:00 PM,6,5,1,clear night,
2019,Fall,10:00:00 AM,1000,562,438,partly cloudy day,
2019,Fall,03:00:00 PM,1890,878,1012,partly cloudy day,
2019,Fall,12:00:00 AM,0,0,0,clear night,
2019,Fall,03:00:00 PM,1803,851,952,cloudy,
2019,Spring,10:00:00 AM,2224,1286,938,clear day,
2019,Fall,10:00:00 AM,1066,587,479,partly cloudy day,
2019,Spring,08:00:00 AM,276,108,168,partly cloudy day,
2019,Spring,11:00:00 AM,3912,2279,1633,clear day,
2019,Summer,12:00:00 PM,1714,793,921,partly cloudy day,
2019,Winter,01:00:00 AM,0,0,0,partly cloudy night,
2019,Spring,04:00:00 AM,0,0,0,clear night,
2019,Winter,02:00:00 AM,2,0,2,rain,
2019,Fall,01:00:00 AM,0,0,0,partly cloudy night,
2019,Fall,03:00:00 AM,0,0,0,clear night,
2019,Summer,02:00:00 PM,1769,802,967,cloudy,
2019,Spring,08:00:00 PM,439,191,248,partly cloudy night,
2019,Spring,03:00:00 AM,0,0,0,clear night,Easter Monday
2019,Fall,08:00:00 AM,293,99,194,cloudy,
2019,Winter,11:00:00 PM,0,0,0,clear night,
2019,Winter,12:00:00 AM,1,0,1,clear night,
2019,Summer,11:00:00 PM,109,96,13,clear night,
2019,Winter,04:00:00 PM,229,154,75,rain,
2019,Fall,07:00:00 PM,122,53,69,cloudy,
2019,Fall,10:00:00 AM,1125,617,508,clear day,
2019,Spring,11:00:00 AM,1438,740,698,cloudy,
2019,Summer,12:00:00 PM,1731,768,963,partly cloudy day,
2019,Summer,04:00:00 AM,0,0,0,partly cloudy night,
2019,Winter,05:00:00 PM,0,0,0,partly cloudy day,
2019,Spring,10:00:00 PM,12,8,4,rain,
2019,Summer,05:00:00 PM,1943,1052,891,clear day,
2019,Fall,11:00:00 PM,25,19,6,partly cloudy night,
2019,Summer,11:00:00 PM,65,61,4,clear night,Independence Day
2019,Spring,06:00:00 AM,152,69,83,partly cloudy day,
2019,Summer,11:00:00 PM,3,2,1,partly cloudy night,
2019,Spring,01:00:00 PM,655,298,357,cloudy,
2019,Spring,07:00:00 PM,700,292,408,cloudy,
2019,Fall,09:00:00 PM,3,2,1,clear night,
2019,Winter,12:00:00 PM,620,283,337,cloudy,
2019,Fall,12:00:00 PM,2210,1028,1182,clear day,
2019,Fall,03:00:00 AM,0,0,0,clear night,
2019,Fall,02:00:00 AM,0,0,0,partly cloudy night,
2019,Winter,04:00:00 AM,0,0,0,partly cloudy night,
2019,Spring,03:00:00 PM,3398,1622,1776,clear day,
2019,Fall,06:00:00 AM,190,99,91,cloudy,
2019,Winter,06:00:00 PM,8,7,1,partly cloudy night,
2019,Winter,12:00:00 AM,1,0,1,clear night,
2019,Summer,12:00:00 AM,1,0,1,clear night,
2019,Spring,11:00:00 PM,2,0,2,clear night,
2019,Fall,10:00:00 PM,8,6,2,wind,
2019,Fall,02:00:00 PM,2587,1161,1426,clear day,Columbus Day (regional holiday)
2019,Spring,10:00:00 PM,30,21,9,cloudy,
2019,Winter,06:00:00 AM,7,3,4,cloudy,
2019,Fall,03:00:00 AM,0,0,0,rain,
2019,Summer,09:00:00 AM,247,132,115,rain,
2019,Fall,03:00:00 PM,2689,1120,1569,cloudy,
2019,Spring,01:00:00 PM,1768,691,1077,partly cloudy day,
2019,Fall,03:00:00 PM,1413,630,783,clear day,
2019,Fall,04:00:00 AM,0,0,0,clear night,Daylight Saving Time ends
2019,Summer,04:00:00 AM,0,0,0,clear night,
2019,Winter,02:00:00 PM,860,472,388,cloudy,
2019,Spring,08:00:00 PM,300,128,172,partly cloudy night,
2019,Summer,05:00:00 AM,66,38,28,clear night,
2019,Fall,05:00:00 AM,0,0,0,cloudy,
2019,Spring,11:00:00 AM,332,128,204,cloudy,
2019,Summer,12:00:00 AM,4,2,2,clear night,
2019,Spring,05:00:00 AM,0,0,0,rain,Tax Day
2019,Summer,06:00:00 PM,2389,1365,1024,partly cloudy day,
2019,Fall,06:00:00 PM,1659,956,703,partly cloudy day,
2019,Summer,10:00:00 PM,77,68,9,clear night,
2019,Spring,05:00:00 PM,2114,1022,1092,partly cloudy day,
2019,Winter,10:00:00 AM,637,363,274,partly cloudy day,
2019,Spring,08:00:00 PM,17,0,17,cloudy,
2019,Spring,12:00:00 PM,1435,681,754,clear day,
2019,Winter,04:00:00 PM,1386,636,750,clear day,
2019,Summer,02:00:00 PM,2094,971,1123,partly cloudy day,
2019,Fall,02:00:00 PM,2413,1083,1330,clear day,
2019,Spring,09:00:00 AM,560,258,302,clear day,
2019,Fall,12:00:00 AM,0,0,0,partly cloudy night,Thanksgiving Day
2019,Fall,06:00:00 PM,63,0,63,partly cloudy night,
2019,Winter,11:00:00 AM,1020,569,451,partly cloudy day,
2019,Winter,03:00:00 AM,2,1,1,partly cloudy night,
2019,Spring,12:00:00 PM,2490,1083,1407,clear day,
2019,Spring,04:00:00 AM,2,1,1,rain,Mother's Day
2019,Summer,05:00:00 AM,80,41,39,partly cloudy night,
2019,Winter,07:00:00 PM,68,57,11,cloudy,
2019,Winter,10:00:00 PM,7,0,7,clear night,
2019,Spring,11:00:00 PM,4,0,4,partly cloudy night,
2019,Fall,04:00:00 AM,0,0,0,clear night,Veterans Day
2019,Spring,06:00:00 PM,258,148,110,rain,
2019,Fall,07:00:00 PM,66,64,2,clear night,
2019,Fall,02:00:00 AM,0,0,0,clear night,
2019,Winter,05:00:00 AM,1,0,1,cloudy,
2019,Winter,06:00:00 AM,13,5,8,clear night,
2019,Winter,07:00:00 AM,66,35,31,clear night,
2019,Spring,05:00:00 AM,80,60,20,cloudy,
2019,Summer,02:00:00 AM,1,1,0,cloudy,
2019,Winter,10:00:00 AM,811,443,368,clear day,
2019,Fall,04:00:00 AM,1,1,0,clear night,
2019,Winter,05:00:00 AM,1,0,1,partly cloudy night,
2019,Winter,08:00:00 AM,195,64,131,clear day,
2019,Winter,05:00:00 AM,3,0,3,rain,
2019,Summer,08:00:00 AM,606,201,405,partly cloudy day,
2019,Fall,08:00:00 AM,465,215,250,partly cloudy day,
2019,Spring,06:00:00 PM,535,273,262,rain,Easter Monday
2019,Spring,05:00:00 AM,22,15,7,cloudy,
2019,Winter,01:00:00 AM,0,0,0,clear night,
2019,Spring,02:00:00 AM,0,0,0,clear night,
2019,Summer,02:00:00 PM,2637,1184,1453,partly cloudy day,
2019,Fall,04:00:00 AM,0,0,0,partly cloudy night,
2019,Summer,02:00:00 AM,1,0,1,clear night,
2019,Spring,02:00:00 PM,1130,484,646,cloudy,
2019,Fall,03:00:00 AM,0,0,0,clear night,
2019,Winter,01:00:00 PM,3267,1790,1477,partly cloudy day,
2019,Winter,05:00:00 PM,733,319,414,cloudy,
2019,Winter,07:00:00 AM,118,51,67,clear day,
2019,Summer,03:00:00 AM,1,0,1,clear night,
2019,Summer,05:00:00 AM,84,56,28,clear night,
2019,Winter,04:00:00 AM,5,4,1,cloudy,
2019,Summer,06:00:00 PM,1836,990,846,partly cloudy day,
2019,Spring,02:00:00 AM,1,0,1,partly cloudy night,
2019,Fall,06:00:00 PM,28,26,2,partly cloudy night,
2019,Spring,01:00:00 AM,0,0,0,clear night,
2019,Summer,12:00:00 AM,11,7,4,rain,
2019,Spring,05:00:00 PM,971,512,459,partly cloudy day,
2019,Spring,03:00:00 PM,1765,962,803,cloudy,
2019,Spring,04:00:00 PM,2007,996,1011,partly cloudy day,
2019,Fall,05:00:00 PM,1903,896,1007,partly cloudy day,
2019,Winter,11:00:00 PM,0,0,0,cloudy,
2019,Summer,05:00:00 AM,50,34,16,cloudy,
2019,Fall,05:00:00 PM,1321,667,654,cloudy,
2019,Summer,10:00:00 PM,59,54,5,partly cloudy night,
2019,Summer,05:00:00 AM,65,25,40,partly cloudy night,
2019,Spring,06:00:00 PM,2474,1111,1363,clear day,
2019,Winter,09:00:00 AM,634,314,320,partly cloudy day,
2019,Summer,03:00:00 PM,1855,817,1038,cloudy,
2019,Summer,12:00:00 AM,4,2,2,clear night,
2019,Spring,05:00:00 PM,1391,669,722,cloudy,
2019,Spring,04:00:00 PM,2592,1078,1514,cloudy,
2019,Winter,09:00:00 PM,53,52,1,clear night,
2019,Spring,08:00:00 AM,276,105,171,clear day,
2019,Spring,05:00:00 PM,1381,641,740,cloudy,
2019,Winter,10:00:00 PM,0,0,0,clear night,
2019,Winter,09:00:00 PM,31,15,16,clear night,
2019,Winter,03:00:00 PM,1125,1125,0,clear day,
2019,Fall,02:00:00 PM,3177,1381,1796,clear day,
2019,Summer,12:00:00 AM,21,20,1,partly cloudy night,
2019,Fall,06:00:00 AM,174,121,53,clear night,
2019,Fall,02:00:00 AM,0,0,0,clear night,
2019,Fall,01:00:00 PM,3189,1408,1781,partly cloudy day,
2019,Fall,08:00:00 PM,84,71,13,clear night,
2019,Summer,12:00:00 AM,3,1,2,clear night,
2019,Fall,03:00:00 PM,2665,1163,1502,clear day,
2019,Spring,12:00:00 AM,0,0,0,partly cloudy night,
2019,Fall,04:00:00 PM,3138,1421,1717,clear day,
2019,Summer,09:00:00 AM,839,517,322,clear day,
2019,Summer,06:00:00 PM,2063,1097,966,partly cloudy day,
2019,Summer,08:00:00 AM,380,106,274,partly cloudy day,
2019,Spring,05:00:00 PM,1852,974,878,partly cloudy day,
2019,Summer,04:00:00 PM,2738,1152,1586,partly cloudy day,
2019,Winter,05:00:00 AM,0,0,0,clear night,
2019,Summer,11:00:00 AM,2252,1350,902,clear day,
2019,Spring,06:00:00 PM,2784,1131,1653,partly cloudy day,
2019,Summer,08:00:00 PM,900,309,591,partly cloudy day,
2019,Spring,02:00:00 PM,3322,1499,1823,clear day,
2019,Winter,04:00:00 AM,0,0,0,partly cloudy night,
2019,Winter,09:00:00 AM,613,312,301,cloudy,
2019,Summer,02:00:00 PM,1469,655,814,rain,
2019,Spring,10:00:00 PM,11,2,9,cloudy,
2019,Summer,12:00:00 PM,2142,1109,1033,partly cloudy day,Independence Day
2019,Fall,02:00:00 PM,1486,634,852,cloudy,
2019,Winter,03:00:00 AM,0,0,0,cloudy,Valentine's Day
2019,Winter,04:00:00 AM,0,0,0,clear night,
2019,Fall,04:00:00 PM,1885,864,1021,cloudy,
2019,Spring,07:00:00 PM,1317,678,639,clear day,
2019,Summer,03:00:00 PM,173,115,58,rain,
2019,Fall,09:00:00 AM,803,441,362,cloudy,Columbus Day (regional holiday)
2019,Fall,04:00:00 AM,0,0,0,clear night,
2019,Winter,01:00:00 PM,1544,732,812,clear day,
2019,Fall,07:00:00 PM,79,53,26,clear night,
2019,Spring,09:00:00 AM,932,486,446,clear day,
2019,Spring,03:00:00 AM,0,0,0,partly cloudy night,
2019,Summer,05:00:00 PM,1812,934,878,clear day,
2019,Winter,04:00:00 PM,3146,1555,1591,clear day,New Year's Eve
2019,Spring,04:00:00 AM,0,0,0,cloudy,
2019,Fall,08:00:00 AM,286,119,167,clear day,
2019,Winter,02:00:00 PM,786,368,418,cloudy,
2019,Winter,04:00:00 AM,3,1,2,rain,
2019,Summer,11:00:00 PM,8,4,4,partly cloudy night,
2019,Summer,01:00:00 PM,2403,1097,1306,partly cloudy day,
2019,Summer,07:00:00 PM,1397,811,586,partly cloudy day,
2019,Winter,01:00:00 PM,1126,478,648,clear day,
2019,Winter,11:00:00 AM,3050,1564,1486,cloudy,New Year's Eve
2019,Fall,03:00:00 AM,1,0,1,partly cloudy night,
2019,Fall,10:00:00 AM,1370,732,638,partly cloudy day,
2019,Spring,03:00:00 PM,3356,1509,1847,partly cloudy day,
2019,Fall,11:00:00 PM,2,1,1,partly cloudy night,
2019,Winter,12:00:00 AM,4,0,4,rain,
2019,Summer,11:00:00 PM,13,8,5,partly cloudy night,
2019,Fall,10:00:00 AM,1447,764,683,clear day,
2019,Summer,08:00:00 AM,371,155,216,cloudy,
2019,Spring,09:00:00 AM,307,163,144,clear day,
2019,Spring,08:00:00 PM,26,18,8,cloudy,
2019,Fall,04:00:00 AM,0,0,0,partly cloudy night,
2019,Spring,02:00:00 AM,0,0,0,rain,
2019,Winter,01:00:00 AM,0,0,0,clear night,
2019,Spring,03:00:00 AM,0,0,0,partly cloudy night,
2019,Fall,04:00:00 AM,1,0,1,clear night,
2019,Fall,01:00:00 PM,461,246,215,rain,
2019,Fall,10:00:00 AM,1436,859,577,partly cloudy day,
2019,Winter,02:00:00 PM,963,413,550,cloudy,
2019,Winter,08:00:00 AM,310,116,194,partly cloudy day,
2019,Fall,12:00:00 AM,7,3,4,clear night,
2019,Fall,01:00:00 AM,0,0,0,cloudy,
2019,Winter,07:00:00 AM,24,11,13,rain,
2019,Fall,01:00:00 AM,1,0,1,partly cloudy night,
2019,Spring,03:00:00 AM,0,0,0,cloudy,
2019,Spring,12:00:00 AM,12,0,12,cloudy,St. Patrick's Day
2019,Winter,09:00:00 PM,3,0,3,clear night,
2019,Summer,10:00:00 AM,1576,925,651,clear day,
2019,Winter,01:00:00 PM,390,191,199,snow,
2019,Fall,01:00:00 PM,1835,793,1042,partly cloudy day,
2019,Spring,01:00:00 AM,1,0,1,cloudy,
2019,Summer,03:00:00 PM,2260,974,1286,partly cloudy day,
2019,Spring,01:00:00 PM,3275,1513,1762,clear day,Memorial Day
2019,Summer,02:00:00 PM,2027,935,1092,cloudy,Father's Day
2019,Winter,02:00:00 PM,1952,880,1072,partly cloudy day,
2019,Winter,01:00:00 PM,1310,593,717,clear day,
2019,Summer,12:00:00 AM,3,0,3,clear night,
2019,Spring,08:00:00 PM,8,4,4,clear night,
2019,Summer,03:00:00 AM,0,0,0,clear night,
2019,Spring,07:00:00 AM,228,112,116,clear day,
2019,Winter,11:00:00 AM,911,409,502,partly cloudy day,
2019,Spring,02:00:00 PM,1966,869,1097,clear day,
2019,Spring,01:00:00 AM,1,0,1,clear night,
2019,Winter,09:00:00 PM,6,6,0,clear night,Christmas Day
2019,Fall,12:00:00 PM,497,225,272,rain,Labor Day
2019,Fall,06:00:00 AM,38,18,20,cloudy,
2019,Summer,12:00:00 AM,4,2,2,partly cloudy night,
2019,Spring,01:00:00 AM,2,2,0,cloudy,
2019,Summer,09:00:00 AM,727,363,364,clear day,
2019,Fall,09:00:00 AM,873,524,349,cloudy,
2019,Fall,10:00:00 AM,1214,592,622,cloudy,Labor Day
2019,Fall,02:00:00 PM,2154,1042,1112,clear day,
2019,Summer,06:00:00 AM,175,90,85,partly cloudy night,
2019,Summer,01:00:00 PM,870,404,466,partly cloudy day,
2019,Summer,02:00:00 PM,1573,662,911,partly cloudy day,
2019,Summer,12:00:00 PM,1974,841,1133,partly cloudy day,
2019,Winter,12:00:00 PM,1491,671,820,partly cloudy day,
2019,Spring,09:00:00 AM,483,273,210,clear day,
2019,Fall,11:00:00 PM,8,7,1,clear night,
2019,Spring,03:00:00 AM,0,0,0,clear night,
2019,Summer,02:00:00 PM,2795,1142,1653,clear day,
2019,Winter,07:00:00 AM,141,47,94,cloudy,
2019,Spring,02:00:00 AM,0,0,0,partly cloudy night,
2019,Winter,09:00:00 PM,37,23,14,cloudy,
2019,Summer,09:00:00 AM,666,367,299,partly cloudy day,
2019,Summer,01:00:00 AM,0,0,0,clear night,
2019,Winter,08:00:00 PM,51,26,25,partly cloudy night,New Year's Day
2019,Fall,05:00:00 PM,2037,1033,1004,clear day,
2019,Summer,03:00:00 PM,2261,964,1297,partly cloudy day,
2019,Winter,07:00:00 PM,51,30,21,cloudy,
2019,Fall,11:00:00 AM,430,204,226,rain,
2019,Fall,12:00:00 PM,1663,800,863,partly cloudy day,
2019,Fall,08:00:00 PM,61,60,1,clear night,
2019,Summer,06:00:00 PM,1791,1000,791,partly cloudy day,
2019,Winter,11:00:00 PM,27,0,27,clear night,
2019,Summer,02:00:00 PM,2135,975,1160,partly cloudy day,
2019,Spring,09:00:00 AM,341,179,162,clear day,
2019,Summer,03:00:00 PM,2367,1036,1331,partly cloudy day,
2019,Spring,08:00:00 AM,395,150,245,cloudy,
2019,Fall,10:00:00 PM,23,15,8,partly cloudy night,
2019,Winter,11:00:00 PM,3,2,1,partly cloudy night,
2019,Fall,09:00:00 AM,984,537,447,partly cloudy day,
2019,Winter,05:00:00 AM,1,0,1,cloudy,
2019,Spring,12:00:00 AM,0,0,0,clear night,
2019,Summer,06:00:00 PM,1948,1047,901,partly cloudy day,
2019,Winter,01:00:00 PM,1006,465,541,cloudy,
2019,Winter,06:00:00 AM,60,28,32,clear night,
2019,Fall,02:00:00 AM,0,0,0,cloudy,
2019,Spring,06:00:00 PM,1218,629,589,clear day,
2019,Fall,05:00:00 AM,0,0,0,partly cloudy night,
2019,Fall,03:00:00 PM,1561,660,901,cloudy,
2019,Fall,04:00:00 AM,0,0,0,cloudy,
2019,Fall,02:00:00 AM,0,0,0,cloudy,
2019,Summer,03:00:00 AM,1,0,1,clear night,
2019,Winter,04:00:00 AM,0,0,0,rain,
2019,Summer,09:00:00 AM,777,453,324,partly cloudy day,
2019,Summer,12:00:00 PM,1413,632,781,clear day,
2019,Fall,07:00:00 PM,408,165,243,partly cloudy night,
2019,Winter,02:00:00 AM,2,0,2,clear night,Christmas Eve
2019,Fall,10:00:00 PM,19,13,6,clear night,
2019,Summer,08:00:00 AM,396,226,170,clear day,
2019,Spring,07:00:00 AM,95,38,57,rain,
2019,Fall,03:00:00 AM,0,0,0,partly cloudy night,
2019,Spring,03:00:00 PM,2067,895,1172,cloudy,
2019,Winter,07:00:00 PM,13,9,4,clear night,
2019,Winter,10:00:00 PM,41,19,22,cloudy,
2019,Fall,11:00:00 PM,3,3,0,cloudy,
2019,Spring,01:00:00 AM,1,1,0,cloudy,
2019,Summer,04:00:00 AM,0,0,0,partly cloudy night,
2019,Summer,09:00:00 PM,25,13,12,cloudy,
2019,Summer,06:00:00 AM,128,78,50,cloudy,
2019,Winter,09:00:00 AM,440,259,181,clear day,
2019,Winter,09:00:00 PM,46,24,22,partly cloudy night,
2019,Spring,09:00:00 PM,2,0,2,cloudy,
2019,Winter,06:00:00 AM,21,16,5,clear night,
2019,Summer,02:00:00 PM,2129,973,1156,partly cloudy day,
2019,Summer,07:00:00 PM,2545,1244,1301,partly cloudy day,
2019,Summer,08:00:00 AM,438,172,266,partly cloudy day,
2019,Winter,03:00:00 AM,1,0,1,clear night,
2019,Spring,12:00:00 PM,954,415,539,partly cloudy day,
2019,Winter,07:00:00 AM,145,89,56,clear night,Christmas Day
2019,Summer,07:00:00 AM,100,30,70,cloudy,
2019,Fall,08:00:00 AM,434,175,259,clear day,
2019,Summer,08:00:00 AM,900,466,434,partly cloudy day,
2019,Winter,05:00:00 AM,0,0,0,cloudy,
2019,Spring,12:00:00 AM,4,1,3,cloudy,
2019,Winter,02:00:00 AM,2,1,1,cloudy,
2019,Winter,08:00:00 PM,0,0,0,partly cloudy night,
2019,Fall,09:00:00 PM,20,15,5,clear night,
2019,Summer,10:00:00 PM,74,59,15,clear night,
2019,Winter,02:00:00 AM,0,0,0,clear night,
2019,Fall,05:00:00 AM,2,0,2,clear night,
2019,Spring,01:00:00 PM,1821,800,1021,partly cloudy day,
2019,Winter,06:00:00 AM,40,25,15,partly cloudy night,
2019,Summer,06:00:00 AM,205,94,111,clear day,
2019,Summer,09:00:00 PM,128,46,82,partly cloudy night,
2019,Winter,05:00:00 PM,319,180,139,cloudy,
2019,Fall,01:00:00 PM,2323,800,1523,partly cloudy day,
2019,Fall,07:00:00 PM,73,70,3,rain,
2019,Fall,12:00:00 AM,0,0,0,cloudy,
2019,Spring,12:00:00 PM,1458,629,829,cloudy,
2019,Winter,08:00:00 AM,163,63,100,cloudy,
2019,Winter,02:00:00 PM,2630,1190,1440,partly cloudy day,
2019,Winter,11:00:00 AM,1726,876,850,clear day,
2019,Fall,08:00:00 AM,84,41,43,rain,
2019,Spring,07:00:00 PM,2247,821,1426,partly cloudy day,
2019,Summer,12:00:00 PM,857,383,474,clear day,
2019,Spring,01:00:00 AM,1,0,1,cloudy,
2019,Winter,01:00:00 PM,713,305,408,clear day,
2019,Summer,07:00:00 PM,1833,923,910,partly cloudy day,
2019,Spring,02:00:00 PM,3538,1660,1878,partly cloudy day,
2019,Fall,11:00:00 AM,1087,450,637,cloudy,
2019,Fall,07:00:00 PM,59,58,1,clear night,
2019,Spring,12:00:00 AM,51,43,8,clear night,
2019,Fall,07:00:00 PM,2324,1073,1251,partly cloudy day,
2019,Fall,11:00:00 PM,5,0,5,rain,
2019,Summer,03:00:00 PM,1643,771,872,clear day,
2019,Summer,02:00:00 PM,2042,896,1146,partly cloudy day,
2019,Summer,09:00:00 AM,964,671,293,partly cloudy day,
2019,Spring,11:00:00 AM,681,336,345,cloudy,
2019,Winter,08:00:00 AM,225,72,153,clear day,
2019,Fall,03:00:00 PM,2977,1343,1634,cloudy,
2019,Spring,08:00:00 AM,188,72,116,partly cloudy day,
2019,Winter,10:00:00 PM,7,7,0,clear night,
2019,Fall,03:00:00 PM,2548,1187,1361,clear day,
2019,Winter,10:00:00 PM,7,0,7,clear night,
2019,Summer,02:00:00 PM,1466,637,829,clear day,
2019,Summer,09:00:00 PM,45,27,18,clear night,
2019,Fall,11:00:00 PM,0,0,0,clear night,
2019,Summer,12:00:00 AM,3,2,1,clear night,
2019,Fall,02:00:00 PM,1977,926,1051,partly cloudy day,
2019,Winter,07:00:00 AM,147,72,75,cloudy,
2019,Spring,02:00:00 PM,2785,1315,1470,partly cloudy day,
2019,Spring,12:00:00 AM,0,0,0,partly cloudy night,
2019,Summer,01:00:00 PM,3279,1586,1693,partly cloudy day,
2019,Summer,08:00:00 AM,432,183,249,clear day,
2019,Spring,06:00:00 PM,2144,1147,997,clear day,
2019,Winter,12:00:00 PM,700,347,353,cloudy,
2019,Winter,11:00:00 AM,544,339,205,rain,
2019,Summer,10:00:00 AM,878,495,383,cloudy,
2019,Winter,09:00:00 AM,1096,635,461,clear day,
2019,Summer,03:00:00 PM,2590,1167,1423,cloudy,
2019,Spring,10:00:00 PM,7,2,5,clear night,
2019,Spring,08:00:00 AM,250,87,163,clear day,
2019,Fall,02:00:00 AM,0,0,0,partly cloudy night,
2019,Summer,12:00:00 AM,8,5,3,clear night,
2019,Summer,03:00:00 PM,2039,946,1093,partly cloudy day,
2019,Winter,03:00:00 PM,3173,1930,1243,partly cloudy day,
2019,Spring,09:00:00 AM,66,39,27,rain,Daylight Saving Time starts
2019,Winter,02:00:00 PM,3099,1623,1476,cloudy,
2019,Summer,07:00:00 PM,2008,903,1105,clear day,
2019,Summer,12:00:00 PM,1759,801,958,clear day,
2019,Summer,05:00:00 PM,1681,855,826,partly cloudy day,
2019,Winter,01:00:00 AM,4,1,3,cloudy,
2019,Spring,09:00:00 PM,9,0,9,rain,
2019,Fall,12:00:00 PM,3012,1430,1582,partly cloudy day,
2019,Summer,03:00:00 PM,2224,889,1335,partly cloudy day,
2019,Winter,04:00:00 PM,1687,784,903,cloudy,
2019,Spring,09:00:00 PM,26,24,2,clear night,
2019,Spring,03:00:00 PM,2617,1159,1458,clear day,St. Patrick's Day
2019,Summer,08:00:00 PM,1944,855,1089,partly cloudy day,
2019,Spring,06:00:00 AM,22,15,7,cloudy,
2019,Winter,09:00:00 AM,511,255,256,partly cloudy day,
2019,Spring,01:00:00 PM,716,342,374,rain,Cinco de Mayo
2019,Winter,04:00:00 AM,0,0,0,partly cloudy night,
2019,Summer,12:00:00 PM,1619,730,889,clear day,
2019,Winter,01:00:00 PM,1483,624,859,clear day,
2019,Winter,06:00:00 PM,137,73,64,partly cloudy night,
2019,Spring,07:00:00 PM,802,295,507,clear day,
2019,Spring,12:00:00 PM,685,301,384,rain,
2019,Summer,10:00:00 PM,31,12,19,partly cloudy night,
2019,Summer,03:00:00 AM,0,0,0,partly cloudy night,
2019,Winter,10:00:00 AM,741,423,318,clear day,
2019,Summer,07:00:00 AM,263,135,128,partly cloudy day,
2019,Summer,05:00:00 PM,1843,874,969,partly cloudy day,
2019,Summer,07:00:00 PM,2161,1015,1146,clear day,
2019,Fall,07:00:00 AM,59,26,33,cloudy,
2019,Summer,04:00:00 AM,0,0,0,clear night,
2019,Spring,02:00:00 AM,1,0,1,cloudy,
2019,Spring,05:00:00 AM,41,26,15,clear night,
2019,Winter,06:00:00 AM,19,13,6,clear night,
2019,Winter,08:00:00 PM,7,6,1,rain,
2019,Summer,08:00:00 AM,384,189,195,partly cloudy day,
2019,Fall,08:00:00 PM,2,1,1,clear night,Black Friday
2019,Summer,09:00:00 PM,42,21,21,partly cloudy night,
2019,Spring,03:00:00 AM,0,0,0,clear night,
2019,Fall,12:00:00 AM,1,0,1,clear night,
2019,Winter,01:00:00 AM,1,0,1,cloudy,New Year's Eve
2019,Fall,01:00:00 AM,2,0,2,partly cloudy night,
2019,Spring,02:00:00 AM,0,0,0,clear night,
2019,Fall,02:00:00 PM,1937,819,1118,cloudy,
2019,Spring,08:00:00 PM,183,65,118,partly cloudy night,
2019,Summer,07:00:00 PM,720,339,381,cloudy,
2019,Spring,03:00:00 PM,2349,1037,1312,partly cloudy day,
2019,Summer,01:00:00 PM,1320,597,723,partly cloudy day,
2019,Winter,07:00:00 PM,94,0,94,rain,
2019,Summer,06:00:00 AM,162,90,72,partly cloudy day,
2019,Summer,02:00:00 AM,0,0,0,partly cloudy night,
2019,Spring,12:00:00 PM,1810,820,990,partly cloudy day,
2019,Fall,11:00:00 PM,30,29,1,cloudy,
2019,Winter,11:00:00 PM,6,6,0,cloudy,
2019,Summer,02:00:00 AM,2,0,2,cloudy,
2019,Fall,07:00:00 AM,300,129,171,partly cloudy day,
2019,Spring,01:00:00 PM,2920,1199,1721,clear day,
2019,Winter,08:00:00 PM,42,31,11,cloudy,
2019,Fall,12:00:00 AM,1,0,1,rain,
2019,Winter,01:00:00 PM,2295,1094,1201,clear day,
2019,Winter,12:00:00 AM,2,2,0,clear night,
2019,Summer,01:00:00 AM,5,3,2,rain,
2019,Fall,08:00:00 PM,62,61,1,partly cloudy night,
2019,Fall,08:00:00 AM,442,207,235,clear day,
2019,Winter,09:00:00 PM,5,4,1,clear night,
2019,Winter,08:00:00 AM,236,108,128,cloudy,
2019,Summer,05:00:00 AM,60,33,27,clear night,
2019,Fall,11:00:00 AM,1971,975,996,clear day,
2019,Fall,10:00:00 PM,14,10,4,partly cloudy night,
2019,Fall,06:00:00 PM,857,320,537,partly cloudy day,
2019,Summer,11:00:00 PM,21,12,9,clear night,
2019,Spring,04:00:00 AM,0,0,0,clear night,
2019,Summer,12:00:00 AM,1,0,1,cloudy,
2019,Fall,01:00:00 PM,2445,1034,1411,clear day,
2019,Spring,06:00:00 PM,1855,1059,796,partly cloudy day,
2019,Summer,01:00:00 PM,1953,920,1033,partly cloudy day,
2019,Spring,11:00:00 PM,0,0,0,partly cloudy night,
2019,Fall,03:00:00 AM,0,0,0,clear night,
2019,Fall,04:00:00 AM,0,0,0,rain,
2019,Fall,12:00:00 PM,1262,494,768,fog,
2019,Summer,04:00:00 AM,0,0,0,rain,
2019,Winter,05:00:00 AM,1,0,1,clear night,
2019,Fall,04:00:00 AM,0,0,0,clear night,
2019,Fall,02:00:00 AM,0,0,0,cloudy,
2019,Winter,12:00:00 PM,1354,541,813,clear day,
2019,Spring,09:00:00 PM,7,4,3,partly cloudy night,
2019,Summer,08:00:00 PM,1085,527,558,partly cloudy day,
2019,Summer,11:00:00 AM,1502,785,717,partly cloudy day,
2019,Fall,10:00:00 PM,3,0,3,cloudy,
2019,Summer,08:00:00 AM,409,174,235,clear day,
2019,Summer,04:00:00 PM,2,0,2,clear day,Independence Day
2019,Fall,11:00:00 PM,51,49,2,clear night,
2019,Fall,10:00:00 AM,1283,782,501,cloudy,
2019,Spring,08:00:00 AM,289,154,135,cloudy,
2019,Spring,03:00:00 PM,1452,702,750,cloudy,
2019,Spring,06:00:00 PM,1114,649,465,clear day,
2019,Summer,06:00:00 PM,2530,1124,1406,partly cloudy day,
2019,Winter,08:00:00 PM,54,0,54,cloudy,
2019,Summer,03:00:00 AM,0,0,0,clear night,
2019,Spring,02:00:00 PM,1790,807,983,clear day,
2019,Fall,09:00:00 AM,638,319,319,partly cloudy day,
2019,Winter,12:00:00 AM,3,1,2,partly cloudy night,
2019,Summer,07:00:00 PM,1483,780,703,partly cloudy day,
2019,Spring,01:00:00 AM,3,2,1,snow,
2019,Fall,07:00:00 PM,593,239,354,clear night,
2019,Spring,10:00:00 PM,22,15,7,cloudy,
2019,Summer,04:00:00 PM,1883,848,1035,clear day,
2019,Fall,05:00:00 AM,0,0,0,partly cloudy night,
2019,Summer,05:00:00 AM,40,17,23,partly cloudy night,
2019,Spring,05:00:00 AM,1,0,1,clear night,
2019,Summer,08:00:00 PM,1742,722,1020,clear day,
2019,Winter,11:00:00 PM,1,0,1,clear night,
2019,Summer,09:00:00 AM,713,401,312,partly cloudy day,
2019,Winter,05:00:00 PM,91,84,7,cloudy,
2019,Summer,08:00:00 AM,375,155,220,partly cloudy day,
2019,Winter,07:00:00 PM,36,17,19,partly cloudy night,
2019,Winter,12:00:00 PM,857,455,402,partly cloudy day,
2019,Fall,02:00:00 AM,4,0,4,partly cloudy night,
2019,Fall,03:00:00 AM,0,0,0,clear night,
2019,Spring,10:00:00 AM,1759,1017,742,partly cloudy day,
2019,Spring,12:00:00 AM,39,38,1,cloudy,
2019,Spring,02:00:00 AM,1,1,0,cloudy,
2019,Winter,12:00:00 PM,314,135,179,partly cloudy day,Martin Luther King Jr. Day
2019,Winter,08:00:00 PM,21,14,7,partly cloudy night,
2019,Summer,04:00:00 AM,1,0,1,partly cloudy night,
2019,Fall,08:00:00 PM,67,64,3,cloudy,Halloween
2019,Winter,03:00:00 AM,0,0,0,clear night,
2019,Spring,01:00:00 AM,3,0,3,partly cloudy night,
2019,Spring,08:00:00 PM,1421,574,847,clear day,
2019,Fall,03:00:00 PM,1571,767,804,clear day,
2019,Winter,05:00:00 AM,0,0,0,clear night,
2019,Spring,11:00:00 PM,129,127,2,partly cloudy night,
2019,Fall,09:00:00 AM,458,234,224,clear day,
2019,Fall,01:00:00 AM,3,2,1,rain,Halloween
2019,Summer,11:00:00 PM,36,19,17,partly cloudy night,
2019,Fall,12:00:00 AM,55,0,55,partly cloudy night,
2019,Winter,06:00:00 AM,4,2,2,rain,
2019,Fall,12:00:00 PM,1867,828,1039,clear day,
2019,Winter,12:00:00 PM,594,275,319,partly cloudy day,
2019,Spring,08:00:00 AM,538,275,263,clear day,
2019,Spring,10:00:00 AM,2605,1402,1203,clear day,
2019,Fall,03:00:00 AM,3,2,1,clear night,
2019,Fall,04:00:00 PM,2459,1218,1241,partly cloudy day,
2019,Summer,09:00:00 AM,855,476,379,clear day,
2019,Summer,11:00:00 PM,11,7,4,clear night,
2019,Summer,06:00:00 AM,128,62,66,partly cloudy day,
2019,Spring,08:00:00 PM,50,48,2,partly cloudy night,
2019,Winter,12:00:00 PM,689,344,345,rain,
2019,Summer,11:00:00 PM,11,9,2,partly cloudy night,
2019,Spring,10:00:00 AM,755,401,354,clear day,
2019,Winter,02:00:00 AM,1,0,1,clear night,
2019,Spring,11:00:00 AM,1174,584,590,clear day,
2019,Fall,09:00:00 PM,3,2,1,clear night,
2019,Spring,07:00:00 AM,166,75,91,cloudy,
2019,Fall,08:00:00 AM,437,195,242,clear day,
2019,Fall,11:00:00 AM,1583,722,861,clear day,
2019,Summer,06:00:00 AM,158,79,79,partly cloudy night,
2019,Winter,09:00:00 PM,0,0,0,partly cloudy night,
2019,Summer,09:00:00 PM,207,101,106,clear night,
2019,Summer,10:00:00 PM,10,9,1,rain,
2019,Summer,07:00:00 AM,359,150,209,partly cloudy day,
2019,Summer,03:00:00 AM,0,0,0,partly cloudy night,
2019,Summer,08:00:00 PM,472,262,210,partly cloudy day,
2019,Fall,03:00:00 AM,0,0,0,clear night,
2019,Summer,06:00:00 PM,1611,909,702,partly cloudy day,
2019,Spring,05:00:00 PM,1702,851,851,cloudy,
2019,Spring,03:00:00 AM,0,0,0,partly cloudy night,
2019,Summer,05:00:00 AM,10,8,2,partly cloudy night,
2019,Summer,04:00:00 PM,923,423,500,cloudy,
2019,Spring,11:00:00 AM,1499,713,786,partly cloudy day,St. Patrick's Day
2019,Fall,06:00:00 PM,143,60,83,rain,Halloween
2019,Winter,11:00:00 AM,541,268,273,cloudy,
2019,Winter,08:00:00 PM,231,223,8,rain,
2019,Spring,10:00:00 AM,659,408,251,cloudy,
2019,Fall,10:00:00 PM,54,52,2,partly cloudy night,
2019,Fall,06:00:00 AM,131,79,52,clear night,
2019,Summer,10:00:00 AM,1165,683,482,cloudy,
2019,Fall,11:00:00 PM,86,82,4,cloudy,
2019,Spring,02:00:00 AM,0,0,0,cloudy,
2019,Winter,03:00:00 PM,1336,625,711,partly cloudy day,
2019,Summer,11:00:00 AM,1583,833,750,clear day,
2019,Spring,09:00:00 AM,655,329,326,clear day,
2019,Fall,05:00:00 AM,5,2,3,partly cloudy night,Labor Day
2019,Summer,09:00:00 PM,73,52,21,clear night,
2019,Summer,09:00:00 AM,609,351,258,partly cloudy day,
2019,Summer,10:00:00 AM,1130,663,467,clear day,
2019,Fall,04:00:00 AM,1,0,1,rain,
2019,Winter,05:00:00 AM,1,0,1,cloudy,
2019,Spring,08:00:00 PM,21,18,3,rain,
2019,Winter,11:00:00 AM,1193,624,569,partly cloudy day,
2019,Fall,09:00:00 PM,8,0,8,cloudy,
2019,Winter,03:00:00 PM,286,163,123,rain,
2019,Summer,04:00:00 AM,0,0,0,partly cloudy night,
2019,Spring,03:00:00 PM,481,243,238,rain,
2019,Summer,02:00:00 PM,3192,1377,1815,cloudy,
2019,Summer,04:00:00 PM,919,431,488,rain,
2019,Fall,12:00:00 AM,0,0,0,partly cloudy night,Black Friday
2019,Spring,07:00:00 AM,231,114,117,clear day,
2019,Spring,10:00:00 PM,25,22,3,cloudy,
2019,Fall,11:00:00 PM,7,6,1,cloudy,
2019,Winter,08:00:00 AM,199,72,127,partly cloudy day,
2019,Fall,07:00:00 AM,349,169,180,clear night,
2019,Winter,05:00:00 AM,0,0,0,partly cloudy night,
2019,Spring,01:00:00 PM,1517,669,848,cloudy,
2019,Fall,09:00:00 AM,831,499,332,clear day,
2019,Spring,12:00:00 AM,27,0,27,clear night,Daylight Saving Time starts
2019,Summer,01:00:00 AM,3,1,2,clear night,
2019,Winter,09:00:00 AM,228,86,142,partly cloudy day,
2019,Winter,10:00:00 AM,1367,725,642,clear day,
2019,Spring,09:00:00 PM,75,63,12,clear night,
2019,Summer,10:00:00 PM,11,10,1,rain,
2019,Summer,05:00:00 AM,50,37,13,partly cloudy night,
2019,Winter,09:00:00 PM,40,39,1,partly cloudy night,
2019,Winter,04:00:00 PM,815,415,400,cloudy,
2019,Fall,05:00:00 PM,62,55,7,partly cloudy night,
2019,Spring,03:00:00 AM,1,0,1,clear night,
2019,Summer,05:00:00 PM,1826,805,1021,cloudy,Father's Day
2019,Fall,12:00:00 AM,0,0,0,clear night,
2019,Fall,11:00:00 AM,1186,601,585,clear day,
2019,Summer,05:00:00 AM,34,28,6,clear night,
2019,Summer,08:00:00 PM,1442,709,733,partly cloudy day,
2019,Spring,07:00:00 PM,316,170,146,cloudy,Mother's Day
2019,Fall,12:00:00 AM,0,0,0,clear night,
2019,Spring,10:00:00 AM,2211,1269,942,partly cloudy day,Easter Sunday
2019,Fall,12:00:00 AM,2,1,1,partly cloudy night,Labor Day
2019,Fall,07:00:00 PM,226,116,110,partly cloudy night,
2019,Fall,12:00:00 AM,1,0,1,clear night,
2019,Spring,02:00:00 AM,1,0,1,partly cloudy night,
2019,Spring,09:00:00 PM,29,13,16,clear night,
2019,Spring,03:00:00 AM,2,0,2,cloudy,
2019,Spring,04:00:00 AM,0,0,0,clear night,
2019,Winter,11:00:00 PM,30,28,2,partly cloudy night,
2019,Fall,05:00:00 PM,22,17,5,clear night,Black Friday
2019,Winter,02:00:00 PM,897,416,481,partly cloudy day,
2019,Winter,07:00:00 PM,83,73,10,partly cloudy night,
2019,Spring,11:00:00 PM,12,5,7,clear night,
2019,Fall,02:00:00 AM,1,0,1,clear night,
2019,Winter,10:00:00 PM,5,1,4,partly cloudy night,
2019,Spring,05:00:00 PM,3380,1691,1689,partly cloudy day,
2019,Summer,06:00:00 AM,200,98,102,clear day,
2019,Fall,10:00:00 PM,2,0,2,clear night,
2019,Summer,11:00:00 PM,91,65,26,cloudy,Father's Day
2019,Fall,09:00:00 PM,50,43,7,partly cloudy night,
2019,Winter,01:00:00 PM,980,424,556,clear day,
2019,Fall,03:00:00 PM,2612,1171,1441,partly cloudy day,
2019,Fall,01:00:00 AM,0,0,0,partly cloudy night,
2019,Spring,12:00:00 AM,2,1,1,cloudy,
2019,Fall,06:00:00 AM,97,62,35,cloudy,
2019,Spring,02:00:00 AM,0,0,0,partly cloudy night,
2019,Winter,05:00:00 AM,0,0,0,partly cloudy night,Martin Luther King Jr. Day
2019,Fall,07:00:00 AM,271,121,150,clear day,
2019,Winter,08:00:00 AM,270,159,111,clear day,
2019,Summer,11:00:00 PM,20,5,15,partly cloudy night,
2019,Winter,06:00:00 PM,51,36,15,clear night,
2019,Summer,04:00:00 PM,2857,1227,1630,partly cloudy day,
2019,Spring,10:00:00 AM,722,383,339,clear day,
2019,Fall,12:00:00 AM,2,1,1,partly cloudy night,Veterans Day
2019,Fall,08:00:00 PM,61,59,2,partly cloudy night,
2019,Summer,02:00:00 PM,1758,765,993,partly cloudy day,
2019,Fall,06:00:00 PM,1703,959,744,partly cloudy day,
2019,Spring,06:00:00 AM,191,107,84,clear day,
2019,Fall,07:00:00 PM,1053,392,661,clear day,
2019,Fall,12:00:00 PM,2905,726,2179,clear day,
2019,Summer,07:00:00 PM,2483,1170,1313,partly cloudy day,
2019,Spring,09:00:00 PM,54,14,40,clear night,
2019,Spring,04:00:00 PM,1432,679,753,partly cloudy day,
2019,Fall,05:00:00 AM,0,0,0,clear night,
2019,Summer,06:00:00 PM,352,176,176,rain,
2019,Spring,10:00:00 AM,1681,1042,639,partly cloudy day,
2019,Winter,10:00:00 AM,265,155,110,rain,
2019,Winter,04:00:00 PM,262,145,117,rain,
2019,Summer,03:00:00 PM,0,0,0,partly cloudy day,
2019,Fall,08:00:00 AM,388,208,180,partly cloudy day,
2019,Winter,12:00:00 AM,23,21,2,snow,
2019,Winter,10:00:00 PM,35,29,6,partly cloudy night,
2019,Summer,08:00:00 PM,1212,629,583,partly cloudy day,
2019,Spring,04:00:00 AM,0,0,0,clear night,
2019,Spring,09:00:00 PM,49,17,32,clear night,
2019,Fall,04:00:00 AM,0,0,0,partly cloudy night,
2019,Spring,09:00:00 PM,18,13,5,cloudy,
2019,Summer,01:00:00 PM,2967,1465,1502,partly cloudy day,
2019,Winter,06:00:00 PM,7,6,1,partly cloudy night,
2019,Summer,08:00:00 PM,80,51,29,clear night,
2019,Spring,10:00:00 AM,1388,783,605,clear day,
2019,Fall,08:00:00 PM,9,0,9,clear night,
2019,Summer,09:00:00 PM,30,14,16,partly cloudy night,
2019,Fall,10:00:00 AM,948,560,388,partly cloudy day,
2019,Summer,04:00:00 PM,1682,859,823,partly cloudy day,
2019,Fall,07:00:00 PM,68,61,7,partly cloudy night,Veterans Day
2019,Winter,01:00:00 AM,1,0,1,clear night,
2019,Winter,10:00:00 AM,385,215,170,clear day,
2019,Summer,08:00:00 PM,1346,617,729,partly cloudy day,
2019,Fall,06:00:00 AM,182,98,84,cloudy,
2019,Winter,11:00:00 PM,6,0,6,cloudy,
2019,Winter,05:00:00 AM,0,0,0,clear night,
2019,Winter,01:00:00 AM,0,0,0,clear night,
2019,Spring,11:00:00 AM,2457,1283,1174,partly cloudy day,
2019,Winter,03:00:00 PM,914,443,471,partly cloudy day,
2019,Summer,06:00:00 AM,163,88,75,clear day,
2019,Fall,10:00:00 AM,817,412,405,cloudy,
2019,Fall,01:00:00 AM,10,0,10,partly cloudy night,
2019,Fall,07:00:00 AM,229,119,110,partly cloudy night,
2019,Summer,10:00:00 AM,1687,965,722,clear day,
2019,Winter,12:00:00 PM,229,111,118,fog,
2019,Winter,12:00:00 PM,614,286,328,clear day,
2019,Fall,09:00:00 PM,0,0,0,clear night,
2019,Spring,09:00:00 PM,41,23,18,clear night,
2019,Winter,10:00:00 PM,8,4,4,cloudy,
2019,Spring,10:00:00 PM,17,16,1,clear night,
2019,Winter,01:00:00 AM,1,0,1,cloudy,
2019,Spring,05:00:00 PM,1026,358,668,cloudy,
2019,Spring,09:00:00 PM,5,0,5,clear night,
2019,Spring,08:00:00 PM,100,61,39,partly cloudy night,
2019,Winter,01:00:00 AM,0,0,0,clear night,
2019,Summer,09:00:00 PM,21,11,10,clear night,
2019,Summer,07:00:00 AM,493,191,302,clear day,
2019,Spring,06:00:00 PM,1148,608,540,clear day,
2019,Fall,07:00:00 AM,285,115,170,cloudy,
2019,Fall,09:00:00 AM,1101,687,414,clear day,
2019,Summer,11:00:00 PM,10,5,5,partly cloudy night,
2019,Summer,11:00:00 AM,181,131,50,rain,
2019,Spring,04:00:00 PM,2538,1165,1373,clear day,
2019,Spring,11:00:00 AM,2452,1173,1279,partly cloudy day,
2019,Spring,02:00:00 AM,3,1,2,clear night,
2019,Winter,01:00:00 PM,654,341,313,rain,
2019,Winter,02:00:00 PM,1796,852,944,partly cloudy day,
2019,Winter,12:00:00 PM,2155,945,1210,clear day,
2019,Winter,02:00:00 PM,2167,1135,1032,partly cloudy day,
2019,Summer,11:00:00 PM,10,6,4,clear night,
2019,Summer,10:00:00 PM,28,17,11,clear night,
2019,Spring,12:00:00 PM,2942,1413,1529,clear day,
2019,Fall,08:00:00 PM,60,59,1,clear night,
2019,Fall,07:00:00 AM,280,136,144,cloudy,
2019,Spring,09:00:00 PM,40,18,22,cloudy,
2019,Summer,11:00:00 AM,1168,627,541,rain,
2019,Summer,01:00:00 AM,0,0,0,partly cloudy night,
2019,Spring,09:00:00 PM,15,0,15,clear night,
2019,Winter,05:00:00 PM,491,248,243,clear night,
2019,Fall,01:00:00 PM,2976,1413,1563,cloudy,
2019,Summer,06:00:00 AM,200,106,94,clear day,
2019,Spring,07:00:00 AM,140,69,71,cloudy,
2019,Winter,06:00:00 AM,14,10,4,clear night,
2019,Fall,11:00:00 AM,2377,1111,1266,partly cloudy day,
2019,Fall,06:00:00 AM,148,73,75,clear night,
2019,Summer,09:00:00 AM,899,533,366,cloudy,
2019,Winter,06:00:00 AM,15,12,3,clear night,
2019,Spring,05:00:00 PM,784,392,392,cloudy,
2019,Summer,08:00:00 AM,474,210,264,partly cloudy day,
2019,Summer,07:00:00 AM,284,141,143,cloudy,
2019,Spring,08:00:00 AM,79,37,42,rain,Mother's Day
2019,Summer,08:00:00 PM,1209,515,694,partly cloudy day,
2019,Winter,07:00:00 AM,133,133,0,clear day,
2019,Fall,09:00:00 PM,9,5,4,rain,
2019,Summer,03:00:00 AM,0,0,0,partly cloudy night,
2019,Winter,11:00:00 AM,2013,931,1082,clear day,
2019,Winter,11:00:00 AM,1622,844,778,clear day,
2019,Spring,09:00:00 AM,455,215,240,clear day,
2019,Winter,11:00:00 PM,7,0,7,clear night,
2019,Winter,07:00:00 PM,69,65,4,clear night,
2019,Summer,03:00:00 AM,1,0,1,clear night,
2019,Winter,05:00:00 AM,0,0,0,clear night,
2019,Summer,10:00:00 AM,1252,614,638,partly cloudy day,
2019,Summer,10:00:00 AM,1475,805,670,clear day,
2019,Fall,02:00:00 AM,1,0,1,clear night,
2019,Fall,10:00:00 AM,1010,526,484,cloudy,
2019,Winter,11:00:00 AM,1529,865,664,clear day,
2019,Fall,12:00:00 PM,1669,783,886,partly cloudy day,
2019,Summer,11:00:00 AM,474,196,278,cloudy,
2019,Spring,01:00:00 AM,0,0,0,cloudy,
2019,Winter,05:00:00 PM,523,291,232,cloudy,
2019,Winter,10:00:00 AM,171,97,74,rain,
2019,Winter,12:00:00 AM,4,2,2,partly cloudy night,Martin Luther King Jr. Day
2019,Fall,02:00:00 AM,1,0,1,clear night,
2019,Summer,05:00:00 AM,35,22,13,clear night,
2019,Spring,05:00:00 AM,53,43,10,clear night,
2019,Fall,08:00:00 PM,18,16,2,clear night,
2019,Winter,02:00:00 AM,2,1,1,clear night,
2019,Summer,04:00:00 AM,0,0,0,partly cloudy night,
2019,Spring,12:00:00 PM,726,377,349,rain,Tax Day
2019,Winter,09:00:00 PM,3,1,2,partly cloudy night,
2019,Winter,10:00:00 PM,18,16,2,clear night,
2019,Winter,09:00:00 AM,232,120,112,rain,
2019,Spring,12:00:00 PM,1722,775,947,cloudy,
2019,Summer,07:00:00 PM,1450,808,642,partly cloudy day,
2019,Fall,02:00:00 AM,0,0,0,cloudy,
2019,Winter,03:00:00 AM,1,0,1,clear night,
2019,Spring,07:00:00 PM,421,212,209,partly cloudy day,
2019,Fall,08:00:00 AM,348,137,211,clear day,
2019,Fall,03:00:00 PM,485,241,244,partly cloudy day,
2019,Summer,02:00:00 AM,0,0,0,cloudy,Father's Day
2019,Fall,01:00:00 AM,2,1,1,clear night,
2019,Spring,06:00:00 PM,1005,524,481,clear day,
2019,Summer,02:00:00 PM,1629,665,964,partly cloudy day,
2019,Fall,05:00:00 PM,1999,971,1028,cloudy,
2019,Winter,01:00:00 PM,1361,600,761,partly cloudy day,
2019,Summer,11:00:00 PM,18,0,18,rain,
2019,Winter,05:00:00 PM,1106,466,640,partly cloudy day,Presidents' Day (regional holiday)
2019,Summer,02:00:00 AM,0,0,0,partly cloudy night,
2019,Winter,05:00:00 PM,67,63,4,partly cloudy night,
2019,Winter,01:00:00 PM,838,379,459,partly cloudy day,
2019,Winter,03:00:00 PM,496,246,250,cloudy,
2019,Summer,04:00:00 AM,0,0,0,clear night,
2019,Spring,03:00:00 PM,1192,533,659,cloudy,
2019,Spring,01:00:00 PM,1948,838,1110,partly cloudy day,
2019,Fall,04:00:00 AM,0,0,0,cloudy,
2019,Spring,09:00:00 AM,458,232,226,partly cloudy day,
2019,Spring,08:00:00 AM,86,42,44,rain,
2019,Fall,12:00:00 AM,4,0,4,clear night,
2019,Summer,01:00:00 PM,2116,904,1212,partly cloudy day,
2019,Fall,07:00:00 PM,222,135,87,cloudy,
2019,Fall,07:00:00 AM,271,122,149,partly cloudy day,
2019,Fall,08:00:00 AM,307,162,145,clear day,
2019,Summer,11:00:00 PM,7,3,4,rain,
2019,Spring,08:00:00 PM,507,247,260,clear night,
2019,Winter,02:00:00 AM,0,0,0,clear night,Christmas Day
2019,Summer,06:00:00 AM,212,94,118,partly cloudy day,
2019,Winter,09:00:00 AM,305,167,138,partly cloudy day,
2019,Summer,12:00:00 AM,1,0,1,partly cloudy night,
2019,Summer,01:00:00 AM,2,1,1,clear night,
2019,Winter,04:00:00 PM,0,0,0,partly cloudy day,
2019,Winter,02:00:00 PM,896,476,420,rain,
2019,Summer,03:00:00 PM,2129,949,1180,partly cloudy day,
2019,Summer,01:00:00 AM,1,0,1,cloudy,
2019,Spring,02:00:00 AM,6,0,6,rain,
2019,Fall,10:00:00 AM,1038,564,474,partly cloudy day,
2019,Spring,01:00:00 AM,0,0,0,clear night,
2019,Fall,04:00:00 AM,0,0,0,clear night,
2019,Summer,01:00:00 AM,0,0,0,partly cloudy night,
2019,Spring,09:00:00 PM,8,5,3,cloudy,
2019,Summer,03:00:00 AM,0,0,0,cloudy,
2019,Winter,05:00:00 PM,38,20,18,clear night,Christmas Eve
2019,Summer,07:00:00 PM,905,529,376,partly cloudy day,
2019,Spring,01:00:00 AM,2,2,0,cloudy,
2019,Fall,01:00:00 PM,2445,1055,1390,cloudy,
2019,Summer,06:00:00 PM,1505,775,730,partly cloudy day,
2019,Spring,05:00:00 AM,13,9,4,rain,
2019,Winter,04:00:00 AM,0,0,0,rain,
2019,Summer,12:00:00 PM,2088,877,1211,partly cloudy day,
2019,Summer,02:00:00 AM,0,0,0,partly cloudy night,
2019,Winter,05:00:00 AM,0,0,0,clear night,
2019,Winter,03:00:00 PM,489,247,242,snow,
2019,Winter,01:00:00 PM,2128,1034,1094,partly cloudy day,
2019,Winter,10:00:00 AM,885,513,372,clear day,
2019,Fall,11:00:00 AM,209,94,115,cloudy,
2019,Spring,12:00:00 AM,0,0,0,partly cloudy night,
2019,Summer,03:00:00 AM,0,0,0,partly cloudy night,
2019,Winter,01:00:00 PM,854,377,477,partly cloudy day,
2019,Winter,08:00:00 PM,14,13,1,rain,
2019,Fall,09:00:00 AM,695,383,312,partly cloudy day,
2019,Winter,06:00:00 AM,17,15,2,clear night,Christmas Eve
2019,Summer,08:00:00 AM,428,198,230,partly cloudy day,
2019,Spring,06:00:00 AM,91,52,39,clear night,
2019,Fall,12:00:00 PM,1909,828,1081,clear day,
2019,Spring,01:00:00 PM,1478,747,731,partly cloudy day,
2019,Fall,08:00:00 PM,8,3,5,partly cloudy night,
2019,Fall,06:00:00 AM,67,40,27,cloudy,
2019,Winter,02:00:00 PM,379,161,218,clear day,
2019,Fall,02:00:00 PM,1156,545,611,cloudy,
2019,Winter,05:00:00 AM,0,0,0,cloudy,
2019,Summer,11:00:00 PM,5,0,5,partly cloudy night,
2019,Summer,08:00:00 AM,273,114,159,cloudy,
2019,Summer,04:00:00 PM,1873,939,934,partly cloudy day,
2019,Spring,07:00:00 AM,20,6,14,snow,
2019,Summer,06:00:00 PM,2076,1248,828,clear day,
2019,Spring,11:00:00 AM,2532,1147,1385,partly cloudy day,
2019,Winter,05:00:00 AM,0,0,0,cloudy,
2019,Summer,01:00:00 PM,2020,932,1088,partly cloudy day,
2019,Fall,11:00:00 AM,2575,1222,1353,partly cloudy day,
2019,Winter,08:00:00 PM,7,3,4,clear night,
2019,Fall,08:00:00 PM,69,64,5,clear night,
2019,Spring,01:00:00 AM,2,0,2,clear night,Memorial Day
2019,Summer,01:00:00 PM,2021,915,1106,partly cloudy day,
2019,Winter,01:00:00 AM,0,0,0,clear night,
2019,Winter,02:00:00 AM,0,0,0,clear night,
2019,Summer,08:00:00 AM,465,245,220,partly cloudy day,
2019,Spring,02:00:00 PM,1571,665,906,clear day,
2019,Winter,05:00:00 AM,1,0,1,rain,
2019,Fall,11:00:00 AM,1639,760,879,cloudy,
2019,Winter,04:00:00 AM,0,0,0,clear night,
2019,Fall,04:00:00 PM,3007,1268,1739,partly cloudy day,
2019,Summer,04:00:00 PM,2620,1071,1549,partly cloudy day,
2019,Fall,03:00:00 PM,1841,864,977,cloudy,
2019,Summer,12:00:00 PM,2096,1006,1090,clear day,
2019,Summer,04:00:00 PM,3114,1404,1710,partly cloudy day,
2019,Spring,03:00:00 AM,0,0,0,clear night,
2019,Spring,08:00:00 PM,18,12,6,partly cloudy night,
2019,Winter,04:00:00 PM,1427,589,838,partly cloudy day,Valentine's Day
2019,Spring,12:00:00 PM,1970,901,1069,partly cloudy day,
2019,Spring,10:00:00 AM,1860,989,871,clear day,
2019,Winter,09:00:00 PM,16,11,5,cloudy,
2019,Summer,08:00:00 PM,1487,646,841,partly cloudy day,
2019,Winter,03:00:00 PM,2467,1128,1339,clear day,
2019,Winter,12:00:00 PM,1607,721,886,partly cloudy day,
2019,Fall,12:00:00 PM,1918,831,1087,clear day,
2019,Fall,05:00:00 AM,0,0,0,clear night,
2019,Spring,02:00:00 PM,2655,1196,1459,clear day,
2019,Summer,07:00:00 AM,111,48,63,rain,
2019,Spring,12:00:00 AM,49,0,49,cloudy,
2019,Winter,06:00:00 AM,0,0,0,clear night,
2019,Fall,11:00:00 AM,2038,1033,1005,clear day,
2019,Spring,07:00:00 PM,140,104,36,rain,
2019,Spring,03:00:00 AM,4,3,1,rain,Cinco de Mayo
2019,Winter,02:00:00 AM,4,2,2,cloudy,
2019,Summer,04:00:00 AM,1,0,1,partly cloudy night,
2019,Summer,04:00:00 PM,2354,1198,1156,partly cloudy day,
2019,Fall,08:00:00 PM,47,0,47,rain,
2019,Spring,12:00:00 PM,815,280,535,cloudy,
2019,Fall,06:00:00 PM,2707,1185,1522,partly cloudy day,
2019,Spring,01:00:00 PM,149,77,72,rain,Mother's Day
2019,Fall,12:00:00 PM,1648,732,916,clear day,
2019,Winter,12:00:00 PM,812,362,450,partly cloudy day,
2019,Summer,03:00:00 PM,3008,1305,1703,partly cloudy day,
2019,Summer,02:00:00 PM,1263,517,746,partly cloudy day,
2019,Spring,02:00:00 PM,1287,597,690,clear day,
2019,Summer,05:00:00 PM,2905,1351,1554,partly cloudy day,
2019,Summer,11:00:00 AM,1847,917,930,partly cloudy day,
2019,Winter,06:00:00 PM,10,9,1,cloudy,
2019,Summer,04:00:00 AM,0,0,0,partly cloudy night,
2019,Fall,09:00:00 AM,413,247,166,cloudy,Thanksgiving Day
2019,Fall,02:00:00 PM,3411,1558,1853,partly cloudy day,
2019,Spring,01:00:00 AM,0,0,0,clear night,
2019,Winter,09:00:00 PM,46,45,1,clear night,
2019,Fall,06:00:00 PM,543,271,272,partly cloudy night,
2019,Winter,05:00:00 PM,334,179,155,clear night,
2019,Winter,07:00:00 AM,112,54,58,clear day,
2019,Summer,04:00:00 AM,0,0,0,partly cloudy night,
2019,Winter,01:00:00 PM,1850,908,942,partly cloudy day,
2019,Summer,09:00:00 AM,1040,615,425,partly cloudy day,
2019,Winter,12:00:00 PM,744,351,393,clear day,
2019,Fall,05:00:00 PM,1901,1004,897,partly cloudy day,
2019,Fall,04:00:00 AM,0,0,0,partly cloudy night,
2019,Fall,06:00:00 AM,61,39,22,cloudy,
2019,Summer,01:00:00 AM,2,0,2,clear night,
2019,Fall,11:00:00 PM,3,2,1,cloudy,
2019,Winter,02:00:00 AM,0,0,0,clear night,
2019,Summer,08:00:00 AM,181,78,103,cloudy,
2019,Spring,01:00:00 AM,2,1,1,clear night,
2019,Spring,10:00:00 AM,840,484,356,cloudy,
2019,Fall,04:00:00 AM,0,0,0,cloudy,
2019,Winter,02:00:00 PM,1037,513,524,cloudy,
2019,Summer,12:00:00 PM,1676,827,849,partly cloudy day,
2019,Winter,10:00:00 AM,536,276,260,clear day,
2019,Summer,12:00:00 AM,6,3,3,clear night,
2019,Summer,07:00:00 PM,1562,843,719,partly cloudy day,
2019,Spring,03:00:00 AM,1,0,1,cloudy,
2019,Fall,09:00:00 PM,92,70,22,partly cloudy night,
2019,Spring,01:00:00 AM,7,0,7,clear night,
2019,Spring,10:00:00 AM,1106,557,549,clear day,
2019,Winter,03:00:00 AM,3,1,2,cloudy,
2019,Winter,01:00:00 AM,0,0,0,clear night,
2019,Fall,01:00:00 PM,2676,1153,1523,partly cloudy day,
2019,Winter,12:00:00 PM,2151,1015,1136,clear day,
2019,Winter,04:00:00 AM,0,0,0,cloudy,
2019,Spring,03:00:00 PM,3346,1453,1893,partly cloudy day,
2019,Spring,06:00:00 AM,93,30,63,cloudy,
2019,Summer,06:00:00 AM,103,43,60,cloudy,
2019,Spring,11:00:00 PM,114,110,4,partly cloudy night,Easter Sunday
2019,Spring,03:00:00 PM,2859,1191,1668,clear day,
2019,Spring,05:00:00 PM,895,464,431,cloudy,
2019,Summer,09:00:00 PM,67,18,49,clear night,
2019,Summer,05:00:00 PM,2563,1269,1294,partly cloudy day,
2019,Winter,08:00:00 PM,21,15,6,partly cloudy night,
2019,Spring,03:00:00 PM,1908,873,1035,cloudy,
2019,Spring,02:00:00 PM,2648,1179,1469,partly cloudy day,
2019,Winter,03:00:00 AM,0,0,0,partly cloudy night,
2019,Winter,01:00:00 PM,1205,511,694,clear day,
2019,Fall,05:00:00 PM,2735,1167,1568,partly cloudy day,
2019,Spring,10:00:00 AM,1373,738,635,clear day,
2019,Summer,11:00:00 AM,2245,1211,1034,partly cloudy day,
2019,Spring,11:00:00 PM,5,4,1,partly cloudy night,
2019,Winter,08:00:00 PM,0,0,0,partly cloudy night,
2019,Winter,01:00:00 AM,7,7,0,clear night,
2019,Fall,03:00:00 PM,2989,1323,1666,clear day,
2019,Spring,08:00:00 PM,440,201,239,clear night,
2019,Spring,01:00:00 PM,2337,1222,1115,cloudy,
2019,Winter,01:00:00 AM,39,20,19,rain,New Year's Day
2019,Summer,01:00:00 AM,1,0,1,partly cloudy night,
2019,Winter,06:00:00 PM,40,39,1,partly cloudy night,
2019,Summer,01:00:00 PM,1862,931,931,partly cloudy day,
2019,Summer,07:00:00 AM,173,90,83,rain,
2019,Fall,05:00:00 AM,1,0,1,clear night,
2019,Spring,04:00:00 PM,1449,633,816,partly cloudy day,
2019,Summer,01:00:00 AM,5,0,5,clear night,
2019,Fall,04:00:00 PM,467,230,237,rain,
2019,Fall,12:00:00 PM,2657,1454,1203,cloudy,
2019,Summer,03:00:00 AM,0,0,0,clear night,
2019,Summer,06:00:00 AM,51,20,31,rain,
2019,Winter,09:00:00 AM,565,301,264,clear day,
2019,Spring,12:00:00 PM,1884,843,1041,cloudy,
2019,Winter,12:00:00 AM,4,2,2,partly cloudy night,
2019,Summer,11:00:00 AM,1817,891,926,clear day,
2019,Summer,08:00:00 PM,503,235,268,cloudy,
2019,Spring,05:00:00 PM,1220,650,570,partly cloudy day,
2019,Fall,07:00:00 PM,13,12,1,clear night,
2019,Fall,04:00:00 PM,2647,1136,1511,clear day,
2019,Winter,06:00:00 PM,128,76,52,clear night,
2019,Winter,01:00:00 AM,2,0,2,clear night,
2019,Spring,07:00:00 AM,262,122,140,partly cloudy day,
2019,Winter,09:00:00 AM,512,246,266,partly cloudy day,
2019,Summer,11:00:00 AM,2142,1168,974,partly cloudy day,
2019,Summer,01:00:00 PM,1425,615,810,partly cloudy day,
2019,Spring,06:00:00 AM,188,89,99,clear day,
2019,Fall,07:00:00 AM,104,55,49,cloudy,
2019,Spring,07:00:00 PM,282,94,188,rain,
2019,Winter,05:00:00 AM,0,0,0,cloudy,
2019,Spring,04:00:00 PM,2033,1044,989,partly cloudy day,
2019,Spring,06:00:00 PM,1020,474,546,partly cloudy day,
2019,Summer,04:00:00 PM,2873,1320,1553,partly cloudy day,
2019,Fall,07:00:00 AM,252,100,152,partly cloudy day,
2019,Summer,06:00:00 PM,1818,1059,759,partly cloudy day,
2019,Spring,09:00:00 AM,486,286,200,clear day,
2019,Summer,04:00:00 AM,1,0,1,partly cloudy night,
2019,Fall,07:00:00 PM,21,18,3,rain,
2019,Fall,07:00:00 AM,202,82,120,partly cloudy day,
2019,Summer,12:00:00 AM,23,21,2,clear night,
2019,Fall,05:00:00 AM,0,0,0,clear night,
2019,Fall,07:00:00 PM,40,23,17,cloudy,
2019,Winter,09:00:00 AM,703,407,296,clear day,
2019,Summer,08:00:00 PM,1523,752,771,clear day,
2019,Winter,03:00:00 AM,0,0,0,clear night,
2019,Summer,11:00:00 AM,795,404,391,cloudy,
2019,Fall,09:00:00 AM,779,509,270,clear day,Daylight Saving Time ends
2019,Fall,05:00:00 PM,35,34,1,cloudy,
2019,Winter,11:00:00 PM,8,2,6,partly cloudy night,
2019,Winter,12:00:00 AM,0,0,0,,
2019,Winter,04:00:00 PM,105,43,62,rain,
2019,Winter,02:00:00 AM,1,0,1,clear night,
2019,Spring,12:00:00 PM,2771,1288,1483,clear day,
2019,Spring,06:00:00 AM,167,74,93,clear night,
2019,Spring,10:00:00 PM,0,0,0,clear night,
2019,Fall,06:00:00 PM,493,289,204,rain,
2019,Spring,09:00:00 PM,10,5,5,cloudy,
2019,Fall,06:00:00 PM,1200,638,562,cloudy,
2019,Spring,04:00:00 PM,1280,584,696,partly cloudy day,
2019,Spring,04:00:00 PM,426,201,225,cloudy,
2019,Winter,02:00:00 PM,1061,497,564,cloudy,
2019,Fall,08:00:00 PM,65,56,9,cloudy,
2019,Summer,11:00:00 AM,1953,1032,921,partly cloudy day,
2019,Spring,06:00:00 PM,2344,1365,979,partly cloudy day,
2019,Spring,06:00:00 AM,32,14,18,rain,Cinco de Mayo
2019,Spring,04:00:00 AM,0,0,0,cloudy,
2019,Fall,06:00:00 PM,941,400,541,partly cloudy night,
2019,Spring,07:00:00 AM,135,82,53,clear day,
2019,Summer,02:00:00 AM,0,0,0,cloudy,
2019,Fall,09:00:00 AM,783,474,309,partly cloudy day,
2019,Summer,07:00:00 PM,1940,778,1162,rain,
2019,Winter,08:00:00 AM,264,96,168,clear day,
2019,Fall,09:00:00 AM,680,375,305,clear day,
2019,Fall,06:00:00 AM,4,2,2,cloudy,
2019,Spring,06:00:00 AM,157,81,76,clear day,Memorial Day
2019,Summer,09:00:00 AM,512,316,196,cloudy,
2019,Summer,07:00:00 AM,214,92,122,cloudy,
2019,Spring,04:00:00 AM,0,0,0,partly cloudy night,
2019,Winter,05:00:00 AM,1,0,1,cloudy,New Year's Eve
2019,Fall,03:00:00 PM,1487,712,775,partly cloudy day,
2019,Fall,06:00:00 PM,2059,1095,964,clear day,
2019,Spring,02:00:00 AM,2,0,2,cloudy,
2019,Winter,08:00:00 PM,12,0,12,cloudy,
2019,Spring,06:00:00 PM,1843,987,856,clear day,
2019,Summer,06:00:00 PM,2149,1171,978,partly cloudy day,
2019,Spring,03:00:00 PM,1559,659,900,partly cloudy day,
2019,Winter,02:00:00 AM,1,0,1,clear night,
2019,Winter,10:00:00 AM,1051,545,506,partly cloudy day,
2019,Spring,03:00:00 AM,0,0,0,clear night,
2019,Fall,07:00:00 AM,155,57,98,partly cloudy night,Thanksgiving Day
2019,Fall,06:00:00 PM,1903,1039,864,clear day,
2019,Summer,08:00:00 PM,1380,664,716,clear day,
2019,Winter,02:00:00 PM,3405,1820,1585,partly cloudy day,New Year's Eve
2019,Spring,02:00:00 AM,2,2,0,rain,
2019,Winter,07:00:00 PM,26,17,9,partly cloudy night,
2019,Fall,05:00:00 PM,159,116,43,clear night,
2019,Spring,07:00:00 PM,11,0,11,cloudy,Daylight Saving Time starts
2019,Fall,01:00:00 AM,1,1,0,clear night,
2019,Winter,06:00:00 PM,63,53,10,clear night,Valentine's Day
2019,Fall,12:00:00 AM,10,0,10,clear night,
2019,Spring,08:00:00 PM,12,8,4,partly cloudy night,
2019,Summer,11:00:00 AM,1756,836,920,partly cloudy day,
2019,Fall,09:00:00 PM,4,3,1,partly cloudy night,
2019,Spring,06:00:00 PM,1455,701,754,partly cloudy day,
2019,Summer,02:00:00 PM,2761,1124,1637,partly cloudy day,
2019,Spring,07:00:00 AM,45,26,19,rain,Mother's Day
2019,Fall,09:00:00 AM,526,279,247,partly cloudy day,
2019,Winter,11:00:00 AM,1469,770,699,clear day,
2019,Spring,07:00:00 PM,385,161,224,cloudy,
2019,Spring,01:00:00 AM,1,0,1,cloudy,
2019,Summer,05:00:00 AM,50,29,21,clear night,
2019,Fall,08:00:00 PM,7,0,7,clear night,
2019,Spring,06:00:00 AM,160,76,84,cloudy,
2019,Winter,04:00:00 AM,3,1,2,cloudy,
2019,Fall,04:00:00 PM,3628,1476,2152,partly cloudy day,
2019,Spring,01:00:00 PM,2131,959,1172,partly cloudy day,
2019,Fall,06:00:00 AM,10,9,1,cloudy,
2019,Spring,11:00:00 AM,2520,1196,1324,clear day,
2019,Fall,08:00:00 PM,55,52,3,partly cloudy night,Veterans Day
2019,Winter,06:00:00 AM,72,39,33,clear night,
2019,Winter,05:00:00 PM,299,156,143,partly cloudy night,
2019,Winter,08:00:00 PM,26,18,8,cloudy,
2019,Winter,06:00:00 AM,20,17,3,partly cloudy night,New Year's Day
2019,Summer,08:00:00 PM,262,181,81,rain,
2019,Fall,10:00:00 PM,2,0,2,partly cloudy night,Veterans Day
2019,Fall,01:00:00 AM,2,0,2,partly cloudy night,
2019,Winter,09:00:00 AM,1005,563,442,clear day,
2019,Winter,01:00:00 PM,1441,621,820,clear day,
2019,Winter,08:00:00 AM,132,48,84,rain,
2019,Fall,12:00:00 AM,5,3,2,cloudy,
2019,Winter,08:00:00 AM,203,77,126,clear day,
2019,Summer,05:00:00 PM,522,284,238,rain,
2019,Summer,06:00:00 AM,159,82,77,cloudy,
2019,Summer,09:00:00 PM,76,43,33,partly cloudy night,
2019,Summer,08:00:00 PM,1350,543,807,partly cloudy day,
2019,Winter,12:00:00 PM,2071,962,1109,partly cloudy day,
2019,Fall,04:00:00 PM,835,473,362,cloudy,
2019,Winter,08:00:00 PM,64,33,31,partly cloudy night,
2019,Spring,06:00:00 PM,2223,1077,1146,partly cloudy day,
2019,Spring,11:00:00 PM,30,16,14,partly cloudy night,Memorial Day
2019,Summer,11:00:00 PM,19,9,10,partly cloudy night,
2019,Spring,03:00:00 AM,1,1,0,partly cloudy night,
2019,Fall,07:00:00 PM,1130,493,637,partly cloudy day,Labor Day
2019,Winter,09:00:00 PM,15,8,7,clear night,
2019,Winter,08:00:00 AM,117,57,60,clear day,
2019,Fall,08:00:00 AM,425,159,266,cloudy,
2019,Summer,04:00:00 PM,1354,614,740,partly cloudy day,
2019,Summer,11:00:00 PM,12,8,4,clear night,
2019,Winter,06:00:00 AM,46,34,12,clear night,
2019,Winter,07:00:00 AM,111,60,51,partly cloudy night,
2019,Summer,09:00:00 PM,114,96,18,cloudy,
2019,Summer,03:00:00 AM,0,0,0,partly cloudy night,
2019,Spring,03:00:00 PM,1764,698,1066,partly cloudy day,
2019,Spring,06:00:00 AM,104,46,58,cloudy,
2019,Fall,05:00:00 AM,0,0,0,clear night,
2019,Spring,01:00:00 PM,3150,1447,1703,clear day,
2019,Spring,08:00:00 PM,12,7,5,partly cloudy night,
2019,Fall,03:00:00 AM,0,0,0,partly cloudy night,
2019,Winter,02:00:00 PM,3722,1972,1750,cloudy,
2019,Fall,06:00:00 AM,100,67,33,clear night,
2019,Spring,03:00:00 PM,3185,1519,1666,clear day,
2019,Summer,06:00:00 PM,2077,1138,939,partly cloudy day,
2019,Summer,01:00:00 AM,1,0,1,rain,
2019,Summer,10:00:00 AM,1158,661,497,partly cloudy day,
2019,Winter,04:00:00 PM,1908,902,1006,clear day,
2019,Fall,03:00:00 PM,2822,1221,1601,partly cloudy day,
2019,Summer,05:00:00 AM,56,32,24,partly cloudy night,
2019,Winter,11:00:00 PM,7,2,5,cloudy,
2019,Fall,10:00:00 PM,9,4,5,partly cloudy night,
2019,Winter,06:00:00 AM,37,22,15,partly cloudy night,
2019,Fall,08:00:00 PM,76,52,24,cloudy,
2019,Summer,03:00:00 PM,1961,925,1036,partly cloudy day,
2019,Summer,09:00:00 PM,120,46,74,clear night,
2019,Spring,01:00:00 AM,5,4,1,partly cloudy night,
2019,Winter,05:00:00 AM,0,0,0,rain,
2019,Summer,03:00:00 PM,1143,439,704,cloudy,
2019,Fall,02:00:00 AM,2,0,2,clear night,
2019,Winter,06:00:00 AM,0,0,0,clear night,
2019,Winter,01:00:00 AM,3,0,3,clear night,
2019,Spring,03:00:00 PM,1715,643,1072,cloudy,
2019,Fall,02:00:00 PM,949,361,588,rain,
2019,Spring,11:00:00 AM,1022,489,533,partly cloudy day,
2019,Winter,09:00:00 PM,70,69,1,clear night,
2019,Fall,03:00:00 PM,2672,1099,1573,partly cloudy day,
2019,Fall,12:00:00 AM,0,0,0,partly cloudy night,
2019,Spring,06:00:00 AM,107,54,53,partly cloudy night,
2019,Summer,04:00:00 PM,1672,674,998,cloudy,
2019,Spring,10:00:00 PM,7,3,4,cloudy,
2019,Fall,02:00:00 PM,901,398,503,cloudy,Halloween
2019,Fall,07:00:00 AM,267,131,136,partly cloudy day,
2019,Winter,12:00:00 AM,0,0,0,rain,
2019,Fall,04:00:00 PM,1240,590,650,cloudy,
2019,Summer,12:00:00 AM,3,2,1,partly cloudy night,
2019,Winter,10:00:00 PM,30,0,30,partly cloudy night,
2019,Summer,11:00:00 AM,1674,885,789,partly cloudy day,
2019,Winter,01:00:00 PM,829,341,488,clear day,
2019,Winter,06:00:00 PM,134,130,4,cloudy,
2019,Fall,08:00:00 PM,14,13,1,rain,
2019,Fall,11:00:00 AM,1540,733,807,partly cloudy day,
2019,Winter,01:00:00 PM,1259,511,748,clear day,
2019,Winter,10:00:00 AM,1079,460,619,cloudy,
2019,Winter,01:00:00 AM,0,0,0,clear night,
2019,Summer,12:00:00 AM,21,12,9,partly cloudy night,Father's Day
2019,Spring,01:00:00 AM,2,1,1,cloudy,
2019,Fall,08:00:00 AM,421,187,234,clear day,
2019,Summer,04:00:00 PM,2631,1137,1494,partly cloudy day,
2019,Spring,01:00:00 AM,2,1,1,partly cloudy night,
2019,Fall,01:00:00 PM,1713,715,998,clear day,Veterans Day
2019,Fall,11:00:00 PM,11,10,1,partly cloudy night,
2019,Spring,06:00:00 AM,89,53,36,cloudy,Easter Sunday
2019,Winter,01:00:00 PM,1080,566,514,partly cloudy day,
2019,Summer,12:00:00 PM,418,189,229,cloudy,
2019,Fall,01:00:00 PM,496,209,287,rain,
2019,Winter,01:00:00 PM,2263,1050,1213,partly cloudy day,
2019,Winter,10:00:00 AM,321,166,155,cloudy,
2019,Winter,09:00:00 AM,276,123,153,clear day,
2019,Summer,07:00:00 PM,1740,921,819,partly cloudy day,
2019,Winter,12:00:00 PM,2239,1081,1158,partly cloudy day,
2019,Fall,05:00:00 AM,0,0,0,partly cloudy night,
2019,Summer,01:00:00 AM,2,0,2,partly cloudy night,
2019,Spring,03:00:00 AM,0,0,0,clear night,
2019,Winter,05:00:00 AM,0,0,0,partly cloudy night,
2019,Winter,11:00:00 PM,46,46,0,clear night,
2019,Summer,11:00:00 AM,2510,1311,1199,clear day,
2019,Summer,07:00:00 PM,2267,1152,1115,partly cloudy day,
2019,Fall,12:00:00 PM,2379,1161,1218,cloudy,
2019,Spring,12:00:00 PM,1191,494,697,cloudy,
2019,Spring,04:00:00 AM,0,0,0,clear night,
2019,Summer,02:00:00 PM,2497,1030,1467,partly cloudy day,
2019,Winter,01:00:00 AM,0,0,0,cloudy,Presidents' Day (regional holiday)
2019,Winter,05:00:00 PM,346,162,184,partly cloudy day,
2019,Fall,07:00:00 PM,819,400,419,partly cloudy day,
2019,Fall,05:00:00 PM,2529,1225,1304,cloudy,
2019,Summer,09:00:00 AM,617,324,293,partly cloudy day,
2019,Spring,06:00:00 PM,165,101,64,rain,
2019,Fall,04:00:00 PM,1912,891,1021,partly cloudy day,
2019,Summer,07:00:00 AM,259,135,124,partly cloudy day,
2019,Fall,10:00:00 AM,221,143,78,rain,
2019,Fall,10:00:00 AM,921,550,371,cloudy,
2019,Spring,06:00:00 AM,75,55,20,cloudy,
2019,Fall,12:00:00 PM,1030,399,631,clear day,
2019,Winter,05:00:00 PM,24,0,24,rain,
2019,Fall,04:00:00 PM,154,96,58,rain,
2019,Winter,06:00:00 PM,80,69,11,partly cloudy night,
2019,Fall,12:00:00 PM,1942,829,1113,clear day,
2019,Summer,01:00:00 AM,0,0,0,clear night,
2019,Summer,06:00:00 AM,189,76,113,clear day,
2019,Winter,06:00:00 PM,127,53,74,clear night,
2019,Summer,06:00:00 AM,208,83,125,partly cloudy day,
2019,Fall,10:00:00 AM,1085,607,478,partly cloudy day,
2019,Summer,09:00:00 PM,119,60,59,clear night,
2019,Fall,04:00:00 PM,1314,619,695,cloudy,
2019,Winter,08:00:00 PM,19,17,2,cloudy,
2019,Summer,11:00:00 AM,1901,890,1011,clear day,
2019,Summer,06:00:00 PM,1732,999,733,partly cloudy day,
2019,Fall,11:00:00 AM,2380,1115,1265,cloudy,
2019,Winter,08:00:00 PM,15,13,2,clear night,
2019,Winter,09:00:00 PM,46,17,29,partly cloudy night,
2019,Summer,11:00:00 AM,1819,952,867,partly cloudy day,Father's Day
2019,Spring,07:00:00 AM,188,82,106,clear day,
2019,Summer,06:00:00 PM,1796,1058,738,partly cloudy day,
2019,Summer,05:00:00 AM,44,32,12,partly cloudy night,
2019,Fall,12:00:00 PM,2119,851,1268,partly cloudy day,Daylight Saving Time ends
2019,Spring,06:00:00 AM,100,42,58,partly cloudy day,
2019,Fall,04:00:00 AM,0,0,0,partly cloudy night,
2019,Fall,09:00:00 PM,15,14,1,cloudy,Halloween
2019,Spring,06:00:00 AM,56,39,17,partly cloudy night,
2019,Fall,05:00:00 AM,0,0,0,partly cloudy night,
2019,Spring,07:00:00 PM,52,37,15,rain,
2019,Spring,04:00:00 AM,0,0,0,clear night,
2019,Fall,07:00:00 PM,126,76,50,clear night,
2019,Spring,05:00:00 AM,0,0,0,partly cloudy night,
2019,Fall,05:00:00 PM,288,164,124,clear night,
2019,Fall,09:00:00 AM,568,325,243,clear day,
2019,Summer,03:00:00 PM,3061,1502,1559,partly cloudy day,
2019,Fall,01:00:00 AM,0,0,0,cloudy,Columbus Day (regional holiday)
2019,Spring,07:00:00 AM,114,53,61,partly cloudy night,
2019,Summer,04:00:00 PM,564,248,316,cloudy,
2019,Summer,08:00:00 PM,398,220,178,cloudy,
2019,Summer,02:00:00 AM,0,0,0,clear night,
2019,Spring,01:00:00 AM,2,1,1,clear night,
2019,Winter,04:00:00 AM,0,0,0,cloudy,
2019,Winter,06:00:00 AM,26,14,12,clear night,
2019,Winter,03:00:00 PM,1115,500,615,cloudy,
2019,Winter,06:00:00 AM,22,10,12,clear night,
2019,Fall,09:00:00 PM,80,77,3,clear night,
2019,Fall,06:00:00 AM,138,89,49,partly cloudy night,Labor Day
2019,Summer,11:00:00 PM,7,0,7,clear night,
2019,Fall,07:00:00 PM,634,304,330,clear night,
2019,Spring,12:00:00 AM,0,0,0,clear night,
2019,Spring,04:00:00 PM,3332,1412,1920,clear day,
2019,Summer,04:00:00 PM,1574,815,759,partly cloudy day,
2019,Spring,03:00:00 AM,0,0,0,clear night,
2019,Spring,06:00:00 AM,172,84,88,cloudy,
2019,Spring,01:00:00 AM,0,0,0,partly cloudy night,Easter Sunday
2019,Summer,02:00:00 PM,2392,1081,1311,partly cloudy day,
2019,Fall,08:00:00 PM,6,4,2,clear night,
2019,Winter,01:00:00 PM,2548,1323,1225,partly cloudy day,
2019,Summer,11:00:00 PM,58,56,2,clear night,
2019,Winter,08:00:00 AM,179,88,91,clear day,
2019,Winter,06:00:00 AM,3,2,1,cloudy,
2019,Fall,09:00:00 PM,3,2,1,partly cloudy night,
2019,Winter,05:00:00 PM,71,0,71,cloudy,
2019,Fall,10:00:00 PM,15,14,1,rain,
2019,Summer,08:00:00 PM,402,163,239,partly cloudy night,
2019,Spring,07:00:00 PM,447,188,259,clear day,
2019,Winter,11:00:00 AM,1051,517,534,clear day,Valentine's Day
2019,Summer,11:00:00 PM,7,2,5,partly cloudy night,
2019,Spring,08:00:00 AM,277,102,175,partly cloudy day,
2019,Summer,08:00:00 PM,915,433,482,rain,
2019,Spring,12:00:00 AM,1,0,1,cloudy,Tax Day
2019,Spring,05:00:00 AM,5,3,2,rain,
2019,Summer,04:00:00 PM,2040,934,1106,partly cloudy day,
2019,Spring,06:00:00 AM,124,71,53,partly cloudy night,
2019,Spring,08:00:00 PM,338,160,178,partly cloudy night,Easter Monday
2019,Summer,03:00:00 AM,0,0,0,cloudy,
2019,Spring,04:00:00 PM,1850,864,986,partly cloudy day,
2019,Spring,01:00:00 AM,1,0,1,fog,
2019,Winter,06:00:00 PM,112,110,2,partly cloudy night,
2019,Summer,06:00:00 AM,132,75,57,clear night,
2019,Spring,08:00:00 PM,3,2,1,clear night,
2019,Winter,03:00:00 AM,1,0,1,clear night,
2019,Spring,06:00:00 AM,114,61,53,clear night,
2019,Fall,10:00:00 AM,1047,547,500,partly cloudy day,
2019,Spring,09:00:00 PM,11,10,1,clear night,
2019,Spring,10:00:00 PM,14,13,1,rain,
2019,Summer,08:00:00 PM,1711,773,938,clear day,
2019,Spring,01:00:00 PM,368,150,218,rain,
2019,Fall,06:00:00 AM,51,47,4,clear night,
2019,Summer,01:00:00 AM,2,0,2,partly cloudy night,
2019,Summer,07:00:00 AM,204,88,116,clear day,
2019,Spring,08:00:00 AM,267,97,170,partly cloudy day,
2019,Spring,04:00:00 AM,0,0,0,rain,Daylight Saving Time starts
2019,Fall,08:00:00 AM,413,180,233,clear day,
2019,Summer,10:00:00 AM,1385,732,653,partly cloudy day,
2019,Spring,10:00:00 AM,602,345,257,cloudy,
2019,Fall,01:00:00 AM,3,0,3,clear night,
2019,Summer,05:00:00 AM,51,42,9,partly cloudy night,
2019,Fall,08:00:00 PM,95,72,23,partly cloudy night,
2019,Winter,11:00:00 PM,7,7,0,rain,
2019,Fall,06:00:00 AM,38,27,11,clear night,
2019,Summer,03:00:00 AM,1,1,0,partly cloudy night,
2019,Winter,03:00:00 PM,821,363,458,cloudy,
2019,Spring,02:00:00 AM,0,0,0,cloudy,
2019,Winter,06:00:00 AM,25,13,12,clear night,
2019,Fall,06:00:00 AM,52,30,22,cloudy,
2019,Spring,01:00:00 PM,2197,989,1208,clear day,
2019,Winter,01:00:00 AM,1,0,1,cloudy,Valentine's Day
2019,Summer,07:00:00 AM,260,118,142,clear day,
2019,Fall,08:00:00 AM,389,131,258,cloudy,
2019,Winter,11:00:00 AM,1236,621,615,cloudy,Presidents' Day (regional holiday)
2019,Winter,12:00:00 AM,5,3,2,cloudy,
2019,Winter,04:00:00 PM,1973,1081,892,partly cloudy day,
2019,Winter,02:00:00 AM,0,0,0,clear night,
2019,Spring,05:00:00 PM,1602,671,931,partly cloudy day,
2019,Summer,10:00:00 PM,17,11,6,clear night,
2019,Spring,09:00:00 AM,948,545,403,partly cloudy day,Easter Monday
2019,Fall,01:00:00 AM,1,0,1,rain,
2019,Fall,04:00:00 AM,0,0,0,clear night,
2019,Fall,10:00:00 PM,4,4,0,clear night,
2019,Summer,09:00:00 AM,606,386,220,clear day,
2019,Spring,09:00:00 PM,24,17,7,partly cloudy night,
2019,Winter,10:00:00 PM,3,2,1,clear night,
2019,Summer,03:00:00 PM,1449,704,745,partly cloudy day,
2019,Spring,05:00:00 PM,2806,1333,1473,partly cloudy day,
2019,Summer,07:00:00 PM,1787,992,795,partly cloudy day,
2019,Spring,08:00:00 AM,294,137,157,partly cloudy day,
2019,Winter,02:00:00 PM,779,406,373,cloudy,
2019,Spring,09:00:00 AM,515,268,247,cloudy,
2019,Winter,07:00:00 PM,30,27,3,cloudy,
2019,Spring,04:00:00 AM,0,0,0,cloudy,
2019,Spring,07:00:00 PM,217,118,99,partly cloudy night,
2019,Fall,11:00:00 AM,2499,1194,1305,partly cloudy day,
2019,Winter,10:00:00 PM,60,59,1,cloudy,
2019,Spring,09:00:00 PM,103,83,20,clear night,
2019,Winter,09:00:00 PM,6,5,1,clear night,
2019,Winter,11:00:00 PM,21,21,0,rain,
2019,Summer,08:00:00 AM,425,159,266,clear day,
2019,Winter,06:00:00 AM,27,19,8,cloudy,
2019,Fall,07:00:00 AM,263,119,144,clear day,
2019,Summer,02:00:00 AM,3,2,1,partly cloudy night,
2019,Winter,02:00:00 AM,0,0,0,clear night,
2019,Fall,04:00:00 AM,0,0,0,partly cloudy night,
2019,Winter,02:00:00 AM,1,0,1,cloudy,
2019,Summer,07:00:00 PM,1630,804,826,partly cloudy day,
2019,Summer,10:00:00 PM,13,6,7,clear night,
2019,Winter,11:00:00 AM,1025,558,467,cloudy,
2019,Fall,10:00:00 AM,1880,1033,847,clear day,
2019,Fall,07:00:00 AM,316,120,196,partly cloudy day,
2019,Winter,08:00:00 AM,185,72,113,cloudy,
2019,Spring,09:00:00 AM,1298,671,627,partly cloudy day,
2019,Summer,11:00:00 AM,2169,1161,1008,clear day,
2019,Fall,02:00:00 AM,2,0,2,cloudy,
2019,Fall,09:00:00 AM,691,377,314,clear day,
2019,Spring,04:00:00 AM,0,0,0,cloudy,
2019,Summer,02:00:00 PM,2160,949,1211,partly cloudy day,
2019,Summer,03:00:00 PM,2168,1001,1167,partly cloudy day,
2019,Fall,08:00:00 PM,4,0,4,clear night,
2019,Spring,09:00:00 PM,80,64,16,clear night,
2019,Winter,09:00:00 AM,342,173,169,clear day,
2019,Summer,06:00:00 AM,168,96,72,partly cloudy night,
2019,Winter,07:00:00 AM,194,76,118,clear night,
2019,Fall,09:00:00 PM,1,0,1,clear night,
2019,Winter,11:00:00 PM,0,0,0,clear night,
2019,Summer,08:00:00 AM,430,172,258,partly cloudy day,
2019,Spring,04:00:00 PM,2591,1129,1462,clear day,
2019,Fall,10:00:00 PM,3,2,1,cloudy,
2019,Spring,09:00:00 PM,44,31,13,clear night,
2019,Fall,04:00:00 PM,2809,1218,1591,clear day,
2019,Summer,12:00:00 PM,2891,1388,1503,partly cloudy day,
2019,Fall,10:00:00 PM,12,6,6,cloudy,
2019,Fall,04:00:00 AM,0,0,0,cloudy,
2019,Spring,05:00:00 PM,1735,874,861,clear day,
2019,Fall,07:00:00 AM,346,145,201,partly cloudy day,
2019,Winter,01:00:00 PM,185,107,78,fog,
2019,Spring,03:00:00 AM,0,0,0,partly cloudy night,
2019,Fall,12:00:00 AM,23,13,10,partly cloudy night,
2019,Winter,10:00:00 AM,0,0,0,clear day,
2019,Winter,02:00:00 AM,0,0,0,partly cloudy night,
2019,Fall,05:00:00 AM,1,0,1,rain,
2019,Winter,10:00:00 AM,668,371,297,clear day,
2019,Winter,04:00:00 PM,1639,752,887,clear day,
2019,Spring,09:00:00 PM,49,37,12,partly cloudy night,
2019,Spring,07:00:00 AM,136,68,68,clear day,
2019,Spring,04:00:00 AM,0,0,0,partly cloudy night,
2019,Summer,03:00:00 AM,0,0,0,cloudy,
2019,Winter,12:00:00 AM,17,0,17,rain,
2019,Summer,05:00:00 AM,76,54,22,clear night,
2019,Summer,10:00:00 AM,1607,842,765,clear day,
2019,Winter,03:00:00 AM,0,0,0,partly cloudy night,
2019,Fall,02:00:00 AM,0,0,0,clear night,
2019,Fall,08:00:00 AM,386,231,155,clear day,Daylight Saving Time ends
2019,Summer,12:00:00 AM,1,0,1,partly cloudy night,
2019,Winter,11:00:00 AM,1010,468,542,partly cloudy day,
2019,Spring,08:00:00 PM,44,42,2,clear night,
2019,Fall,08:00:00 AM,443,172,271,partly cloudy day,
2019,Fall,04:00:00 AM,0,0,0,partly cloudy night,
2019,Spring,09:00:00 PM,12,0,12,rain,
2019,Fall,12:00:00 AM,0,0,0,clear night,
2019,Winter,07:00:00 AM,166,74,92,partly cloudy day,
2019,Summer,07:00:00 AM,285,128,157,clear day,
2019,Summer,10:00:00 AM,1179,666,513,clear day,
2019,Summer,06:00:00 PM,3,0,3,clear day,Independence Day
2019,Winter,07:00:00 PM,11,9,2,cloudy,
2019,Winter,02:00:00 PM,1027,468,559,partly cloudy day,
2019,Winter,08:00:00 PM,9,7,2,clear night,
2019,Winter,07:00:00 PM,9,4,5,clear night,
2019,Fall,11:00:00 AM,1460,723,737,partly cloudy day,
2019,Winter,10:00:00 PM,9,6,3,clear night,
2019,Winter,01:00:00 PM,769,317,452,clear day,
2019,Summer,06:00:00 AM,26,8,18,rain,
2019,Fall,05:00:00 AM,0,0,0,cloudy,
2019,Summer,11:00:00 AM,1366,649,717,partly cloudy day,
2019,Fall,12:00:00 AM,2,1,1,partly cloudy night,
2019,Summer,04:00:00 PM,1994,925,1069,partly cloudy day,
2019,Summer,01:00:00 AM,1,0,1,cloudy,
2019,Spring,10:00:00 AM,677,350,327,clear day,
2019,Summer,09:00:00 PM,83,61,22,clear night,
2019,Fall,05:00:00 AM,0,0,0,cloudy,
2019,Winter,02:00:00 PM,2485,1206,1279,clear day,
2019,Summer,04:00:00 AM,0,0,0,clear night,
2019,Winter,10:00:00 PM,71,71,0,clear night,Presidents' Day (regional holiday)
2019,Winter,04:00:00 AM,0,0,0,clear night,
2019,Fall,08:00:00 AM,410,184,226,clear day,
2019,Summer,09:00:00 PM,50,23,27,clear night,
2019,Fall,01:00:00 AM,0,0,0,clear night,
2019,Spring,08:00:00 PM,12,8,4,clear night,
2019,Spring,09:00:00 PM,29,25,4,clear night,
2019,Winter,02:00:00 PM,2899,1301,1598,partly cloudy day,
2019,Winter,04:00:00 AM,0,0,0,cloudy,
2019,Winter,05:00:00 PM,365,207,158,snow,
2019,Winter,10:00:00 PM,10,0,10,clear night,
2019,Spring,11:00:00 AM,847,397,450,partly cloudy day,
2019,Winter,04:00:00 PM,1034,451,583,partly cloudy day,
2019,Summer,10:00:00 AM,1560,939,621,partly cloudy day,
2019,Winter,01:00:00 PM,1859,888,971,clear day,Christmas Eve
2019,Spring,10:00:00 PM,12,3,9,partly cloudy night,
2019,Summer,07:00:00 AM,259,111,148,partly cloudy day,
2019,Spring,02:00:00 PM,1521,843,678,partly cloudy day,
2019,Summer,04:00:00 AM,4,3,1,partly cloudy night,
2019,Fall,04:00:00 AM,1,1,0,partly cloudy night,
2019,Spring,11:00:00 PM,15,13,2,clear night,
2019,Winter,04:00:00 AM,0,0,0,clear night,
2019,Fall,09:00:00 AM,1078,671,407,clear day,
2019,Summer,07:00:00 AM,352,151,201,partly cloudy day,
2019,Winter,09:00:00 AM,52,19,33,rain,
2019,Spring,10:00:00 AM,1626,730,896,clear day,
2019,Fall,09:00:00 AM,722,423,299,clear day,
2019,Winter,08:00:00 AM,177,63,114,partly cloudy day,
2019,Fall,06:00:00 AM,35,26,9,clear night,
2019,Fall,05:00:00 AM,0,0,0,cloudy,
2019,Summer,07:00:00 AM,277,125,152,partly cloudy day,
2019,Spring,11:00:00 PM,7,2,5,snow,
2019,Spring,10:00:00 AM,2019,1151,868,clear day,
2019,Winter,09:00:00 AM,245,140,105,partly cloudy day,
2019,Winter,10:00:00 PM,9,8,1,partly cloudy night,
2019,Winter,03:00:00 PM,3807,2435,1372,clear day,Christmas Day
2019,Summer,10:00:00 PM,30,11,19,partly cloudy night,
2019,Fall,01:00:00 PM,1820,744,1076,partly cloudy day,
2019,Spring,05:00:00 PM,3352,1501,1851,partly cloudy day,
2019,Summer,12:00:00 AM,3,1,2,clear night,
2019,Summer,11:00:00 AM,1489,799,690,cloudy,
2019,Winter,11:00:00 AM,879,510,369,rain,
2019,Summer,02:00:00 PM,2059,897,1162,partly cloudy day,
2019,Summer,08:00:00 AM,440,175,265,partly cloudy day,
2019,Summer,09:00:00 AM,284,152,132,rain,
2019,Summer,05:00:00 AM,29,16,13,cloudy,Father's Day
2019,Summer,12:00:00 AM,33,31,2,clear night,
2019,Winter,05:00:00 AM,2,0,2,rain,
2019,Winter,04:00:00 PM,0,0,0,cloudy,
2019,Spring,11:00:00 PM,64,58,6,partly cloudy night,
2019,Spring,09:00:00 PM,22,8,14,clear night,
2019,Spring,05:00:00 PM,2143,1072,1071,partly cloudy day,
2019,Winter,12:00:00 AM,3,3,0,,
2019,Winter,05:00:00 AM,3,0,3,clear night,
2019,Winter,11:00:00 PM,29,17,12,cloudy,
2019,Fall,04:00:00 AM,0,0,0,partly cloudy night,
2019,Winter,09:00:00 PM,11,10,1,rain,
2019,Spring,11:00:00 AM,1518,709,809,clear day,
2019,Summer,04:00:00 AM,1,0,1,cloudy,
2019,Summer,08:00:00 PM,1223,611,612,clear day,
2019,Summer,10:00:00 PM,29,9,20,partly cloudy night,
2019,Winter,06:00:00 AM,11,6,5,partly cloudy night,
2019,Spring,09:00:00 AM,698,312,386,cloudy,
2019,Fall,11:00:00 AM,1494,646,848,clear day,
2019,Summer,09:00:00 AM,749,436,313,cloudy,
2019,Fall,03:00:00 AM,0,0,0,clear night,
2019,Summer,11:00:00 AM,1863,999,864,partly cloudy day,
2019,Spring,02:00:00 PM,3103,1367,1736,partly cloudy day,
2019,Spring,10:00:00 AM,232,124,108,rain,Mother's Day
2019,Winter,09:00:00 PM,0,0,0,partly cloudy night,
2019,Fall,07:00:00 AM,221,92,129,clear day,
2019,Summer,09:00:00 AM,807,466,341,cloudy,
2019,Winter,04:00:00 PM,1139,547,592,clear day,
2019,Spring,02:00:00 PM,3383,1646,1737,clear day,
2019,Summer,05:00:00 AM,50,37,13,partly cloudy night,
2019,Summer,09:00:00 PM,35,21,14,partly cloudy night,
2019,Spring,12:00:00 AM,2,0,2,clear night,
2019,Summer,06:00:00 PM,833,430,403,rain,
2019,Winter,11:00:00 AM,0,0,0,partly cloudy day,
2019,Summer,12:00:00 PM,1388,624,764,partly cloudy day,
2019,Winter,08:00:00 PM,0,0,0,clear night,
2019,Fall,11:00:00 AM,1399,652,747,partly cloudy day,
2019,Winter,09:00:00 PM,36,13,23,partly cloudy night,New Year's Day
2019,Summer,12:00:00 AM,22,18,4,clear night,
2019,Spring,11:00:00 AM,2086,1043,1043,clear day,
2019,Fall,08:00:00 PM,66,58,8,clear night,
2019,Spring,02:00:00 PM,888,367,521,cloudy,
2019,Fall,03:00:00 PM,2483,1179,1304,clear day,Black Friday
2019,Fall,11:00:00 AM,965,497,468,partly cloudy day,
2019,Winter,02:00:00 AM,0,0,0,cloudy,
2019,Winter,05:00:00 PM,535,179,356,partly cloudy night,
2019,Spring,04:00:00 PM,1449,692,757,clear day,
2019,Fall,04:00:00 PM,2945,1321,1624,partly cloudy day,
2019,Fall,01:00:00 PM,2016,823,1193,clear day,
2019,Winter,09:00:00 PM,7,5,2,partly cloudy night,
2019,Summer,11:00:00 AM,1741,979,762,partly cloudy day,
2019,Summer,02:00:00 PM,2173,871,1302,partly cloudy day,
2019,Summer,09:00:00 PM,44,17,27,clear night,
2019,Summer,10:00:00 PM,84,70,14,clear night,
2019,Spring,10:00:00 AM,502,282,220,rain,Cinco de Mayo
2019,Winter,01:00:00 AM,2,0,2,rain,
2019,Winter,11:00:00 PM,4,3,1,clear night,
2019,Summer,08:00:00 PM,284,139,145,partly cloudy night,
2019,Fall,10:00:00 AM,1507,815,692,partly cloudy day,
2019,Fall,12:00:00 AM,1,0,1,cloudy,
2019,Spring,08:00:00 PM,52,46,6,clear night,
2019,Spring,10:00:00 AM,911,500,411,cloudy,
2019,Spring,02:00:00 PM,1548,681,867,cloudy,
2019,Spring,10:00:00 AM,1366,816,550,partly cloudy day,
2019,Winter,09:00:00 AM,77,38,39,clear day,
2019,Summer,12:00:00 PM,455,151,304,clear day,
2019,Summer,02:00:00 AM,3,2,1,partly cloudy night,
2019,Fall,05:00:00 AM,0,0,0,clear night,
2019,Fall,09:00:00 AM,747,454,293,clear day,
2019,Summer,08:00:00 AM,415,236,179,clear day,
2019,Summer,05:00:00 AM,52,38,14,clear night,
2019,Spring,08:00:00 AM,509,186,323,clear day,
2019,Fall,04:00:00 PM,1824,873,951,clear day,
2019,Summer,04:00:00 PM,2152,962,1190,partly cloudy day,
2019,Spring,03:00:00 PM,1244,509,735,cloudy,
2019,Spring,08:00:00 PM,40,39,1,clear night,
2019,Winter,09:00:00 AM,679,378,301,partly cloudy day,
2019,Fall,08:00:00 PM,25,0,25,rain,
2019,Fall,04:00:00 AM,0,0,0,partly cloudy night,
2019,Spring,10:00:00 AM,1823,1027,796,clear day,Memorial Day
2019,Summer,10:00:00 AM,1383,758,625,partly cloudy day,
2019,Summer,01:00:00 PM,1827,826,1001,cloudy,
2019,Fall,09:00:00 AM,763,407,356,clear day,
2019,Spring,03:00:00 AM,2,1,1,partly cloudy night,
2019,Summer,10:00:00 AM,1514,939,575,clear day,
2019,Winter,02:00:00 PM,2037,966,1071,partly cloudy day,
2019,Spring,11:00:00 PM,1,0,1,cloudy,
2019,Winter,06:00:00 PM,103,0,103,clear night,
2019,Summer,01:00:00 AM,2,0,2,clear night,
2019,Spring,03:00:00 PM,4286,2121,2165,partly cloudy day,
2019,Summer,12:00:00 PM,863,347,516,cloudy,
2019,Fall,08:00:00 PM,44,34,10,partly cloudy night,
2019,Spring,10:00:00 PM,40,33,7,rain,
2019,Fall,11:00:00 AM,2499,1390,1109,partly cloudy day,
2019,Fall,08:00:00 PM,66,60,6,cloudy,
2019,Fall,05:00:00 AM,0,0,0,partly cloudy night,
2019,Fall,06:00:00 AM,105,67,38,partly cloudy night,
2019,Fall,12:00:00 PM,1748,855,893,cloudy,Thanksgiving Day
2019,Spring,11:00:00 AM,1379,643,736,clear day,
2019,Winter,09:00:00 AM,1076,648,428,cloudy,New Year's Eve
2019,Spring,12:00:00 AM,0,0,0,clear night,
2019,Winter,06:00:00 AM,4,1,3,clear night,
2019,Spring,06:00:00 PM,1476,768,708,partly cloudy day,
2019,Spring,06:00:00 AM,79,40,39,partly cloudy day,
2019,Winter,08:00:00 PM,41,23,18,clear night,
2019,Spring,07:00:00 AM,71,30,41,fog,
2019,Summer,12:00:00 PM,2169,1019,1150,cloudy,
2019,Fall,05:00:00 PM,2213,1182,1031,clear day,
2019,Winter,06:00:00 PM,7,0,7,clear night,
2019,Spring,07:00:00 PM,2235,946,1289,clear day,
2019,Winter,04:00:00 AM,0,0,0,cloudy,
2019,Summer,09:00:00 AM,694,388,306,clear day,
2019,Spring,07:00:00 AM,266,119,147,clear day,
2019,Winter,11:00:00 AM,433,268,165,rain,
2019,Spring,10:00:00 PM,12,6,6,cloudy,
2019,Summer,10:00:00 PM,33,13,20,clear night,
2019,Spring,09:00:00 PM,16,0,16,rain,
2019,Fall,12:00:00 PM,2372,893,1479,clear day,
2019,Summer,11:00:00 PM,28,17,11,clear night,
2019,Fall,01:00:00 PM,1047,385,662,cloudy,
2019,Fall,06:00:00 AM,90,59,31,clear night,
2019,Fall,10:00:00 PM,19,17,2,clear night,
2019,Fall,03:00:00 PM,2237,1075,1162,clear day,
2019,Summer,06:00:00 PM,3062,1590,1472,partly cloudy day,
2019,Spring,11:00:00 PM,12,3,9,cloudy,
2019,Fall,02:00:00 PM,692,254,438,cloudy,
2019,Spring,04:00:00 PM,3425,1499,1926,partly cloudy day,
2019,Spring,06:00:00 PM,1248,606,642,partly cloudy day,
2019,Winter,01:00:00 PM,736,340,396,partly cloudy day,
2019,Winter,07:00:00 AM,227,104,123,partly cloudy night,
2019,Fall,08:00:00 AM,287,141,146,clear day,Black Friday
2019,Summer,08:00:00 AM,398,158,240,clear day,
2019,Spring,10:00:00 PM,28,21,7,cloudy,
2019,Summer,03:00:00 PM,1628,807,821,cloudy,
2019,Winter,10:00:00 PM,11,10,1,rain,
2019,Winter,02:00:00 PM,124,51,73,rain,
2019,Winter,04:00:00 AM,0,0,0,partly cloudy night,Martin Luther King Jr. Day
2019,Winter,05:00:00 PM,22,21,1,snow,
2019,Fall,11:00:00 PM,9,5,4,partly cloudy night,
2019,Summer,02:00:00 PM,2080,915,1165,partly cloudy day,
2019,Fall,05:00:00 AM,0,0,0,clear night,
2019,Spring,05:00:00 PM,1730,923,807,partly cloudy day,
2019,Winter,12:00:00 AM,2,2,0,rain,
2019,Summer,08:00:00 PM,1571,676,895,partly cloudy day,Father's Day
2019,Winter,12:00:00 PM,850,389,461,clear day,
2019,Summer,10:00:00 PM,31,16,15,partly cloudy night,
2019,Summer,08:00:00 PM,676,299,377,partly cloudy night,
2019,Spring,01:00:00 PM,1686,697,989,clear day,
2019,Fall,09:00:00 AM,640,367,273,partly cloudy day,
2019,Fall,12:00:00 PM,3074,1323,1751,partly cloudy day,
2019,Spring,05:00:00 AM,37,27,10,partly cloudy night,
2019,Spring,06:00:00 PM,275,119,156,partly cloudy night,
2019,Spring,06:00:00 PM,1917,1067,850,partly cloudy day,
2019,Winter,07:00:00 AM,247,164,83,partly cloudy night,
2019,Fall,05:00:00 AM,0,0,0,cloudy,
2019,Fall,12:00:00 AM,8,4,4,clear night,
2019,Fall,07:00:00 AM,302,133,169,clear day,
2019,Summer,03:00:00 PM,3369,1368,2001,partly cloudy day,
2019,Summer,12:00:00 PM,3052,1538,1514,partly cloudy day,
2019,Winter,05:00:00 AM,3,2,1,clear night,
2019,Winter,07:00:00 PM,10,9,1,clear night,
2019,Summer,01:00:00 AM,5,1,4,partly cloudy night,
2019,Winter,01:00:00 AM,1,1,0,clear night,
2019,Winter,09:00:00 PM,1,0,1,clear night,
2019,Winter,07:00:00 AM,97,49,48,rain,
2019,Spring,12:00:00 PM,1824,1062,762,cloudy,
2019,Summer,04:00:00 PM,1909,946,963,clear day,
2019,Winter,05:00:00 PM,418,234,184,partly cloudy night,
2019,Winter,06:00:00 PM,50,0,50,partly cloudy night,
2019,Spring,06:00:00 AM,119,61,58,clear night,Easter Monday
2019,Summer,06:00:00 PM,2367,1181,1186,clear day,
2019,Fall,05:00:00 PM,57,53,4,clear night,
2019,Fall,06:00:00 PM,20,14,6,clear night,Veterans Day
2019,Summer,05:00:00 PM,2367,1168,1199,partly cloudy day,
2019,Summer,12:00:00 AM,5,4,1,partly cloudy night,
2019,Fall,03:00:00 PM,524,236,288,cloudy,
2019,Spring,12:00:00 AM,5,0,5,rain,
2019,Fall,07:00:00 PM,862,296,566,cloudy,
2019,Winter,09:00:00 AM,482,283,199,cloudy,
2019,Winter,11:00:00 AM,2711,1508,1203,partly cloudy day,
2019,Summer,09:00:00 PM,33,12,21,cloudy,
2019,Winter,01:00:00 AM,2,0,2,partly cloudy night,
2019,Summer,01:00:00 AM,1,0,1,cloudy,
2019,Winter,01:00:00 PM,1292,563,729,cloudy,
2019,Winter,08:00:00 PM,27,26,1,clear night,
2019,Spring,09:00:00 AM,574,275,299,cloudy,
2019,Fall,09:00:00 AM,217,152,65,rain,
2019,Spring,05:00:00 AM,1,0,1,partly cloudy night,
2019,Spring,07:00:00 PM,1494,801,693,clear day,
2019,Summer,09:00:00 PM,96,31,65,partly cloudy night,
2019,Spring,12:00:00 AM,4,3,1,clear night,
2019,Spring,06:00:00 PM,1087,568,519,cloudy,
2019,Fall,07:00:00 AM,258,125,133,cloudy,
2019,Winter,10:00:00 AM,1715,924,791,partly cloudy day,
2019,Fall,08:00:00 AM,405,216,189,partly cloudy day,
2019,Spring,09:00:00 PM,58,42,16,partly cloudy night,
2019,Winter,06:00:00 AM,18,12,6,clear night,
2019,Winter,08:00:00 AM,364,150,214,partly cloudy day,
2019,Spring,06:00:00 AM,86,36,50,cloudy,
2019,Winter,09:00:00 AM,429,201,228,cloudy,
2019,Winter,03:00:00 PM,826,414,412,cloudy,
2019,Fall,07:00:00 PM,308,142,166,clear night,
2019,Winter,12:00:00 PM,1371,662,709,partly cloudy day,
2019,Spring,11:00:00 PM,4,0,4,clear night,Easter Monday
2019,Spring,07:00:00 PM,16,14,2,partly cloudy night,
2019,Fall,09:00:00 AM,397,208,189,partly cloudy day,
2019,Spring,04:00:00 AM,0,0,0,rain,
2019,Spring,06:00:00 PM,959,428,531,cloudy,
2019,Fall,07:00:00 PM,969,458,511,partly cloudy day,
2019,Summer,03:00:00 AM,0,0,0,clear night,
2019,Winter,03:00:00 AM,1,0,1,partly cloudy night,
2019,Fall,08:00:00 AM,315,119,196,partly cloudy day,
2019,Spring,02:00:00 AM,1,0,1,partly cloudy night,
2019,Spring,12:00:00 PM,1385,608,777,cloudy,
2019,Fall,01:00:00 PM,1506,648,858,partly cloudy day,
2019,Fall,06:00:00 PM,588,272,316,clear night,
2019,Summer,02:00:00 AM,3,1,2,clear night,
2019,Fall,03:00:00 PM,1699,762,937,clear day,
2019,Spring,09:00:00 AM,836,506,330,clear day,
2019,Summer,05:00:00 AM,25,18,7,rain,
2019,Summer,03:00:00 AM,0,0,0,clear night,
2019,Spring,05:00:00 PM,3302,1384,1918,partly cloudy day,
2019,Spring,07:00:00 PM,1453,856,597,rain,
2019,Spring,05:00:00 PM,1778,898,880,partly cloudy day,
2019,Summer,06:00:00 AM,157,72,85,partly cloudy day,
2019,Summer,05:00:00 PM,2749,1205,1544,partly cloudy day,
2019,Spring,01:00:00 PM,1719,776,943,partly cloudy day,
2019,Spring,04:00:00 AM,0,0,0,clear night,
2019,Summer,02:00:00 AM,0,0,0,clear night,
2019,Winter,01:00:00 AM,5,4,1,cloudy,
2019,Fall,04:00:00 AM,0,0,0,cloudy,
2019,Spring,02:00:00 AM,0,0,0,cloudy,
2019,Winter,05:00:00 PM,402,208,194,clear night,
2019,Winter,02:00:00 AM,4,4,0,clear night,
2019,Spring,04:00:00 PM,1702,775,927,partly cloudy day,
2019,Winter,11:00:00 PM,1,0,1,cloudy,New Year's Eve
2019,Fall,04:00:00 PM,2165,936,1229,partly cloudy day,Daylight Saving Time ends
2019,Summer,05:00:00 PM,1969,980,989,partly cloudy day,
2019,Spring,07:00:00 AM,100,48,52,partly cloudy night,
2019,Summer,05:00:00 AM,47,36,11,clear night,
2019,Summer,12:00:00 PM,2259,1100,1159,partly cloudy day,
2019,Spring,04:00:00 PM,1719,772,947,partly cloudy day,
2019,Fall,02:00:00 PM,2189,1048,1141,clear day,
2019,Fall,12:00:00 PM,1894,872,1022,partly cloudy day,
2019,Winter,12:00:00 AM,17,0,17,cloudy,
2019,Fall,04:00:00 AM,0,0,0,clear night,
2019,Summer,10:00:00 PM,18,5,13,clear night,
2019,Winter,05:00:00 PM,539,265,274,clear day,
2019,Winter,04:00:00 AM,1,0,1,clear night,
2019,Summer,01:00:00 PM,2258,974,1284,clear day,
2019,Summer,05:00:00 PM,1717,893,824,clear day,
2019,Fall,05:00:00 AM,0,0,0,clear night,
2019,Summer,12:00:00 AM,9,5,4,cloudy,
2019,Summer,02:00:00 PM,808,296,512,clear day,
2019,Fall,04:00:00 PM,1241,552,689,partly cloudy day,
2019,Spring,12:00:00 AM,27,19,8,cloudy,
2019,Spring,07:00:00 AM,206,87,119,clear night,
2019,Spring,05:00:00 PM,1632,736,896,partly cloudy day,
2019,Fall,12:00:00 PM,2507,1077,1430,partly cloudy day,
2019,Fall,12:00:00 PM,2926,1394,1532,clear day,
2019,Summer,06:00:00 AM,207,88,119,clear day,
2019,Spring,04:00:00 AM,0,0,0,clear night,
2019,Summer,07:00:00 PM,1847,950,897,clear day,
2019,Spring,07:00:00 PM,507,168,339,clear day,St. Patrick's Day
2019,Summer,07:00:00 AM,190,97,93,clear day,
2019,Spring,04:00:00 PM,2770,1281,1489,clear day,
2019,Winter,02:00:00 PM,2255,1184,1071,clear day,
2019,Fall,11:00:00 PM,54,48,6,partly cloudy night,
2019,Winter,07:00:00 AM,153,68,85,cloudy,
2019,Spring,04:00:00 PM,1370,623,747,partly cloudy day,
2019,Spring,05:00:00 PM,2911,1361,1550,partly cloudy day,
2019,Fall,05:00:00 PM,79,74,5,clear night,
2019,Winter,06:00:00 PM,190,160,30,partly cloudy night,
2019,Winter,02:00:00 PM,1306,667,639,clear day,
2019,Fall,08:00:00 AM,330,122,208,clear day,Veterans Day
2019,Summer,11:00:00 AM,1558,804,754,clear day,
2019,Winter,01:00:00 AM,1,0,1,rain,
2019,Summer,01:00:00 PM,2666,1252,1414,partly cloudy day,
2019,Winter,08:00:00 PM,5,5,0,clear night,
2019,Spring,07:00:00 PM,513,238,275,clear day,
2019,Summer,07:00:00 AM,305,117,188,clear day,
2019,Spring,06:00:00 PM,1192,682,510,partly cloudy day,
2019,Summer,10:00:00 PM,22,11,11,clear night,
2019,Spring,12:00:00 AM,51,50,1,cloudy,Mother's Day
2019,Winter,07:00:00 AM,90,47,43,cloudy,Presidents' Day (regional holiday)
2019,Fall,05:00:00 PM,3554,1450,2104,partly cloudy day,
2019,Winter,05:00:00 AM,1,0,1,rain,
2019,Summer,06:00:00 PM,1407,799,608,partly cloudy day,
2019,Summer,10:00:00 AM,1239,676,563,partly cloudy day,
2019,Spring,07:00:00 AM,255,104,151,clear day,
2019,Spring,12:00:00 PM,1416,687,729,clear day,
2019,Spring,11:00:00 AM,1744,703,1041,partly cloudy day,
2019,Summer,01:00:00 AM,1,0,1,partly cloudy night,
2019,Spring,09:00:00 PM,6,5,1,clear night,
2019,Fall,12:00:00 PM,2489,1124,1365,clear day,
2019,Fall,12:00:00 AM,7,3,4,partly cloudy night,
2019,Summer,10:00:00 PM,79,63,16,clear night,
2019,Fall,08:00:00 AM,474,155,319,clear day,
2019,Summer,11:00:00 AM,2280,1297,983,partly cloudy day,
2019,Summer,05:00:00 PM,2405,1281,1124,partly cloudy day,
2019,Winter,01:00:00 PM,353,167,186,partly cloudy day,Martin Luther King Jr. Day
2019,Fall,08:00:00 AM,222,77,145,cloudy,
2019,Fall,06:00:00 AM,69,43,26,clear night,
2019,Winter,10:00:00 AM,576,299,277,cloudy,
2019,Spring,12:00:00 AM,1,1,0,cloudy,
2019,Summer,10:00:00 PM,19,11,8,clear night,
2019,Fall,12:00:00 PM,1544,715,829,cloudy,
2019,Winter,11:00:00 PM,32,30,2,clear night,Valentine's Day
2019,Fall,01:00:00 PM,1617,708,909,cloudy,
2019,Winter,07:00:00 PM,21,14,7,cloudy,
2019,Spring,11:00:00 PM,3,1,2,partly cloudy night,
2019,Spring,05:00:00 AM,0,0,0,partly cloudy night,
2019,Summer,01:00:00 AM,1,0,1,clear night,Independence Day
2019,Summer,12:00:00 PM,1413,563,850,clear day,
2019,Fall,12:00:00 AM,37,33,4,cloudy,
2019,Winter,01:00:00 PM,592,279,313,cloudy,
2019,Summer,06:00:00 PM,2944,1452,1492,partly cloudy day,
2019,Spring,04:00:00 AM,0,0,0,partly cloudy night,
2019,Spring,02:00:00 AM,3,2,1,partly cloudy night,
2019,Spring,05:00:00 PM,1867,1030,837,partly cloudy day,
2019,Summer,02:00:00 PM,971,469,502,partly cloudy day,
2019,Fall,04:00:00 AM,0,0,0,rain,Halloween
2019,Winter,10:00:00 AM,384,220,164,cloudy,
2019,Fall,06:00:00 PM,1697,949,748,partly cloudy day,
2019,Winter,07:00:00 PM,213,213,0,clear night,
2019,Spring,03:00:00 AM,0,0,0,cloudy,
2019,Winter,03:00:00 PM,1269,588,681,clear day,
2019,Fall,03:00:00 AM,0,0,0,clear night,
2019,Spring,03:00:00 AM,0,0,0,cloudy,
2019,Spring,04:00:00 PM,1908,990,918,partly cloudy day,
2019,Spring,09:00:00 AM,824,488,336,clear day,
2019,Fall,02:00:00 AM,1,0,1,partly cloudy night,Labor Day
2019,Summer,07:00:00 PM,1471,799,672,partly cloudy day,
2019,Winter,11:00:00 PM,5,4,1,cloudy,
2019,Winter,12:00:00 AM,13,9,4,clear night,
2019,Fall,06:00:00 PM,75,71,4,clear night,
2019,Spring,08:00:00 PM,69,54,15,partly cloudy night,Tax Day
2019,Summer,12:00:00 AM,2,0,2,partly cloudy night,
2019,Fall,04:00:00 AM,1,0,1,rain,
2019,Summer,07:00:00 AM,288,130,158,partly cloudy day,
2019,Winter,05:00:00 PM,73,62,11,rain,
2019,Winter,09:00:00 AM,588,353,235,clear day,
2019,Fall,06:00:00 PM,2386,955,1431,clear day,
2019,Spring,05:00:00 AM,30,16,14,clear night,
2019,Summer,05:00:00 PM,2072,998,1074,partly cloudy day,
2019,Winter,02:00:00 PM,302,175,127,sleet,
2019,Winter,06:00:00 AM,31,22,9,clear night,
2019,Spring,02:00:00 AM,0,0,0,,Daylight Saving Time starts
2019,Summer,09:00:00 PM,140,59,81,cloudy,
2019,Winter,12:00:00 AM,1,0,1,cloudy,
2019,Summer,07:00:00 PM,1333,648,685,partly cloudy day,
2019,Summer,04:00:00 AM,0,0,0,partly cloudy night,
2019,Fall,08:00:00 AM,395,159,236,partly cloudy day,
2019,Spring,08:00:00 PM,48,46,2,clear night,
2019,Summer,11:00:00 PM,67,54,13,partly cloudy night,
2019,Spring,12:00:00 AM,21,0,21,partly cloudy night,
2019,Winter,03:00:00 PM,1124,482,642,cloudy,
2019,Winter,07:00:00 PM,9,6,3,cloudy,
2019,Summer,12:00:00 AM,5,4,1,cloudy,
2019,Fall,05:00:00 PM,3056,1316,1740,cloudy,
2019,Fall,02:00:00 PM,1036,515,521,cloudy,
2019,Winter,02:00:00 PM,589,256,333,partly cloudy day,
2019,Winter,11:00:00 PM,1,0,1,partly cloudy night,
2019,Winter,12:00:00 AM,13,8,5,rain,
2019,Winter,08:00:00 AM,319,144,175,clear day,Christmas Eve
2019,Summer,07:00:00 PM,976,477,499,cloudy,
2019,Spring,09:00:00 AM,698,364,334,cloudy,
2019,Spring,12:00:00 AM,4,3,1,partly cloudy night,
2019,Spring,12:00:00 PM,1521,709,812,clear day,
2019,Spring,02:00:00 PM,416,194,222,rain,
2019,Winter,02:00:00 AM,0,0,0,partly cloudy night,
2019,Winter,12:00:00 PM,692,342,350,clear day,
2019,Summer,12:00:00 AM,8,2,6,clear night,
2019,Winter,02:00:00 AM,0,0,0,rain,
2019,Spring,01:00:00 PM,878,389,489,cloudy,
2019,Summer,02:00:00 AM,0,0,0,clear night,
2019,Winter,09:00:00 PM,9,9,0,clear night,
2019,Summer,07:00:00 PM,1393,642,751,partly cloudy day,
2019,Summer,07:00:00 AM,216,91,125,clear day,
2019,Winter,02:00:00 PM,1377,635,742,partly cloudy day,
2019,Spring,07:00:00 PM,90,71,19,rain,
2019,Fall,05:00:00 AM,0,0,0,cloudy,
2019,Spring,09:00:00 AM,326,159,167,partly cloudy day,
2019,Winter,05:00:00 AM,0,0,0,partly cloudy night,
2019,Spring,01:00:00 PM,2430,1169,1261,partly cloudy day,
2019,Winter,04:00:00 AM,0,0,0,cloudy,
2019,Summer,07:00:00 PM,1402,819,583,partly cloudy day,
2019,Summer,08:00:00 PM,1443,625,818,partly cloudy day,
2019,Fall,03:00:00 PM,2216,993,1223,clear day,
2019,Summer,05:00:00 AM,42,32,10,clear night,
2019,Winter,08:00:00 AM,303,114,189,partly cloudy day,
2019,Summer,02:00:00 AM,0,0,0,clear night,
2019,Winter,06:00:00 PM,55,53,2,rain,
2019,Fall,06:00:00 PM,1756,1071,685,clear day,
2019,Fall,12:00:00 AM,1,0,1,clear night,
2019,Summer,07:00:00 AM,198,87,111,cloudy,
2019,Spring,01:00:00 PM,3633,1722,1911,cloudy,Easter Sunday
2019,Winter,09:00:00 PM,0,0,0,cloudy,
2019,Winter,08:00:00 AM,185,56,129,cloudy,
2019,Fall,01:00:00 PM,1849,772,1077,cloudy,
2019,Winter,02:00:00 AM,1,0,1,clear night,
2019,Fall,11:00:00 PM,1,0,1,clear night,
2019,Winter,10:00:00 AM,630,366,264,clear day,
2019,Fall,02:00:00 AM,0,0,0,clear night,
2019,Winter,05:00:00 AM,0,0,0,cloudy,
2019,Fall,08:00:00 AM,316,118,198,cloudy,
2019,Winter,04:00:00 PM,1393,637,756,clear day,
2019,Fall,11:00:00 PM,12,2,10,partly cloudy night,
2019,Summer,11:00:00 AM,1365,732,633,partly cloudy day,
2019,Fall,03:00:00 AM,0,0,0,cloudy,Veterans Day
2019,Summer,08:00:00 AM,364,198,166,partly cloudy day,
2019,Summer,08:00:00 AM,390,211,179,partly cloudy day,
2019,Summer,09:00:00 AM,1249,758,491,clear day,
2019,Fall,03:00:00 AM,1,0,1,clear night,
2019,Summer,07:00:00 PM,1849,1034,815,clear day,
2019,Winter,04:00:00 PM,973,429,544,partly cloudy day,
2019,Fall,03:00:00 AM,0,0,0,partly cloudy night,
2019,Winter,01:00:00 AM,1,0,1,partly cloudy night,
2019,Spring,01:00:00 PM,1949,876,1073,clear day,
2019,Fall,09:00:00 PM,0,0,0,cloudy,
2019,Winter,06:00:00 AM,72,38,34,clear night,
2019,Fall,10:00:00 PM,26,14,12,partly cloudy night,Labor Day
2019,Fall,01:00:00 AM,1,0,1,clear night,Daylight Saving Time ends
2019,Spring,04:00:00 PM,1664,778,886,partly cloudy day,
2019,Winter,01:00:00 PM,926,392,534,clear day,
2019,Fall,08:00:00 AM,445,217,228,clear day,
2019,Summer,05:00:00 AM,43,30,13,clear night,
2019,Winter,10:00:00 PM,35,34,1,cloudy,
2019,Winter,05:00:00 AM,0,0,0,partly cloudy night,
2019,Winter,03:00:00 PM,877,437,440,clear day,
2019,Spring,09:00:00 AM,555,263,292,cloudy,
2019,Spring,11:00:00 AM,2829,1504,1325,partly cloudy day,
2019,Summer,10:00:00 AM,525,300,225,rain,
2019,Summer,03:00:00 AM,1,0,1,clear night,
2019,Spring,08:00:00 AM,223,95,128,clear day,
2019,Winter,10:00:00 PM,8,0,8,clear night,
2019,Spring,08:00:00 PM,39,33,6,clear night,
2019,Winter,09:00:00 AM,655,427,228,clear day,
2019,Fall,04:00:00 AM,0,0,0,cloudy,
2019,Summer,04:00:00 PM,2026,968,1058,partly cloudy day,
2019,Winter,02:00:00 AM,0,0,0,partly cloudy night,
2019,Winter,01:00:00 AM,0,0,0,partly cloudy night,
2019,Winter,09:00:00 AM,422,202,220,partly cloudy day,
2019,Spring,02:00:00 AM,0,0,0,partly cloudy night,Tax Day
2019,Fall,09:00:00 AM,156,76,80,rain,Halloween
2019,Summer,09:00:00 PM,115,81,34,partly cloudy night,
2019,Fall,05:00:00 AM,0,0,0,clear night,
2019,Summer,02:00:00 PM,2212,1002,1210,partly cloudy day,
2019,Fall,12:00:00 AM,1,0,1,clear night,
2019,Fall,10:00:00 PM,39,38,1,partly cloudy night,
2019,Spring,03:00:00 PM,2567,1179,1388,partly cloudy day,
2019,Winter,10:00:00 AM,1237,697,540,partly cloudy day,
2019,Fall,03:00:00 AM,0,0,0,clear night,
2019,Spring,05:00:00 AM,2,1,1,clear night,
2019,Fall,09:00:00 AM,823,463,360,clear day,
2019,Spring,03:00:00 PM,2950,1276,1674,clear day,
2019,Winter,09:00:00 PM,64,47,17,cloudy,
2019,Fall,12:00:00 AM,0,0,0,partly cloudy night,
2019,Fall,12:00:00 PM,2578,1220,1358,clear day,
2019,Summer,02:00:00 AM,1,0,1,partly cloudy night,
2019,Summer,01:00:00 PM,1988,962,1026,partly cloudy day,
2019,Winter,03:00:00 AM,1,0,1,cloudy,
2019,Fall,05:00:00 AM,0,0,0,cloudy,
2019,Winter,09:00:00 AM,533,268,265,cloudy,
2019,Fall,02:00:00 PM,2353,1132,1221,partly cloudy day,
2019,Summer,03:00:00 PM,2828,1187,1641,partly cloudy day,
2019,Winter,10:00:00 AM,535,327,208,clear day,
2019,Spring,09:00:00 PM,7,3,4,partly cloudy night,
2019,Spring,08:00:00 AM,474,168,306,clear day,
2019,Winter,03:00:00 PM,2140,1041,1099,clear day,
2019,Summer,05:00:00 PM,1891,963,928,partly cloudy day,
2019,Spring,03:00:00 AM,0,0,0,cloudy,
2019,Spring,02:00:00 AM,1,0,1,cloudy,
2019,Summer,01:00:00 PM,745,341,404,partly cloudy day,
2019,Summer,09:00:00 AM,1277,716,561,partly cloudy day,
2019,Fall,04:00:00 AM,0,0,0,clear night,
2019,Summer,01:00:00 PM,1434,521,913,partly cloudy day,
2019,Spring,10:00:00 AM,744,379,365,partly cloudy day,
2019,Winter,12:00:00 AM,2,0,2,clear night,
2019,Spring,07:00:00 PM,835,393,442,partly cloudy day,Tax Day
2019,Spring,02:00:00 PM,2103,955,1148,partly cloudy day,
2019,Spring,12:00:00 PM,1776,853,923,partly cloudy day,
2019,Fall,05:00:00 AM,1,0,1,partly cloudy night,
2019,Spring,05:00:00 AM,16,7,9,cloudy,
2019,Winter,10:00:00 PM,2,2,0,cloudy,
2019,Spring,03:00:00 AM,0,0,0,partly cloudy night,
2019,Spring,08:00:00 PM,14,10,4,partly cloudy night,
2019,Summer,10:00:00 AM,1110,606,504,partly cloudy day,
2019,Winter,11:00:00 AM,1451,734,717,clear day,
2019,Winter,12:00:00 PM,3745,2141,1604,clear day,
2019,Spring,02:00:00 AM,0,0,0,cloudy,
2019,Spring,06:00:00 PM,1284,659,625,cloudy,
2019,Spring,02:00:00 PM,722,346,376,rain,Cinco de Mayo
2019,Winter,05:00:00 AM,3,3,0,partly cloudy night,
2019,Fall,09:00:00 AM,697,381,316,partly cloudy day,
2019,Spring,01:00:00 AM,1,0,1,partly cloudy night,
2019,Fall,04:00:00 AM,0,0,0,partly cloudy night,
2019,Winter,02:00:00 AM,1,0,1,clear night,
2019,Winter,12:00:00 PM,1359,675,684,clear day,
2019,Summer,02:00:00 PM,2163,974,1189,partly cloudy day,
2019,Summer,12:00:00 PM,2094,950,1144,partly cloudy day,
2019,Spring,05:00:00 PM,2834,1345,1489,partly cloudy day,
2019,Fall,05:00:00 AM,1,0,1,partly cloudy night,
2019,Summer,06:00:00 AM,134,65,69,partly cloudy night,
2019,Spring,10:00:00 PM,2,2,0,clear night,
2019,Spring,06:00:00 PM,1671,718,953,partly cloudy day,
2019,Fall,11:00:00 PM,45,44,1,clear night,
2019,Winter,09:00:00 AM,171,77,94,cloudy,
2019,Spring,09:00:00 AM,558,284,274,partly cloudy day,
2019,Fall,11:00:00 AM,2603,1376,1227,clear day,
2019,Fall,05:00:00 PM,8,5,3,clear night,Thanksgiving Day
2019,Summer,09:00:00 AM,921,596,325,partly cloudy day,
2019,Fall,09:00:00 AM,869,571,298,partly cloudy day,
2019,Fall,01:00:00 AM,0,0,0,cloudy,
2019,Summer,12:00:00 AM,5,3,2,partly cloudy night,
2019,Spring,09:00:00 PM,18,6,12,cloudy,
2019,Summer,02:00:00 PM,511,259,252,partly cloudy day,
2019,Summer,11:00:00 PM,37,29,8,partly cloudy night,
2019,Fall,09:00:00 AM,506,250,256,cloudy,
2019,Summer,06:00:00 AM,198,98,100,clear day,
2019,Spring,04:00:00 AM,0,0,0,clear night,St. Patrick's Day
2019,Winter,12:00:00 PM,872,392,480,clear day,
2019,Winter,03:00:00 PM,1896,905,991,partly cloudy day,
2019,Summer,10:00:00 PM,14,7,7,fog,
2019,Fall,04:00:00 PM,2517,1222,1295,clear day,
2019,Fall,08:00:00 PM,32,31,1,clear night,
2019,Winter,05:00:00 PM,95,89,6,clear night,
2019,Summer,05:00:00 PM,2833,1209,1624,partly cloudy day,
2019,Fall,07:00:00 PM,76,61,15,cloudy,
2019,Spring,03:00:00 PM,1737,718,1019,cloudy,
2019,Summer,12:00:00 AM,6,5,1,clear night,
2019,Summer,11:00:00 PM,42,33,9,rain,
2019,Spring,09:00:00 AM,890,492,398,clear day,
2019,Winter,02:00:00 PM,700,337,363,rain,
2019,Fall,03:00:00 PM,1470,726,744,partly cloudy day,
2019,Fall,03:00:00 AM,0,0,0,partly cloudy night,
2019,Fall,04:00:00 AM,0,0,0,cloudy,
2019,Winter,08:00:00 AM,214,85,129,partly cloudy day,
2019,Winter,01:00:00 AM,2,0,2,clear night,
2019,Fall,02:00:00 PM,1404,617,787,clear day,
2019,Summer,04:00:00 AM,0,0,0,rain,
2019,Spring,07:00:00 AM,195,78,117,cloudy,
2019,Winter,07:00:00 AM,111,47,64,cloudy,
2019,Fall,09:00:00 PM,16,13,3,clear night,
2019,Winter,10:00:00 AM,912,555,357,cloudy,
2019,Spring,09:00:00 PM,90,58,32,partly cloudy night,Cinco de Mayo
2019,Fall,07:00:00 PM,85,76,9,cloudy,
2019,Winter,05:00:00 PM,2227,907,1320,clear day,
2019,Summer,10:00:00 PM,45,21,24,partly cloudy night,
2019,Winter,01:00:00 PM,270,134,136,rain,
2019,Fall,03:00:00 AM,1,0,1,rain,
2019,Spring,09:00:00 AM,641,324,317,cloudy,
2019,Fall,09:00:00 PM,39,32,7,partly cloudy night,
2019,Summer,07:00:00 PM,1869,1021,848,partly cloudy day,
2019,Fall,03:00:00 AM,0,0,0,clear night,
2019,Spring,09:00:00 PM,38,14,24,partly cloudy night,
2019,Fall,01:00:00 PM,2300,970,1330,partly cloudy day,
2019,Winter,08:00:00 AM,238,79,159,cloudy,Valentine's Day
2019,Winter,11:00:00 AM,2259,1371,888,clear day,Christmas Day
2019,Fall,08:00:00 PM,59,0,59,clear night,
2019,Winter,07:00:00 AM,150,70,80,clear day,
2019,Spring,09:00:00 PM,87,71,16,partly cloudy night,
2019,Summer,09:00:00 AM,533,305,228,partly cloudy day,
2019,Summer,06:00:00 AM,148,78,70,cloudy,
2019,Fall,04:00:00 PM,1611,695,916,clear day,
2019,Summer,02:00:00 PM,2154,954,1200,clear day,
2019,Spring,02:00:00 AM,1,0,1,clear night,
2019,Winter,03:00:00 AM,0,0,0,cloudy,
2019,Spring,02:00:00 AM,1,0,1,cloudy,
2019,Summer,01:00:00 PM,1996,947,1049,partly cloudy day,
2019,Summer,04:00:00 PM,860,492,368,rain,
2019,Summer,08:00:00 AM,418,153,265,clear day,
2019,Winter,02:00:00 PM,1270,561,709,cloudy,
2019,Spring,08:00:00 AM,221,88,133,clear day,
2019,Summer,01:00:00 PM,2228,969,1259,clear day,Independence Day
2019,Winter,05:00:00 AM,1,0,1,clear night,
2019,Winter,08:00:00 PM,24,23,1,partly cloudy night,
2019,Winter,07:00:00 PM,138,99,39,partly cloudy night,
2019,Summer,04:00:00 AM,0,0,0,clear night,
2019,Winter,10:00:00 PM,44,40,4,cloudy,
2019,Spring,04:00:00 AM,0,0,0,partly cloudy night,
2019,Spring,10:00:00 AM,835,467,368,partly cloudy day,
2019,Winter,09:00:00 AM,529,293,236,partly cloudy day,New Year's Day
2019,Winter,10:00:00 AM,992,589,403,clear day,
2019,Spring,03:00:00 AM,0,0,0,clear night,
2019,Fall,01:00:00 PM,2459,1123,1336,clear day,
2019,Spring,06:00:00 AM,246,117,129,clear night,
2019,Winter,12:00:00 AM,0,0,0,cloudy,
2019,Summer,01:00:00 PM,1893,868,1025,cloudy,
2019,Spring,09:00:00 AM,305,138,167,cloudy,
2019,Summer,01:00:00 PM,1864,737,1127,clear day,
2019,Fall,07:00:00 PM,761,391,370,clear night,
2019,Summer,09:00:00 PM,75,55,20,partly cloudy night,
2019,Winter,02:00:00 AM,0,0,0,clear night,
2019,Fall,11:00:00 PM,40,0,40,clear night,
2019,Winter,04:00:00 PM,1665,805,860,partly cloudy day,
2019,Winter,08:00:00 PM,43,29,14,cloudy,
2019,Spring,01:00:00 PM,1280,614,666,partly cloudy day,Tax Day
2019,Spring,06:00:00 AM,84,43,41,cloudy,
2019,Summer,04:00:00 AM,0,0,0,cloudy,
2019,Fall,09:00:00 PM,26,23,3,clear night,
2019,Summer,09:00:00 AM,588,276,312,clear day,
2019,Fall,01:00:00 AM,0,0,0,partly cloudy night,
2019,Spring,04:00:00 PM,1980,986,994,clear day,
2019,Summer,08:00:00 AM,483,133,350,clear day,
2019,Summer,10:00:00 AM,1300,739,561,clear day,
2019,Winter,02:00:00 AM,0,0,0,clear night,
2019,Spring,04:00:00 AM,0,0,0,clear night,
2019,Winter,10:00:00 PM,3,1,2,partly cloudy night,
2019,Spring,02:00:00 PM,3305,1485,1820,clear day,Memorial Day
2019,Summer,03:00:00 PM,1551,765,786,partly cloudy day,
2019,Summer,03:00:00 AM,3,2,1,clear night,
2019,Winter,04:00:00 AM,1,0,1,clear night,
2019,Spring,06:00:00 AM,60,41,19,clear night,
2019,Spring,02:00:00 AM,0,0,0,clear night,
2019,Spring,02:00:00 PM,2540,1167,1373,clear day,
2019,Spring,03:00:00 PM,2973,1431,1542,cloudy,
2019,Winter,05:00:00 AM,5,1,4,cloudy,
2019,Winter,10:00:00 AM,1230,669,561,clear day,
2019,Fall,08:00:00 AM,162,56,106,clear day,
2019,Spring,12:00:00 PM,2496,1082,1414,clear day,
2019,Summer,10:00:00 AM,1106,657,449,clear day,
2019,Spring,03:00:00 PM,1525,758,767,partly cloudy day,
2019,Fall,03:00:00 PM,1378,623,755,partly cloudy day,
2019,Summer,03:00:00 AM,0,0,0,partly cloudy night,
2019,Winter,02:00:00 AM,1,0,1,clear night,
2019,Winter,08:00:00 PM,57,36,21,clear night,
2019,Fall,02:00:00 AM,3,2,1,cloudy,
2019,Spring,02:00:00 AM,1,0,1,cloudy,
2019,Spring,05:00:00 PM,2679,1314,1365,clear day,
2019,Summer,08:00:00 AM,456,273,183,clear day,
2019,Winter,01:00:00 AM,2,0,2,partly cloudy night,
2019,Fall,05:00:00 AM,1,0,1,partly cloudy night,
2019,Winter,07:00:00 PM,49,49,0,cloudy,
2019,Fall,05:00:00 PM,100,94,6,cloudy,
2019,Fall,09:00:00 AM,589,311,278,clear day,
2019,Fall,12:00:00 AM,38,37,1,partly cloudy night,
2019,Summer,03:00:00 PM,1051,380,671,cloudy,
2019,Spring,11:00:00 PM,16,14,2,partly cloudy night,
2019,Summer,09:00:00 PM,46,17,29,partly cloudy night,
2019,Summer,03:00:00 AM,0,0,0,partly cloudy night,
2019,Summer,02:00:00 AM,7,6,1,cloudy,
2019,Fall,12:00:00 AM,3,0,3,clear night,
2019,Summer,04:00:00 PM,1086,545,541,partly cloudy day,
2019,Fall,03:00:00 PM,1432,645,787,cloudy,
2019,Spring,06:00:00 AM,151,82,69,clear day,
2019,Summer,11:00:00 AM,1206,575,631,cloudy,
2019,Winter,12:00:00 PM,2173,947,1226,clear day,
2019,Fall,10:00:00 PM,12,6,6,cloudy,
2019,Winter,04:00:00 AM,0,0,0,clear night,
2019,Summer,05:00:00 PM,509,337,172,rain,
2019,Winter,05:00:00 PM,681,287,394,clear day,
2019,Fall,07:00:00 AM,205,88,117,partly cloudy night,
2019,Fall,12:00:00 AM,7,5,2,rain,
2019,Fall,03:00:00 PM,3623,1550,2073,partly cloudy day,
2019,Summer,02:00:00 AM,1,0,1,partly cloudy night,
2019,Winter,09:00:00 PM,7,4,3,partly cloudy night,
2019,Winter,05:00:00 AM,0,0,0,clear night,
2019,Winter,10:00:00 PM,4,0,4,clear night,Christmas Eve
2019,Summer,04:00:00 AM,0,0,0,cloudy,
2019,Fall,04:00:00 AM,0,0,0,partly cloudy night,
2019,Summer,04:00:00 AM,0,0,0,partly cloudy night,
2019,Spring,09:00:00 PM,77,44,33,partly cloudy night,
2019,Fall,12:00:00 PM,2331,973,1358,partly cloudy day,
2019,Winter,03:00:00 AM,1,0,1,clear night,Christmas Eve
2019,Winter,10:00:00 AM,680,358,322,clear day,
2019,Winter,09:00:00 PM,4,3,1,clear night,
2019,Spring,03:00:00 AM,0,0,0,clear night,
2019,Summer,05:00:00 AM,51,37,14,partly cloudy night,
2019,Fall,08:00:00 AM,469,187,282,clear day,
2019,Winter,03:00:00 PM,0,0,0,clear day,
2019,Spring,10:00:00 PM,98,81,17,partly cloudy night,Easter Sunday
2019,Fall,01:00:00 AM,0,0,0,clear night,
2019,Fall,10:00:00 PM,4,0,4,cloudy,
2019,Summer,05:00:00 AM,12,7,5,rain,
2019,Fall,03:00:00 AM,0,0,0,clear night,
2019,Winter,12:00:00 PM,909,457,452,cloudy,
2019,Summer,01:00:00 AM,0,0,0,partly cloudy night,
2019,Fall,08:00:00 AM,313,122,191,cloudy,
2019,Summer,11:00:00 PM,44,41,3,partly cloudy night,
2019,Winter,02:00:00 PM,2498,1251,1247,clear day,
2019,Spring,12:00:00 PM,601,283,318,cloudy,
2019,Spring,08:00:00 AM,482,188,294,clear day,
2019,Spring,01:00:00 PM,1804,747,1057,cloudy,
2019,Winter,07:00:00 PM,12,5,7,clear night,Martin Luther King Jr. Day
2019,Summer,07:00:00 PM,1012,598,414,partly cloudy day,
2019,Fall,12:00:00 PM,2037,867,1170,clear day,
2019,Fall,04:00:00 AM,0,0,0,partly cloudy night,
2019,Winter,01:00:00 AM,1,0,1,partly cloudy night,
2019,Fall,09:00:00 PM,2,1,1,clear night,
2019,Summer,01:00:00 AM,12,4,8,rain,
2019,Summer,03:00:00 AM,0,0,0,cloudy,
2019,Spring,01:00:00 AM,2,1,1,cloudy,
2019,Fall,11:00:00 PM,6,3,3,partly cloudy night,
2019,Winter,05:00:00 AM,3,2,1,cloudy,
2019,Spring,12:00:00 PM,1809,803,1006,partly cloudy day,
2019,Winter,04:00:00 AM,1,0,1,partly cloudy night,
2019,Spring,08:00:00 AM,189,111,78,cloudy,
2019,Fall,02:00:00 AM,0,0,0,partly cloudy night,
2019,Spring,03:00:00 PM,1781,867,914,cloudy,
2019,Spring,06:00:00 PM,1443,859,584,cloudy,
2019,Summer,05:00:00 PM,1310,634,676,partly cloudy day,
2019,Summer,02:00:00 AM,1,0,1,rain,
2019,Winter,05:00:00 PM,1172,594,578,partly cloudy day,
2019,Winter,05:00:00 AM,2,0,2,cloudy,
2019,Summer,03:00:00 PM,1759,764,995,partly cloudy day,
2019,Winter,01:00:00 PM,698,388,310,rain,
2019,Winter,04:00:00 PM,946,534,412,clear day,
2019,Spring,07:00:00 AM,91,43,48,partly cloudy day,
2019,Summer,08:00:00 PM,1571,678,893,clear day,
2019,Winter,03:00:00 PM,984,427,557,cloudy,
2019,Winter,04:00:00 PM,1025,465,560,clear day,
2019,Summer,07:00:00 PM,1462,781,681,partly cloudy day,
2019,Fall,11:00:00 AM,2164,870,1294,clear day,
2019,Spring,12:00:00 PM,3187,1571,1616,partly cloudy day,
2019,Winter,03:00:00 PM,2682,1367,1315,clear day,
2019,Spring,05:00:00 AM,0,0,0,cloudy,
2019,Summer,12:00:00 AM,81,77,4,partly cloudy night,
2019,Spring,02:00:00 PM,3255,1423,1832,partly cloudy day,
2019,Spring,03:00:00 AM,1,0,1,clear night,
2019,Fall,09:00:00 PM,14,0,14,clear night,
2019,Summer,01:00:00 PM,2074,961,1113,partly cloudy day,
2019,Summer,06:00:00 PM,2063,990,1073,partly cloudy day,
2019,Summer,05:00:00 PM,761,359,402,rain,
2019,Fall,10:00:00 PM,21,20,1,cloudy,
2019,Winter,08:00:00 PM,95,92,3,rain,
2019,Fall,01:00:00 PM,1873,780,1093,partly cloudy day,
2019,Winter,06:00:00 AM,17,9,8,partly cloudy night,
2019,Summer,09:00:00 PM,126,68,58,clear night,
2019,Summer,10:00:00 PM,40,15,25,clear night,
2019,Winter,09:00:00 AM,284,164,120,partly cloudy day,
2019,Fall,01:00:00 AM,0,0,0,clear night,
2019,Winter,08:00:00 AM,149,66,83,cloudy,Presidents' Day (regional holiday)
2019,Summer,07:00:00 AM,334,163,171,partly cloudy day,
2019,Spring,09:00:00 PM,74,41,33,cloudy,Mother's Day
2019,Summer,04:00:00 PM,2568,1205,1363,partly cloudy day,
2019,Summer,07:00:00 AM,284,127,157,clear day,
2019,Fall,11:00:00 AM,1975,882,1093,clear day,
2019,Winter,11:00:00 PM,4,0,4,clear night,
2019,Fall,06:00:00 PM,71,68,3,clear night,
2019,Spring,11:00:00 PM,58,47,11,clear night,
2019,Spring,09:00:00 PM,19,5,14,partly cloudy night,
2019,Winter,08:00:00 PM,9,8,1,cloudy,
2019,Summer,06:00:00 AM,83,32,51,rain,
2019,Winter,03:00:00 PM,2606,1235,1371,cloudy,
2019,Winter,02:00:00 AM,0,0,0,clear night,
2019,Summer,05:00:00 AM,63,32,31,clear night,
2019,Winter,02:00:00 PM,3005,1622,1383,partly cloudy day,
2019,Fall,01:00:00 PM,78,47,31,rain,
2019,Spring,07:00:00 AM,167,76,91,clear day,
2019,Spring,02:00:00 PM,2833,1327,1506,clear day,
2019,Summer,06:00:00 AM,121,48,73,partly cloudy night,
2019,Summer,03:00:00 PM,1311,601,710,partly cloudy day,
2019,Spring,11:00:00 PM,79,78,1,cloudy,Mother's Day
2019,Fall,08:00:00 PM,3,0,3,clear night,
2019,Winter,08:00:00 AM,40,21,19,partly cloudy day,Martin Luther King Jr. Day
2019,Fall,07:00:00 AM,268,135,133,partly cloudy day,
2019,Fall,02:00:00 PM,2528,1128,1400,clear day,
2019,Fall,09:00:00 PM,3,2,1,clear night,
2019,Winter,04:00:00 PM,830,398,432,cloudy,
2019,Winter,05:00:00 PM,935,418,517,partly cloudy day,
2019,Summer,11:00:00 AM,1357,624,733,partly cloudy day,
2019,Summer,12:00:00 PM,1582,726,856,partly cloudy day,
2019,Fall,07:00:00 AM,252,109,143,partly cloudy night,
2019,Fall,10:00:00 PM,1,0,1,clear night,
2019,Summer,10:00:00 AM,1589,906,683,partly cloudy day,
2019,Winter,04:00:00 AM,2,0,2,clear night,
2019,Spring,08:00:00 PM,7,6,1,clear night,
2019,Spring,10:00:00 PM,3,1,2,partly cloudy night,
2019,Winter,09:00:00 AM,234,112,122,partly cloudy day,
2019,Fall,08:00:00 PM,27,22,5,clear night,
2019,Summer,04:00:00 AM,3,2,1,clear night,
2019,Spring,03:00:00 AM,0,0,0,clear night,
2019,Summer,10:00:00 AM,108,46,62,rain,
2019,Summer,06:00:00 AM,162,86,76,cloudy,
2019,Spring,12:00:00 AM,2,0,2,rain,
2019,Summer,10:00:00 PM,17,4,13,partly cloudy night,
2019,Spring,07:00:00 PM,848,326,522,clear day,
2019,Winter,12:00:00 AM,38,37,1,clear night,
2019,Winter,10:00:00 AM,1481,782,699,clear day,
2019,Spring,11:00:00 AM,703,344,359,cloudy,
2019,Fall,10:00:00 PM,24,0,24,partly cloudy night,
2019,Winter,03:00:00 AM,0,0,0,clear night,
2019,Summer,03:00:00 PM,3112,1444,1668,partly cloudy day,
2019,Fall,11:00:00 AM,1278,592,686,partly cloudy day,
2019,Summer,06:00:00 AM,116,50,66,cloudy,
2019,Summer,09:00:00 PM,99,83,16,partly cloudy night,
2019,Summer,04:00:00 PM,593,209,384,cloudy,
2019,Fall,10:00:00 PM,4,2,2,clear night,
2019,Winter,08:00:00 PM,13,9,4,cloudy,
2019,Summer,12:00:00 AM,22,6,16,partly cloudy night,
2019,Winter,09:00:00 PM,11,8,3,clear night,
2019,Winter,05:00:00 AM,2,0,2,clear night,
2019,Fall,12:00:00 PM,1183,556,627,cloudy,
2019,Spring,10:00:00 PM,22,9,13,clear night,
2019,Spring,11:00:00 PM,0,0,0,clear night,
2019,Summer,05:00:00 PM,2192,1118,1074,partly cloudy day,
2019,Fall,04:00:00 AM,0,0,0,clear night,
2019,Fall,12:00:00 PM,806,418,388,cloudy,
2019,Winter,02:00:00 AM,0,0,0,cloudy,
2019,Summer,11:00:00 AM,2353,1342,1011,clear day,
2019,Winter,09:00:00 AM,153,94,59,partly cloudy day,
2019,Winter,06:00:00 PM,91,89,2,rain,
2019,Fall,08:00:00 PM,80,79,1,clear night,
2019,Spring,05:00:00 PM,2586,1242,1344,clear day,
2019,Summer,08:00:00 PM,591,305,286,rain,
2019,Fall,05:00:00 PM,1744,878,866,partly cloudy day,
2019,Spring,06:00:00 PM,680,341,339,cloudy,
2019,Fall,08:00:00 PM,93,83,10,cloudy,
2019,Fall,07:00:00 AM,325,138,187,clear night,
2019,Summer,07:00:00 PM,1723,968,755,partly cloudy day,
2019,Fall,12:00:00 AM,0,0,0,rain,
2019,Spring,10:00:00 PM,4,0,4,clear night,
2019,Winter,06:00:00 AM,54,54,0,clear night,
2019,Fall,09:00:00 PM,19,0,19,cloudy,
2019,Spring,10:00:00 PM,20,7,13,cloudy,
2019,Summer,05:00:00 PM,1657,939,718,partly cloudy day,
2019,Fall,12:00:00 PM,1958,911,1047,clear day,Black Friday
2019,Summer,03:00:00 PM,2409,971,1438,clear day,
2019,Spring,11:00:00 AM,1259,659,600,partly cloudy day,
2019,Winter,01:00:00 AM,0,0,0,rain,
2019,Spring,09:00:00 PM,28,12,16,cloudy,
2019,Winter,09:00:00 AM,233,92,141,cloudy,
2019,Summer,09:00:00 AM,604,361,243,partly cloudy day,Independence Day
2019,Fall,04:00:00 PM,3287,1494,1793,partly cloudy day,
2019,Summer,07:00:00 AM,294,132,162,clear day,
2019,Summer,06:00:00 PM,1643,972,671,clear day,
2019,Fall,06:00:00 PM,1928,929,999,partly cloudy day,
2019,Winter,09:00:00 PM,0,0,0,clear night,
2019,Fall,01:00:00 PM,2949,1346,1603,clear day,
2019,Fall,03:00:00 AM,0,0,0,clear night,
2019,Summer,08:00:00 AM,384,126,258,partly cloudy day,
2019,Spring,12:00:00 PM,1498,649,849,cloudy,
2019,Fall,10:00:00 PM,0,0,0,clear night,
2019,Winter,06:00:00 AM,1,0,1,cloudy,New Year's Eve
2019,Summer,04:00:00 AM,0,0,0,partly cloudy night,
2019,Summer,09:00:00 PM,98,33,65,partly cloudy night,
2019,Spring,08:00:00 PM,94,64,30,rain,
2019,Winter,10:00:00 PM,56,55,1,clear night,
2019,Fall,05:00:00 AM,0,0,0,partly cloudy night,
2019,Fall,04:00:00 PM,2051,1048,1003,clear day,
2019,Winter,01:00:00 PM,765,377,388,cloudy,
2019,Winter,02:00:00 PM,634,296,338,cloudy,
2019,Winter,04:00:00 PM,2328,1135,1193,clear day,
2019,Summer,07:00:00 AM,278,114,164,cloudy,
2019,Fall,03:00:00 PM,3115,1595,1520,clear day,
2019,Spring,07:00:00 PM,637,345,292,cloudy,
2019,Winter,07:00:00 PM,44,41,3,clear night,Valentine's Day
2019,Winter,08:00:00 PM,17,9,8,clear night,
2019,Winter,01:00:00 AM,2,0,2,cloudy,
2019,Summer,05:00:00 AM,79,65,14,clear night,Independence Day
2019,Summer,07:00:00 PM,1758,853,905,partly cloudy day,
2019,Spring,08:00:00 AM,135,50,85,cloudy,
2019,Spring,09:00:00 AM,905,409,496,clear day,
2019,Spring,08:00:00 AM,336,211,125,clear day,
2019,Spring,10:00:00 AM,1901,1007,894,clear day,
2019,Spring,07:00:00 AM,122,69,53,cloudy,
2019,Summer,04:00:00 PM,2561,1131,1430,partly cloudy day,
2019,Summer,10:00:00 PM,70,67,3,rain,
2019,Summer,09:00:00 AM,577,270,307,clear day,
2019,Spring,04:00:00 PM,1885,804,1081,clear day,
2019,Summer,09:00:00 PM,20,16,4,rain,
2019,Summer,09:00:00 AM,905,584,321,clear day,
2019,Summer,02:00:00 AM,0,0,0,clear night,
2019,Winter,01:00:00 AM,0,0,0,clear night,Christmas Day
2019,Summer,06:00:00 PM,2100,1315,785,partly cloudy day,
2019,Summer,07:00:00 AM,259,116,143,partly cloudy day,
2019,Fall,07:00:00 PM,93,92,1,clear night,
2019,Winter,06:00:00 PM,91,78,13,partly cloudy night,
2019,Winter,10:00:00 PM,2,0,2,clear night,
2019,Spring,01:00:00 PM,1473,565,908,clear day,
2019,Spring,12:00:00 PM,1414,580,834,partly cloudy day,
2019,Spring,08:00:00 AM,414,166,248,clear day,
2019,Winter,10:00:00 PM,16,7,9,clear night,
2019,Spring,06:00:00 PM,1093,597,496,cloudy,
2019,Summer,02:00:00 PM,1946,881,1065,partly cloudy day,
2019,Winter,01:00:00 PM,1681,734,947,partly cloudy day,
2019,Summer,03:00:00 PM,1876,916,960,partly cloudy day,
2019,Winter,06:00:00 AM,1,0,1,rain,
2019,Fall,04:00:00 PM,1929,915,1014,clear day,
2019,Spring,12:00:00 AM,2,0,2,clear night,
2019,Summer,01:00:00 AM,1,0,1,partly cloudy night,
2019,Summer,08:00:00 PM,245,118,127,partly cloudy night,
2019,Summer,03:00:00 AM,1,0,1,clear night,
2019,Summer,04:00:00 PM,1433,688,745,partly cloudy day,
2019,Winter,12:00:00 PM,404,181,223,sleet,
2019,Winter,07:00:00 PM,1,0,1,partly cloudy night,
2019,Spring,08:00:00 PM,18,16,2,clear night,
2019,Fall,08:00:00 PM,98,57,41,cloudy,
2019,Winter,09:00:00 AM,94,60,34,partly cloudy day,Martin Luther King Jr. Day
2019,Winter,06:00:00 PM,67,66,1,clear night,
2019,Summer,05:00:00 AM,42,27,15,partly cloudy night,
2019,Spring,09:00:00 PM,33,16,17,cloudy,
2019,Spring,08:00:00 AM,483,151,332,cloudy,
2019,Winter,02:00:00 AM,1,0,1,clear night,
2019,Fall,06:00:00 AM,95,57,38,partly cloudy night,
2019,Spring,05:00:00 PM,1605,853,752,partly cloudy day,
2019,Fall,04:00:00 AM,0,0,0,clear night,
2019,Fall,07:00:00 PM,5,2,3,cloudy,
2019,Fall,09:00:00 PM,11,7,4,clear night,
2019,Fall,04:00:00 PM,1654,805,849,partly cloudy day,
2019,Spring,10:00:00 AM,932,558,374,partly cloudy day,St. Patrick's Day
2019,Spring,03:00:00 PM,2868,1344,1524,partly cloudy day,
2019,Summer,01:00:00 PM,1559,653,906,partly cloudy day,
2019,Fall,09:00:00 AM,578,319,259,partly cloudy day,
2019,Spring,12:00:00 PM,1324,586,738,clear day,
2019,Summer,04:00:00 PM,2423,1184,1239,clear day,
2019,Summer,10:00:00 PM,17,7,10,cloudy,
2019,Spring,08:00:00 PM,515,255,260,partly cloudy day,
2019,Winter,02:00:00 PM,479,225,254,snow,
2019,Fall,09:00:00 AM,768,478,290,partly cloudy day,Labor Day
2019,Summer,10:00:00 PM,50,36,14,partly cloudy night,
2019,Fall,09:00:00 PM,51,44,7,partly cloudy night,
2019,Spring,02:00:00 AM,1,0,1,cloudy,
2019,Spring,09:00:00 PM,19,13,6,partly cloudy night,
2019,Fall,06:00:00 PM,1175,578,597,partly cloudy day,
2019,Fall,03:00:00 PM,1696,799,897,clear day,
2019,Fall,11:00:00 AM,1540,708,832,partly cloudy day,
2019,Fall,09:00:00 PM,40,33,7,partly cloudy night,
2019,Spring,08:00:00 PM,9,8,1,cloudy,
2019,Winter,05:00:00 PM,33,31,2,cloudy,
2019,Spring,10:00:00 PM,3,3,0,clear night,
2019,Spring,06:00:00 AM,17,8,9,snow,
2019,Spring,07:00:00 AM,282,126,156,cloudy,
2019,Fall,03:00:00 AM,1,0,1,partly cloudy night,
2019,Fall,12:00:00 AM,33,32,1,partly cloudy night,
2019,Winter,08:00:00 AM,145,47,98,cloudy,
2019,Fall,05:00:00 AM,0,0,0,partly cloudy night,
2019,Winter,07:00:00 AM,164,42,122,clear day,
2019,Fall,04:00:00 PM,597,290,307,partly cloudy day,
2019,Winter,02:00:00 PM,1408,655,753,partly cloudy day,
2019,Fall,11:00:00 AM,1549,782,767,partly cloudy day,
2019,Summer,11:00:00 PM,69,67,2,rain,
2019,Winter,01:00:00 PM,1458,672,786,cloudy,
2019,Spring,09:00:00 PM,53,52,1,partly cloudy night,
2019,Summer,03:00:00 AM,0,0,0,partly cloudy night,
2019,Summer,07:00:00 PM,1951,848,1103,clear day,
2019,Fall,10:00:00 AM,1057,624,433,cloudy,
2019,Summer,07:00:00 PM,86,54,32,rain,
2019,Fall,11:00:00 AM,1285,588,697,cloudy,
2019,Summer,04:00:00 AM,1,0,1,cloudy,
2019,Spring,02:00:00 AM,0,0,0,clear night,Easter Monday
2019,Fall,01:00:00 AM,2,0,2,rain,
2019,Fall,01:00:00 AM,0,0,0,clear night,
2019,Fall,01:00:00 PM,1992,871,1121,partly cloudy day,
2019,Spring,05:00:00 PM,1521,760,761,partly cloudy day,
2019,Spring,03:00:00 AM,0,0,0,partly cloudy night,
2019,Summer,05:00:00 PM,2936,1362,1574,partly cloudy day,
2019,Fall,11:00:00 AM,428,221,207,cloudy,
2019,Fall,07:00:00 AM,192,92,100,clear night,Black Friday
2019,Spring,12:00:00 PM,408,217,191,rain,Daylight Saving Time starts
2019,Fall,05:00:00 PM,2363,1207,1156,clear day,
2019,Fall,11:00:00 AM,1672,757,915,clear day,
2019,Fall,10:00:00 PM,0,0,0,clear night,
2019,Summer,02:00:00 PM,70,42,28,partly cloudy day,
2019,Spring,04:00:00 AM,0,0,0,cloudy,
2019,Spring,02:00:00 AM,5,4,1,cloudy,Cinco de Mayo
2019,Spring,12:00:00 AM,51,49,2,partly cloudy night,
2019,Summer,01:00:00 PM,2049,974,1075,partly cloudy day,
2019,Fall,11:00:00 PM,7,0,7,rain,
2019,Spring,09:00:00 AM,1266,726,540,partly cloudy day,Easter Sunday
2019,Winter,07:00:00 AM,112,47,65,partly cloudy night,
2019,Summer,04:00:00 AM,1,0,1,clear night,
2019,Winter,07:00:00 AM,102,44,58,cloudy,
2019,Winter,10:00:00 AM,831,494,337,clear day,
2019,Winter,06:00:00 PM,54,42,12,clear night,
2019,Fall,07:00:00 AM,233,95,138,clear day,
2019,Fall,10:00:00 AM,3312,2555,757,partly cloudy day,
2019,Fall,01:00:00 AM,0,0,0,clear night,
2019,Spring,01:00:00 PM,2545,1164,1381,clear day,
2019,Spring,06:00:00 AM,116,56,60,clear day,
2019,Winter,03:00:00 AM,0,0,0,cloudy,Presidents' Day (regional holiday)
2019,Fall,08:00:00 PM,24,23,1,clear night,
2019,Summer,11:00:00 AM,1390,700,690,cloudy,
2019,Winter,07:00:00 PM,65,59,6,partly cloudy night,
2019,Summer,08:00:00 AM,400,181,219,partly cloudy day,
2019,Spring,04:00:00 PM,1617,748,869,partly cloudy day,
2019,Winter,10:00:00 PM,33,0,33,clear night,
2019,Winter,09:00:00 PM,81,0,81,rain,
2019,Fall,09:00:00 PM,5,3,2,cloudy,
2019,Fall,07:00:00 AM,224,90,134,partly cloudy day,
2019,Spring,09:00:00 PM,15,7,8,cloudy,
2019,Winter,11:00:00 AM,1137,441,696,cloudy,
2019,Winter,08:00:00 PM,48,45,3,partly cloudy night,
2019,Winter,10:00:00 AM,394,233,161,clear day,
2019,Spring,09:00:00 PM,31,25,6,rain,
2019,Summer,06:00:00 PM,1963,1093,870,partly cloudy day,
2019,Summer,11:00:00 PM,8,6,2,rain,
2019,Fall,05:00:00 PM,1708,925,783,partly cloudy day,
2019,Winter,12:00:00 AM,14,11,3,cloudy,
2019,Spring,03:00:00 AM,0,0,0,cloudy,
2019,Fall,04:00:00 AM,0,0,0,cloudy,
2019,Summer,04:00:00 AM,0,0,0,clear night,
2019,Winter,10:00:00 PM,84,83,1,partly cloudy night,
2019,Winter,09:00:00 PM,5,4,1,clear night,
2019,Spring,02:00:00 AM,4,1,3,cloudy,
2019,Fall,05:00:00 AM,2,0,2,clear night,Daylight Saving Time ends
2019,Fall,11:00:00 AM,1720,773,947,clear day,
2019,Fall,01:00:00 PM,2413,949,1464,clear day,
2019,Summer,07:00:00 AM,306,139,167,clear day,
2019,Spring,01:00:00 AM,0,0,0,clear night,
2019,Spring,04:00:00 PM,3614,1588,2026,partly cloudy day,
2019,Summer,11:00:00 PM,16,10,6,partly cloudy night,
2019,Winter,04:00:00 AM,0,0,0,partly cloudy night,
2019,Spring,05:00:00 AM,1,1,0,cloudy,
2019,Spring,08:00:00 AM,279,109,170,partly cloudy day,Tax Day
2019,Winter,09:00:00 AM,280,126,154,partly cloudy day,
2019,Winter,10:00:00 AM,1071,603,468,clear day,
2019,Fall,08:00:00 AM,293,116,177,partly cloudy day,
2019,Summer,08:00:00 AM,304,150,154,partly cloudy day,
2019,Fall,07:00:00 PM,910,498,412,partly cloudy day,
2019,Summer,01:00:00 PM,3223,1468,1755,partly cloudy day,
2019,Winter,06:00:00 AM,13,10,3,clear night,Christmas Day
2019,Winter,11:00:00 PM,4,3,1,partly cloudy night,
2019,Spring,12:00:00 AM,14,14,0,partly cloudy night,
2019,Summer,05:00:00 PM,2587,1209,1378,partly cloudy day,
2019,Winter,03:00:00 PM,1581,716,865,clear day,
2019,Summer,10:00:00 PM,43,21,22,partly cloudy night,
2019,Winter,01:00:00 PM,962,459,503,cloudy,
2019,Fall,06:00:00 PM,3137,1498,1639,partly cloudy day,
2019,Winter,09:00:00 AM,312,171,141,clear day,
2019,Spring,11:00:00 AM,2506,1253,1253,clear day,
2019,Winter,08:00:00 AM,416,218,198,clear day,
2019,Summer,08:00:00 AM,461,232,229,partly cloudy day,
2019,Fall,02:00:00 PM,2317,1038,1279,partly cloudy day,
2019,Fall,03:00:00 AM,0,0,0,partly cloudy night,Thanksgiving Day
2019,Spring,02:00:00 AM,1,0,1,rain,
2019,Spring,04:00:00 AM,0,0,0,cloudy,
2019,Fall,12:00:00 AM,1,0,1,clear night,
2019,Spring,06:00:00 AM,134,62,72,partly cloudy day,
2019,Spring,01:00:00 PM,3272,1494,1778,partly cloudy day,
2019,Summer,06:00:00 AM,106,55,51,partly cloudy day,
2019,Fall,06:00:00 AM,67,47,20,partly cloudy night,
2019,Winter,10:00:00 AM,178,103,75,rain,
2019,Spring,04:00:00 AM,0,0,0,clear night,
2019,Winter,07:00:00 PM,41,27,14,partly cloudy night,
2019,Fall,08:00:00 PM,15,0,15,partly cloudy night,
2019,Fall,07:00:00 AM,218,106,112,clear day,Veterans Day
2019,Winter,01:00:00 AM,1,0,1,cloudy,
2019,Winter,05:00:00 AM,0,0,0,clear night,
2019,Fall,08:00:00 PM,62,60,2,partly cloudy night,Daylight Saving Time ends
2019,Winter,05:00:00 PM,30,29,1,partly cloudy night,
2019,Winter,11:00:00 AM,581,307,274,clear day,
2019,Winter,10:00:00 PM,7,5,2,cloudy,
2019,Fall,06:00:00 PM,85,83,2,clear night,
2019,Spring,02:00:00 PM,2073,1017,1056,cloudy,
2019,Fall,05:00:00 AM,0,0,0,clear night,
2019,Summer,02:00:00 PM,1907,836,1071,partly cloudy day,
2019,Winter,01:00:00 AM,2,0,2,clear night,
2019,Spring,11:00:00 PM,0,0,0,partly cloudy night,
2019,Summer,09:00:00 AM,1203,691,512,cloudy,
2019,Fall,11:00:00 AM,3245,1655,1590,cloudy,
2019,Summer,04:00:00 PM,1896,900,996,partly cloudy day,
2019,Fall,01:00:00 AM,2,0,2,partly cloudy night,
2019,Winter,07:00:00 AM,121,72,49,cloudy,
2019,Spring,04:00:00 PM,3123,1388,1735,clear day,
2019,Winter,01:00:00 AM,5,0,5,cloudy,
2019,Spring,06:00:00 AM,94,50,44,partly cloudy day,
2019,Winter,05:00:00 PM,67,61,6,cloudy,
2019,Spring,05:00:00 PM,650,356,294,rain,Easter Monday
2019,Spring,01:00:00 PM,1328,642,686,cloudy,
2019,Spring,11:00:00 AM,1005,525,480,cloudy,
2019,Summer,10:00:00 PM,28,12,16,partly cloudy night,
2019,Winter,06:00:00 PM,21,17,4,clear night,
2019,Summer,01:00:00 PM,2717,1230,1487,partly cloudy day,
2019,Spring,12:00:00 AM,27,26,1,clear night,
2019,Winter,09:00:00 PM,15,0,15,rain,
2019,Fall,09:00:00 AM,682,399,283,partly cloudy day,
2019,Winter,10:00:00 PM,27,26,1,cloudy,
2019,Summer,07:00:00 PM,1308,700,608,clear day,
2019,Spring,06:00:00 PM,307,194,113,clear night,
2019,Spring,03:00:00 AM,0,0,0,partly cloudy night,
2019,Fall,10:00:00 PM,30,30,0,cloudy,
2019,Spring,04:00:00 AM,0,0,0,clear night,
2019,Spring,04:00:00 PM,2004,1012,992,partly cloudy day,
2019,Summer,08:00:00 PM,1739,662,1077,clear day,
2019,Winter,02:00:00 PM,695,304,391,partly cloudy day,
2019,Fall,01:00:00 PM,2234,938,1296,cloudy,
2019,Spring,03:00:00 PM,2972,1221,1751,cloudy,
2019,Fall,06:00:00 AM,27,22,5,clear night,
2019,Spring,01:00:00 PM,2092,956,1136,clear day,
2019,Spring,06:00:00 AM,77,40,37,partly cloudy night,
2019,Spring,11:00:00 AM,1733,854,879,partly cloudy day,
2019,Winter,06:00:00 PM,115,69,46,clear night,
2019,Fall,10:00:00 AM,1540,832,708,partly cloudy day,
2019,Spring,06:00:00 PM,1765,994,771,partly cloudy day,
2019,Fall,07:00:00 PM,1034,444,590,clear night,
2019,Fall,03:00:00 PM,3292,1578,1714,clear day,
2019,Fall,09:00:00 PM,8,0,8,clear night,Black Friday
2019,Summer,12:00:00 PM,1607,715,892,cloudy,
2019,Spring,05:00:00 PM,1042,531,511,cloudy,
2019,Spring,08:00:00 PM,188,140,48,cloudy,
2019,Summer,04:00:00 AM,1,0,1,cloudy,
2019,Spring,11:00:00 AM,1570,773,797,partly cloudy day,
2019,Spring,07:00:00 AM,184,84,100,clear night,
2019,Winter,07:00:00 AM,112,55,57,cloudy,
2019,Summer,02:00:00 AM,0,0,0,clear night,
2019,Fall,07:00:00 PM,72,69,3,partly cloudy night,
2019,Summer,11:00:00 PM,17,4,13,clear night,
2019,Summer,10:00:00 PM,21,6,15,clear night,
2019,Winter,03:00:00 AM,0,0,0,clear night,
2019,Winter,06:00:00 AM,15,5,10,clear night,
2019,Fall,08:00:00 PM,54,53,1,cloudy,
2019,Summer,11:00:00 PM,19,12,7,partly cloudy night,
2019,Summer,02:00:00 AM,1,0,1,partly cloudy night,
2019,Fall,09:00:00 PM,11,6,5,partly cloudy night,
2019,Fall,08:00:00 PM,91,65,26,partly cloudy night,
2019,Summer,02:00:00 AM,0,0,0,clear night,
2019,Winter,09:00:00 AM,72,37,35,rain,
2019,Winter,07:00:00 PM,2,2,0,rain,
2019,Spring,12:00:00 PM,2004,935,1069,clear day,
2019,Spring,06:00:00 AM,32,28,4,clear night,
2019,Fall,01:00:00 AM,2,1,1,clear night,
2019,Spring,04:00:00 PM,821,422,399,partly cloudy day,
2019,Fall,03:00:00 PM,1859,807,1052,partly cloudy day,
2019,Fall,05:00:00 PM,3190,1398,1792,partly cloudy day,
2019,Fall,09:00:00 AM,718,366,352,partly cloudy day,
2019,Fall,02:00:00 AM,0,0,0,clear night,
2019,Spring,07:00:00 PM,963,475,488,partly cloudy day,
2019,Spring,11:00:00 AM,1427,706,721,clear day,
2019,Fall,07:00:00 PM,284,130,154,clear night,
2019,Fall,09:00:00 PM,31,19,12,cloudy,
2019,Spring,03:00:00 AM,0,0,0,cloudy,
2019,Summer,02:00:00 AM,4,3,1,cloudy,
2019,Fall,08:00:00 PM,42,41,1,clear night,
2019,Winter,01:00:00 PM,1530,619,911,clear day,
2019,Summer,06:00:00 PM,2296,1048,1248,partly cloudy day,
2019,Winter,04:00:00 PM,1159,1159,0,clear day,
2019,Fall,09:00:00 AM,520,288,232,cloudy,
2019,Spring,12:00:00 PM,1052,590,462,cloudy,
2019,Winter,12:00:00 AM,4,3,1,clear night,
2019,Fall,12:00:00 PM,2491,1122,1369,partly cloudy day,Columbus Day (regional holiday)
2019,Summer,08:00:00 PM,1339,595,744,partly cloudy day,
2019,Spring,01:00:00 PM,2107,958,1149,cloudy,
2019,Spring,05:00:00 PM,3542,1584,1958,clear day,
2019,Fall,01:00:00 PM,1111,506,605,cloudy,
2019,Winter,01:00:00 AM,1,0,1,clear night,
2019,Winter,04:00:00 AM,0,0,0,cloudy,Valentine's Day
2019,Winter,06:00:00 PM,67,59,8,partly cloudy night,
2019,Fall,07:00:00 PM,457,227,230,partly cloudy night,
2019,Winter,01:00:00 AM,10,4,6,rain,
2019,Winter,12:00:00 AM,0,0,0,cloudy,
2019,Winter,05:00:00 AM,4,3,1,cloudy,
2019,Winter,11:00:00 PM,45,45,0,fog,
2019,Spring,09:00:00 AM,711,387,324,partly cloudy day,Tax Day
2019,Summer,03:00:00 AM,9,8,1,clear night,
2019,Summer,01:00:00 PM,1189,506,683,clear day,
2019,Spring,06:00:00 AM,171,70,101,clear day,
2019,Fall,06:00:00 AM,80,47,33,clear night,
2019,Summer,05:00:00 AM,53,43,10,clear night,
2019,Spring,06:00:00 AM,192,91,101,partly cloudy day,
2019,Summer,02:00:00 PM,1996,834,1162,partly cloudy day,
2019,Summer,04:00:00 AM,0,0,0,clear night,
2019,Spring,12:00:00 PM,706,367,339,rain,
2019,Spring,02:00:00 PM,1326,562,764,cloudy,
2019,Spring,01:00:00 AM,0,0,0,partly cloudy night,Tax Day
2019,Fall,11:00:00 PM,10,5,5,clear night,
2019,Fall,08:00:00 PM,31,30,1,partly cloudy night,
2019,Winter,01:00:00 AM,0,0,0,clear night,
2019,Spring,10:00:00 PM,38,19,19,partly cloudy night,
2019,Summer,06:00:00 PM,1585,1006,579,partly cloudy day,
2019,Spring,11:00:00 PM,34,33,1,cloudy,
2019,Winter,01:00:00 PM,3485,1638,1847,partly cloudy day,New Year's Day
2019,Summer,01:00:00 AM,2,1,1,partly cloudy night,
2019,Winter,02:00:00 PM,1282,661,621,partly cloudy day,
2019,Summer,06:00:00 AM,251,146,105,partly cloudy night,
2019,Summer,01:00:00 PM,1692,716,976,clear day,
2019,Fall,12:00:00 PM,1336,563,773,clear day,
2019,Fall,12:00:00 PM,900,401,499,clear day,
2019,Fall,10:00:00 AM,1465,817,648,clear day,
2019,Summer,04:00:00 PM,2167,990,1177,partly cloudy day,
2019,Winter,07:00:00 PM,7,0,7,cloudy,New Year's Eve
2019,Spring,03:00:00 AM,0,0,0,cloudy,
2019,Winter,09:00:00 AM,447,251,196,cloudy,
2019,Summer,04:00:00 PM,2399,1131,1268,partly cloudy day,
2019,Fall,07:00:00 PM,29,26,3,rain,
2019,Summer,07:00:00 PM,2271,941,1330,partly cloudy day,
2019,Fall,04:00:00 PM,2188,1111,1077,clear day,
2019,Fall,09:00:00 PM,10,8,2,cloudy,
2019,Spring,04:00:00 PM,2823,1189,1634,clear day,
2019,Summer,07:00:00 AM,277,119,158,partly cloudy day,
2019,Winter,06:00:00 PM,127,111,16,partly cloudy night,
2019,Spring,04:00:00 AM,0,0,0,clear night,
2019,Spring,05:00:00 AM,18,10,8,partly cloudy night,
2019,Winter,06:00:00 AM,23,18,5,clear night,
2019,Summer,03:00:00 AM,1,0,1,clear night,
2019,Fall,06:00:00 AM,40,30,10,clear night,
2019,Fall,10:00:00 AM,779,458,321,partly cloudy day,
2019,Fall,04:00:00 PM,2026,883,1143,clear day,
2019,Summer,04:00:00 AM,1,1,0,clear night,
2019,Spring,02:00:00 AM,0,0,0,clear night,
2019,Winter,06:00:00 PM,10,8,2,clear night,Christmas Eve
2019,Fall,05:00:00 AM,1,0,1,clear night,
2019,Fall,06:00:00 PM,1142,633,509,cloudy,
2019,Fall,05:00:00 AM,1,0,1,clear night,
2019,Summer,03:00:00 PM,3244,1570,1674,partly cloudy day,
2019,Spring,07:00:00 PM,1088,558,530,partly cloudy day,
2019,Fall,01:00:00 PM,1624,697,927,cloudy,
2019,Summer,01:00:00 AM,2,2,0,clear night,
2019,Summer,04:00:00 PM,1921,897,1024,partly cloudy day,
2019,Fall,08:00:00 PM,49,47,2,clear night,
2019,Winter,06:00:00 AM,9,7,2,clear night,
2019,Winter,05:00:00 PM,221,162,59,rain,
2019,Spring,01:00:00 PM,1044,474,570,snow,
2019,Fall,09:00:00 AM,724,389,335,clear day,
2019,Summer,09:00:00 AM,680,402,278,partly cloudy day,
2019,Summer,07:00:00 AM,241,98,143,partly cloudy day,
2019,Spring,07:00:00 AM,243,114,129,partly cloudy day,
2019,Spring,01:00:00 AM,1,1,0,partly cloudy night,
2019,Spring,06:00:00 AM,93,43,50,cloudy,
2019,Summer,07:00:00 AM,238,124,114,clear day,
2019,Spring,06:00:00 AM,39,20,19,rain,
2019,Summer,08:00:00 PM,908,387,521,clear day,
2019,Winter,07:00:00 AM,182,108,74,clear night,Christmas Eve
2019,Spring,12:00:00 PM,1318,604,714,clear day,
2019,Spring,10:00:00 AM,1732,1002,730,partly cloudy day,
2019,Spring,03:00:00 PM,1662,742,920,clear day,
2019,Winter,12:00:00 AM,0,0,0,partly cloudy night,
2019,Summer,06:00:00 AM,255,102,153,partly cloudy day,
2019,Spring,09:00:00 AM,1086,560,526,clear day,
2019,Winter,10:00:00 PM,43,0,43,clear night,
2019,Fall,10:00:00 AM,915,495,420,clear day,
2019,Spring,11:00:00 AM,1108,563,545,clear day,
2019,Fall,07:00:00 PM,72,70,2,clear night,
2019,Winter,01:00:00 AM,0,0,0,clear night,
2019,Summer,05:00:00 PM,1933,976,957,partly cloudy day,
2019,Spring,09:00:00 PM,33,14,19,partly cloudy night,
2019,Summer,09:00:00 AM,678,361,317,clear day,
2019,Winter,02:00:00 AM,3,0,3,clear night,
2019,Spring,04:00:00 PM,2009,931,1078,partly cloudy day,
2019,Fall,04:00:00 PM,2166,983,1183,partly cloudy day,
2019,Summer,12:00:00 AM,89,82,7,clear night,
2019,Spring,04:00:00 PM,1475,595,880,partly cloudy day,
2019,Summer,11:00:00 AM,1432,704,728,partly cloudy day,
2019,Winter,07:00:00 AM,177,86,91,clear night,
2019,Summer,05:00:00 PM,2121,1105,1016,partly cloudy day,
2019,Summer,11:00:00 AM,1306,654,652,partly cloudy day,
2019,Spring,01:00:00 PM,1223,418,805,cloudy,
2019,Spring,11:00:00 AM,1955,938,1017,clear day,
2019,Winter,05:00:00 PM,402,222,180,partly cloudy night,
2019,Winter,11:00:00 AM,0,0,0,clear day,
2019,Fall,01:00:00 AM,3,0,3,clear night,
2019,Fall,08:00:00 AM,440,205,235,partly cloudy day,
2019,Winter,05:00:00 AM,0,0,0,clear night,
2019,Spring,02:00:00 AM,0,0,0,partly cloudy night,
2019,Summer,09:00:00 AM,692,363,329,clear day,
2019,Summer,10:00:00 AM,1040,562,478,clear day,
2019,Summer,01:00:00 PM,1678,844,834,cloudy,
2019,Spring,05:00:00 AM,50,34,16,clear night,
2019,Summer,08:00:00 AM,112,22,90,rain,
2019,Spring,04:00:00 PM,542,266,276,cloudy,
2019,Summer,12:00:00 AM,2,0,2,clear night,Independence Day
2019,Fall,03:00:00 PM,1337,583,754,clear day,
2019,Fall,06:00:00 PM,2401,1148,1253,clear day,
2019,Spring,04:00:00 AM,1,0,1,clear night,
2019,Spring,04:00:00 AM,0,0,0,clear night,
2019,Fall,01:00:00 PM,2939,1204,1735,clear day,
2019,Summer,06:00:00 AM,38,15,23,fog,
2019,Winter,11:00:00 AM,610,330,280,cloudy,
2019,Fall,08:00:00 AM,476,177,299,clear day,
2019,Fall,04:00:00 AM,2,0,2,clear night,
2019,Spring,08:00:00 PM,63,31,32,cloudy,
2019,Spring,11:00:00 AM,1418,637,781,cloudy,
2019,Spring,06:00:00 PM,251,134,117,rain,Mother's Day
2019,Fall,10:00:00 PM,14,13,1,partly cloudy night,
2019,Spring,09:00:00 AM,570,280,290,cloudy,
2019,Winter,11:00:00 PM,6,3,3,clear night,Martin Luther King Jr. Day
2019,Winter,05:00:00 AM,0,0,0,clear night,
2019,Summer,11:00:00 PM,4,1,3,partly cloudy night,
2019,Spring,07:00:00 AM,112,55,57,partly cloudy night,
2019,Winter,01:00:00 AM,0,0,0,cloudy,
2019,Spring,07:00:00 PM,23,21,2,clear night,
2019,Spring,06:00:00 PM,502,287,215,cloudy,
2019,Spring,11:00:00 PM,9,4,5,partly cloudy night,
2019,Summer,05:00:00 PM,2057,1067,990,partly cloudy day,
2019,Summer,07:00:00 AM,467,186,281,partly cloudy day,
2019,Spring,01:00:00 PM,1267,541,726,clear day,
2019,Summer,01:00:00 PM,1608,651,957,partly cloudy day,
2019,Summer,10:00:00 AM,1635,862,773,partly cloudy day,
2019,Summer,11:00:00 AM,2224,1164,1060,clear day,
2019,Spring,03:00:00 AM,1,0,1,rain,Mother's Day
2019,Spring,10:00:00 PM,16,3,13,clear night,
2019,Fall,03:00:00 AM,0,0,0,partly cloudy night,
2019,Fall,04:00:00 AM,0,0,0,partly cloudy night,
2019,Spring,08:00:00 PM,1346,494,852,partly cloudy day,
2019,Winter,02:00:00 PM,2243,993,1250,partly cloudy day,
2019,Winter,02:00:00 PM,1597,647,950,partly cloudy day,
2019,Winter,01:00:00 PM,951,472,479,partly cloudy day,
2019,Fall,05:00:00 PM,1472,698,774,partly cloudy day,
2019,Fall,10:00:00 AM,1556,945,611,partly cloudy day,
2019,Summer,11:00:00 AM,1660,912,748,partly cloudy day,
2019,Summer,11:00:00 PM,8,3,5,clear night,
2019,Winter,01:00:00 PM,2625,1344,1281,clear day,
2019,Summer,08:00:00 AM,378,209,169,clear day,
2019,Summer,08:00:00 PM,2124,899,1225,clear day,
2019,Spring,06:00:00 PM,2520,1111,1409,partly cloudy day,
2019,Summer,12:00:00 AM,7,2,5,partly cloudy night,
2019,Spring,01:00:00 PM,2477,1117,1360,partly cloudy day,
2019,Spring,06:00:00 PM,141,77,64,cloudy,
2019,Fall,01:00:00 AM,1,0,1,clear night,
2019,Summer,03:00:00 PM,2336,1018,1318,partly cloudy day,
2019,Winter,01:00:00 AM,2,0,2,clear night,
2019,Spring,09:00:00 AM,390,193,197,clear day,
2019,Fall,10:00:00 PM,66,64,2,partly cloudy night,
2019,Summer,01:00:00 PM,1731,757,974,partly cloudy day,
2019,Summer,11:00:00 AM,1198,649,549,cloudy,
2019,Summer,08:00:00 AM,453,152,301,clear day,
2019,Winter,08:00:00 AM,183,88,95,cloudy,
2019,Winter,07:00:00 AM,125,59,66,clear night,
2019,Winter,09:00:00 PM,7,5,2,partly cloudy night,
2019,Fall,12:00:00 PM,2075,864,1211,cloudy,
2019,Spring,11:00:00 PM,1,0,1,partly cloudy night,
2019,Spring,04:00:00 AM,1,0,1,rain,
2019,Summer,12:00:00 AM,1,0,1,clear night,
2019,Summer,06:00:00 PM,2198,1009,1189,clear day,
2019,Winter,10:00:00 PM,1,0,1,partly cloudy night,
2019,Summer,10:00:00 AM,1679,947,732,clear day,
2019,Winter,09:00:00 AM,152,89,63,rain,
2019,Winter,04:00:00 AM,1,0,1,clear night,
2019,Summer,06:00:00 AM,222,88,134,clear night,
2019,Winter,06:00:00 AM,7,6,1,clear night,
2019,Summer,05:00:00 PM,2442,1212,1230,clear day,
2019,Spring,10:00:00 PM,23,21,2,cloudy,
2019,Winter,02:00:00 AM,1,1,0,clear night,
2019,Summer,08:00:00 AM,497,180,317,clear day,
2019,Winter,09:00:00 PM,6,4,2,clear night,
2019,Winter,12:00:00 AM,14,0,14,clear night,
2019,Winter,02:00:00 AM,15,10,5,rain,New Year's Day
2019,Spring,07:00:00 PM,401,227,174,cloudy,
2019,Fall,05:00:00 AM,0,0,0,partly cloudy night,
2019,Fall,09:00:00 PM,8,7,1,clear night,
2019,Fall,05:00:00 PM,82,73,9,cloudy,
2019,Spring,02:00:00 PM,2255,1038,1217,clear day,St. Patrick's Day
2019,Winter,06:00:00 AM,44,24,20,clear night,
2019,Winter,02:00:00 AM,0,0,0,clear night,
2019,Summer,12:00:00 PM,2465,1152,1313,partly cloudy day,
2019,Fall,03:00:00 AM,0,0,0,partly cloudy night,
2019,Spring,09:00:00 AM,822,383,439,clear day,
2019,Winter,02:00:00 AM,0,0,0,cloudy,New Year's Eve
2019,Summer,04:00:00 PM,1697,879,818,partly cloudy day,
2019,Winter,05:00:00 PM,1809,929,880,clear day,
2019,Winter,02:00:00 AM,3,1,2,clear night,
2019,Spring,02:00:00 PM,3169,1381,1788,clear day,
2019,Summer,11:00:00 PM,8,4,4,clear night,
2019,Spring,02:00:00 AM,3,1,2,cloudy,
2019,Spring,11:00:00 AM,1962,1025,937,cloudy,
2019,Spring,01:00:00 AM,2,1,1,cloudy,
2019,Summer,07:00:00 PM,1540,867,673,partly cloudy day,
2019,Winter,02:00:00 PM,891,408,483,rain,
2019,Winter,09:00:00 AM,428,252,176,clear day,
2019,Winter,08:00:00 PM,69,0,69,clear night,
2019,Winter,09:00:00 AM,359,183,176,clear day,
2019,Spring,03:00:00 AM,0,0,0,partly cloudy night,
2019,Summer,12:00:00 AM,62,59,3,clear night,
2019,Winter,12:00:00 AM,7,2,5,,
2019,Summer,02:00:00 AM,1,0,1,partly cloudy night,
2019,Summer,05:00:00 PM,2125,1048,1077,partly cloudy day,
2019,Fall,04:00:00 PM,3127,1245,1882,cloudy,
2019,Fall,08:00:00 PM,9,6,3,clear night,
2019,Summer,02:00:00 AM,0,0,0,partly cloudy night,
2019,Fall,02:00:00 PM,1480,621,859,partly cloudy day,
2019,Summer,07:00:00 AM,267,107,160,partly cloudy day,
2019,Fall,04:00:00 PM,301,162,139,cloudy,
2019,Spring,12:00:00 AM,0,0,0,cloudy,
2019,Winter,03:00:00 PM,2313,1388,925,partly cloudy day,
2019,Summer,06:00:00 AM,177,81,96,cloudy,
2019,Winter,01:00:00 PM,1662,756,906,partly cloudy day,
2019,Winter,01:00:00 PM,1196,592,604,partly cloudy day,
2019,Summer,01:00:00 AM,1,0,1,cloudy,
2019,Spring,03:00:00 AM,0,0,0,clear night,
2019,Winter,04:00:00 AM,0,0,0,clear night,
2019,Spring,03:00:00 PM,2095,1043,1052,partly cloudy day,
2019,Summer,12:00:00 PM,1041,490,551,cloudy,
2019,Summer,05:00:00 PM,1273,603,670,cloudy,
2019,Spring,11:00:00 AM,1871,975,896,cloudy,
2019,Spring,03:00:00 PM,493,270,223,rain,
2019,Fall,06:00:00 AM,155,103,52,partly cloudy night,
2019,Winter,11:00:00 PM,2,0,2,clear night,
2019,Winter,08:00:00 AM,308,153,155,partly cloudy day,
2019,Summer,10:00:00 PM,39,16,23,partly cloudy night,
2019,Spring,03:00:00 PM,1573,738,835,partly cloudy day,
2019,Winter,03:00:00 PM,1440,700,740,clear day,
2019,Summer,01:00:00 PM,1278,588,690,cloudy,
2019,Spring,03:00:00 AM,0,0,0,cloudy,
2019,Spring,05:00:00 AM,12,9,3,cloudy,
2019,Fall,07:00:00 PM,47,41,6,partly cloudy night,
2019,Summer,12:00:00 PM,2626,1389,1237,partly cloudy day,
2019,Winter,09:00:00 AM,195,101,94,rain,
2019,Summer,04:00:00 PM,402,181,221,rain,
2019,Winter,09:00:00 PM,3,0,3,cloudy,
2019,Winter,01:00:00 PM,740,370,370,cloudy,
2019,Fall,06:00:00 AM,38,22,16,cloudy,
2019,Fall,04:00:00 AM,0,0,0,partly cloudy night,
2019,Fall,01:00:00 AM,5,0,5,clear night,
2019,Spring,03:00:00 AM,0,0,0,clear night,
2019,Fall,08:00:00 PM,25,8,17,cloudy,
2019,Summer,03:00:00 PM,1657,533,1124,cloudy,
2019,Winter,09:00:00 AM,249,138,111,clear day,
2019,Winter,02:00:00 PM,2276,1124,1152,clear day,
2019,Spring,05:00:00 PM,1386,614,772,clear day,
2019,Winter,09:00:00 PM,34,0,34,clear night,
2019,Winter,08:00:00 AM,137,34,103,cloudy,
2019,Summer,03:00:00 AM,0,0,0,partly cloudy night,
2019,Spring,08:00:00 AM,230,76,154,clear day,
2019,Spring,06:00:00 PM,2476,1176,1300,clear day,
2019,Winter,10:00:00 PM,15,5,10,clear night,
2019,Fall,09:00:00 PM,5,3,2,clear night,
2019,Spring,04:00:00 PM,1382,640,742,partly cloudy day,
2019,Fall,08:00:00 PM,23,17,6,cloudy,
2019,Spring,10:00:00 PM,1,0,1,partly cloudy night,
2019,Winter,10:00:00 PM,22,22,0,clear night,
2019,Spring,12:00:00 PM,1536,745,791,clear day,
2019,Fall,11:00:00 AM,1890,1046,844,partly cloudy day,
2019,Spring,12:00:00 PM,2416,1029,1387,partly cloudy day,
2019,Winter,06:00:00 PM,497,150,347,partly cloudy night,Presidents' Day (regional holiday)
2019,Fall,04:00:00 PM,1476,678,798,partly cloudy day,
2019,Summer,10:00:00 AM,1538,892,646,partly cloudy day,
2019,Winter,04:00:00 PM,978,471,507,cloudy,
2019,Fall,12:00:00 PM,1513,513,1000,cloudy,
2019,Fall,08:00:00 PM,65,61,4,clear night,
2019,Fall,10:00:00 PM,10,5,5,clear night,
2019,Fall,03:00:00 PM,2129,1047,1082,clear day,
2019,Summer,03:00:00 PM,2076,932,1144,partly cloudy day,Father's Day
2019,Fall,11:00:00 PM,6,1,5,clear night,
2019,Spring,11:00:00 AM,2135,1052,1083,cloudy,
2019,Winter,02:00:00 PM,2079,887,1192,clear day,
2019,Spring,09:00:00 AM,659,366,293,partly cloudy day,
2019,Summer,11:00:00 PM,15,7,8,partly cloudy night,
2019,Winter,02:00:00 PM,868,389,479,partly cloudy day,
2019,Summer,01:00:00 AM,1,0,1,partly cloudy night,
2019,Winter,03:00:00 AM,3,3,0,cloudy,
2019,Spring,04:00:00 PM,760,345,415,cloudy,
2019,Spring,02:00:00 AM,0,0,0,partly cloudy night,
2019,Winter,06:00:00 AM,2,1,1,rain,
2019,Winter,03:00:00 PM,1448,711,737,clear day,Valentine's Day
2019,Fall,06:00:00 PM,1667,941,726,partly cloudy day,
2019,Spring,02:00:00 AM,1,0,1,clear night,
2019,Summer,07:00:00 PM,1471,818,653,partly cloudy day,
2019,Winter,11:00:00 AM,838,838,0,clear day,
2019,Fall,11:00:00 AM,2231,1150,1081,clear day,
2019,Summer,10:00:00 AM,1381,799,582,partly cloudy day,
2019,Summer,03:00:00 PM,3023,1362,1661,clear day,
2019,Winter,02:00:00 AM,1,0,1,clear night,
2019,Spring,11:00:00 AM,2089,962,1127,partly cloudy day,
2019,Spring,04:00:00 PM,2218,968,1250,partly cloudy day,
2019,Summer,08:00:00 AM,395,209,186,cloudy,
2019,Fall,04:00:00 PM,2538,1102,1436,cloudy,
2019,Fall,03:00:00 AM,0,0,0,clear night,
2019,Winter,05:00:00 AM,1,0,1,rain,
2019,Spring,08:00:00 AM,307,116,191,cloudy,
2019,Fall,12:00:00 PM,171,76,95,rain,
2019,Spring,09:00:00 AM,1317,794,523,clear day,
2019,Summer,01:00:00 AM,0,0,0,partly cloudy night,
2019,Spring,07:00:00 AM,371,164,207,clear night,
2019,Fall,02:00:00 AM,0,0,0,clear night,
2019,Spring,01:00:00 AM,0,0,0,cloudy,
2019,Spring,10:00:00 PM,14,8,6,cloudy,
2019,Winter,04:00:00 PM,3498,2123,1375,clear day,Christmas Day
2019,Fall,11:00:00 AM,1446,607,839,partly cloudy day,
2019,Fall,10:00:00 PM,53,0,53,clear night,
2019,Fall,10:00:00 AM,304,164,140,rain,
2019,Spring,03:00:00 AM,0,0,0,partly cloudy night,
2019,Winter,01:00:00 AM,0,0,0,partly cloudy night,
2019,Fall,02:00:00 PM,625,295,330,rain,
2019,Summer,05:00:00 PM,1155,649,506,cloudy,
2019,Spring,01:00:00 PM,1733,792,941,clear day,
2019,Fall,11:00:00 PM,4,0,4,clear night,
2019,Fall,08:00:00 PM,4,3,1,cloudy,Thanksgiving Day
2019,Summer,04:00:00 AM,6,0,6,cloudy,
2019,Winter,06:00:00 PM,19,11,8,rain,
2019,Fall,07:00:00 AM,313,130,183,clear day,
2019,Spring,04:00:00 AM,1,0,1,clear night,Memorial Day
2019,Spring,11:00:00 PM,7,0,7,partly cloudy night,
2019,Winter,03:00:00 PM,1498,780,718,partly cloudy day,Presidents' Day (regional holiday)
2019,Spring,05:00:00 AM,7,5,2,cloudy,Easter Sunday
2019,Spring,05:00:00 AM,0,0,0,clear night,
2019,Spring,08:00:00 AM,300,187,113,clear day,
2019,Spring,02:00:00 PM,1566,619,947,partly cloudy day,
2019,Summer,05:00:00 PM,2225,831,1394,partly cloudy day,
2019,Fall,02:00:00 PM,1913,860,1053,partly cloudy day,
2019,Fall,05:00:00 PM,771,350,421,cloudy,Halloween
2019,Fall,07:00:00 PM,92,91,1,rain,
2019,Summer,02:00:00 PM,2293,1034,1259,partly cloudy day,
2019,Fall,04:00:00 PM,1647,725,922,partly cloudy day,
2019,Spring,07:00:00 PM,94,46,48,rain,Cinco de Mayo
2019,Fall,05:00:00 AM,0,0,0,partly cloudy night,
2019,Summer,01:00:00 AM,0,0,0,clear night,
2019,Winter,02:00:00 AM,2,0,2,clear night,
2019,Summer,03:00:00 PM,2452,1179,1273,partly cloudy day,
2019,Fall,11:00:00 PM,2,0,2,clear night,
2019,Fall,03:00:00 AM,1,0,1,clear night,Black Friday
2019,Fall,01:00:00 AM,0,0,0,partly cloudy night,
2019,Spring,01:00:00 AM,16,14,2,rain,
2019,Summer,05:00:00 PM,602,220,382,cloudy,
2019,Summer,02:00:00 PM,2229,960,1269,partly cloudy day,
2019,Fall,05:00:00 AM,0,0,0,cloudy,Columbus Day (regional holiday)
2019,Fall,08:00:00 AM,468,264,204,partly cloudy day,
2019,Fall,02:00:00 PM,1736,722,1014,cloudy,
2019,Winter,05:00:00 PM,1340,547,793,clear day,
2019,Spring,10:00:00 PM,19,10,9,clear night,Easter Monday
2019,Winter,09:00:00 AM,415,415,0,clear day,
2019,Fall,02:00:00 AM,1,0,1,clear night,
2019,Winter,05:00:00 AM,0,0,0,clear night,
2019,Winter,02:00:00 AM,0,0,0,clear night,
2019,Summer,08:00:00 PM,772,357,415,partly cloudy day,
2019,Winter,10:00:00 AM,665,372,293,partly cloudy day,
2019,Spring,10:00:00 AM,894,487,407,cloudy,
2019,Spring,04:00:00 AM,0,0,0,cloudy,
2019,Fall,04:00:00 PM,1298,618,680,rain,Labor Day
2019,Summer,03:00:00 AM,0,0,0,partly cloudy night,
2019,Summer,12:00:00 PM,1297,617,680,partly cloudy day,
2019,Spring,11:00:00 PM,34,33,1,cloudy,
2019,Spring,09:00:00 AM,914,512,402,clear day,
2019,Winter,09:00:00 AM,687,366,321,partly cloudy day,
2019,Winter,02:00:00 PM,794,394,400,clear day,
2019,Fall,05:00:00 AM,1,0,1,clear night,
2019,Winter,10:00:00 PM,0,0,0,clear night,
2019,Winter,07:00:00 PM,17,17,0,rain,
2019,Winter,12:00:00 AM,6,4,2,rain,
2019,Fall,06:00:00 PM,202,141,61,rain,
2019,Fall,02:00:00 PM,2675,1194,1481,partly cloudy day,
2019,Summer,03:00:00 AM,3,0,3,clear night,
2019,Spring,04:00:00 AM,0,0,0,partly cloudy night,
2019,Fall,04:00:00 PM,1111,577,534,partly cloudy day,
2019,Summer,12:00:00 PM,1628,869,759,partly cloudy day,
2019,Fall,05:00:00 PM,2866,1285,1581,partly cloudy day,
2019,Fall,01:00:00 PM,1713,668,1045,clear day,
2019,Fall,03:00:00 AM,0,0,0,clear night,
2019,Winter,02:00:00 PM,1250,601,649,partly cloudy day,
2019,Spring,05:00:00 AM,18,12,6,cloudy,
2019,Winter,01:00:00 AM,2,0,2,cloudy,
2019,Summer,02:00:00 PM,1607,715,892,clear day,
2019,Summer,03:00:00 PM,3316,1522,1794,clear day,
2019,Fall,08:00:00 AM,455,259,196,clear day,
2019,Spring,09:00:00 AM,830,450,380,partly cloudy day,
2019,Spring,03:00:00 AM,1,0,1,clear night,
2019,Spring,08:00:00 AM,216,111,105,partly cloudy day,
2019,Fall,04:00:00 PM,2273,905,1368,clear day,Black Friday
2019,Fall,12:00:00 AM,4,3,1,clear night,
2019,Fall,08:00:00 PM,74,63,11,clear night,
2019,Winter,06:00:00 PM,104,90,14,cloudy,
2019,Summer,01:00:00 AM,0,0,0,partly cloudy night,
2019,Winter,06:00:00 AM,57,43,14,clear night,
2019,Fall,01:00:00 PM,2014,821,1193,clear day,
2019,Spring,10:00:00 AM,263,158,105,cloudy,
2019,Winter,10:00:00 AM,507,300,207,partly cloudy day,
2019,Winter,06:00:00 AM,5,3,2,rain,
2019,Summer,03:00:00 PM,2912,1204,1708,partly cloudy day,
2019,Fall,08:00:00 AM,494,170,324,partly cloudy day,
2019,Spring,08:00:00 AM,376,162,214,cloudy,
2019,Winter,07:00:00 AM,132,59,73,clear day,
2019,Spring,05:00:00 PM,2553,1247,1306,clear day,
2019,Spring,04:00:00 PM,906,419,487,cloudy,Daylight Saving Time starts
2019,Winter,04:00:00 AM,0,0,0,cloudy,
2019,Winter,04:00:00 AM,1,0,1,rain,
2019,Summer,12:00:00 PM,2163,1029,1134,partly cloudy day,
2019,Fall,10:00:00 AM,972,443,529,cloudy,
2019,Spring,09:00:00 AM,477,234,243,partly cloudy day,
2019,Fall,01:00:00 PM,2508,1092,1416,partly cloudy day,
2019,Winter,05:00:00 AM,0,0,0,clear night,
2019,Winter,06:00:00 AM,8,5,3,clear night,
2019,Summer,11:00:00 AM,1764,926,838,clear day,
2019,Spring,11:00:00 PM,8,7,1,cloudy,
2019,Summer,02:00:00 AM,0,0,0,partly cloudy night,
2019,Winter,03:00:00 AM,0,0,0,clear night,
2019,Fall,02:00:00 AM,0,0,0,clear night,
2019,Summer,11:00:00 PM,42,30,12,clear night,
2019,Winter,05:00:00 PM,61,56,5,rain,
2019,Spring,10:00:00 PM,9,5,4,cloudy,
2019,Winter,03:00:00 AM,0,0,0,clear night,
2019,Winter,06:00:00 PM,74,61,13,partly cloudy night,
2019,Spring,12:00:00 PM,1372,657,715,partly cloudy day,
2019,Summer,11:00:00 AM,2458,1302,1156,cloudy,
2019,Summer,11:00:00 PM,49,43,6,partly cloudy night,
2019,Spring,01:00:00 PM,1584,677,907,cloudy,
2019,Spring,10:00:00 AM,1929,1059,870,partly cloudy day,
2019,Fall,08:00:00 PM,61,45,16,partly cloudy night,
2019,Fall,05:00:00 AM,1,0,1,partly cloudy night,
2019,Summer,10:00:00 AM,952,576,376,partly cloudy day,
2019,Fall,02:00:00 PM,2490,1071,1419,clear day,
2019,Summer,03:00:00 AM,0,0,0,clear night,
2019,Summer,04:00:00 AM,1,0,1,partly cloudy night,
2019,Winter,05:00:00 PM,0,0,0,cloudy,
2019,Fall,03:00:00 AM,0,0,0,clear night,
2019,Spring,01:00:00 PM,1556,542,1014,cloudy,Easter Monday
2019,Spring,04:00:00 PM,1362,679,683,clear day,
2019,Summer,04:00:00 AM,0,0,0,clear night,
2019,Winter,09:00:00 AM,179,87,92,clear day,
2019,Summer,06:00:00 AM,119,46,73,partly cloudy day,
2019,Winter,12:00:00 AM,3,0,3,cloudy,
2019,Fall,05:00:00 AM,0,0,0,clear night,
2019,Summer,05:00:00 AM,41,21,20,clear night,
2019,Winter,06:00:00 PM,91,54,37,cloudy,
2019,Spring,02:00:00 AM,0,0,0,clear night,
2019,Spring,12:00:00 PM,2863,1369,1494,clear day,
2019,Winter,10:00:00 PM,0,0,0,partly cloudy night,
2019,Summer,12:00:00 PM,1931,943,988,partly cloudy day,
2019,Fall,09:00:00 PM,6,0,6,clear night,
2019,Fall,02:00:00 AM,0,0,0,partly cloudy night,
2019,Summer,12:00:00 AM,6,0,6,rain,
2019,Spring,03:00:00 PM,1838,872,966,clear day,
2019,Spring,12:00:00 AM,3,2,1,,
2019,Spring,12:00:00 AM,0,0,0,partly cloudy night,
2019,Winter,06:00:00 AM,24,11,13,cloudy,
2019,Fall,05:00:00 PM,43,39,4,cloudy,
2019,Summer,12:00:00 AM,5,3,2,clear night,
2019,Spring,06:00:00 PM,1064,578,486,clear day,
2019,Spring,03:00:00 PM,2788,1274,1514,clear day,
2019,Spring,12:00:00 PM,2725,1215,1510,partly cloudy day,
2019,Summer,12:00:00 PM,1500,780,720,rain,
2019,Summer,10:00:00 AM,1284,628,656,clear day,
2019,Winter,11:00:00 PM,14,13,1,partly cloudy night,
2019,Spring,10:00:00 PM,17,5,12,clear night,
2019,Summer,05:00:00 AM,38,27,11,partly cloudy night,
2019,Fall,08:00:00 AM,438,227,211,cloudy,
2019,Spring,09:00:00 PM,39,38,1,clear night,
2019,Summer,07:00:00 AM,131,67,64,rain,
2019,Spring,07:00:00 PM,129,67,62,rain,
2019,Spring,05:00:00 PM,1289,651,638,clear day,
2019,Summer,02:00:00 AM,3,2,1,clear night,
2019,Fall,12:00:00 AM,41,0,41,clear night,
2019,Fall,03:00:00 PM,641,318,323,rain,
2019,Spring,01:00:00 PM,789,368,421,cloudy,
2019,Summer,02:00:00 AM,0,0,0,partly cloudy night,
2019,Spring,06:00:00 PM,1846,1005,841,clear day,
2019,Summer,07:00:00 AM,269,114,155,partly cloudy day,
2019,Spring,05:00:00 PM,2226,1165,1061,partly cloudy day,
2019,Fall,11:00:00 PM,40,0,40,clear night,
2019,Fall,09:00:00 AM,652,365,287,cloudy,
2019,Winter,10:00:00 AM,1131,660,471,clear day,
2019,Summer,10:00:00 AM,1067,623,444,clear day,
2019,Fall,05:00:00 PM,266,182,84,rain,
2019,Fall,06:00:00 PM,132,126,6,rain,
2019,Winter,10:00:00 AM,1518,792,726,clear day,
2019,Spring,05:00:00 PM,2168,1140,1028,partly cloudy day,
2019,Spring,05:00:00 AM,28,23,5,clear night,
2019,Winter,07:00:00 PM,167,68,99,cloudy,
2019,Summer,03:00:00 AM,0,0,0,partly cloudy night,
2019,Winter,08:00:00 AM,282,103,179,clear day,
2019,Spring,07:00:00 AM,366,154,212,clear day,
2019,Fall,03:00:00 AM,0,0,0,cloudy,
2019,Fall,11:00:00 AM,1479,772,707,cloudy,
2019,Summer,02:00:00 AM,0,0,0,clear night,
2019,Winter,12:00:00 AM,2,0,2,rain,
2019,Fall,02:00:00 AM,3,0,3,clear night,
2019,Summer,02:00:00 AM,3,0,3,cloudy,
2019,Summer,10:00:00 PM,21,14,7,partly cloudy night,
2019,Summer,12:00:00 PM,2074,1033,1041,partly cloudy day,
2019,Winter,10:00:00 PM,12,6,6,partly cloudy night,
2019,Fall,01:00:00 AM,0,0,0,cloudy,
2019,Spring,11:00:00 AM,2593,1399,1194,clear day,
2019,Winter,09:00:00 AM,497,233,264,clear day,
2019,Fall,01:00:00 PM,1380,570,810,cloudy,
2019,Winter,11:00:00 PM,4,3,1,cloudy,
2019,Spring,07:00:00 PM,5,0,5,snow,
2019,Winter,08:00:00 AM,381,145,236,partly cloudy day,
2019,Fall,03:00:00 AM,1,0,1,partly cloudy night,
2019,Winter,10:00:00 AM,1436,871,565,clear day,
2019,Fall,06:00:00 AM,76,63,13,clear night,
2019,Fall,11:00:00 PM,23,20,3,partly cloudy night,Labor Day
2019,Fall,12:00:00 PM,1652,734,918,partly cloudy day,
2019,Winter,01:00:00 AM,0,0,0,clear night,
2019,Winter,04:00:00 AM,0,0,0,clear night,
2019,Summer,10:00:00 PM,25,12,13,partly cloudy night,
2019,Spring,07:00:00 AM,266,110,156,partly cloudy day,
2019,Fall,01:00:00 AM,1,0,1,cloudy,
2019,Summer,08:00:00 PM,1397,614,783,partly cloudy day,Independence Day
2019,Spring,02:00:00 AM,1,0,1,cloudy,
2019,Summer,08:00:00 AM,442,162,280,clear day,
2019,Summer,10:00:00 PM,0,0,0,partly cloudy night,
2019,Spring,07:00:00 PM,410,170,240,partly cloudy night,
2019,Spring,01:00:00 PM,2227,1104,1123,cloudy,
2019,Winter,12:00:00 AM,5,3,2,clear night,
2019,Winter,03:00:00 PM,754,433,321,rain,
2019,Spring,12:00:00 PM,1011,405,606,partly cloudy day,
2019,Spring,07:00:00 AM,39,16,23,rain,
2019,Summer,01:00:00 AM,9,3,6,cloudy,Father's Day
2019,Fall,02:00:00 AM,1,0,1,partly cloudy night,
2019,Fall,12:00:00 AM,1,0,1,cloudy,
2019,Fall,12:00:00 AM,2,1,1,cloudy,
2019,Winter,09:00:00 PM,8,0,8,cloudy,
2019,Summer,01:00:00 AM,10,5,5,clear night,
2019,Fall,08:00:00 AM,367,165,202,partly cloudy day,
2019,Summer,08:00:00 AM,397,178,219,clear day,
2019,Winter,07:00:00 AM,121,52,69,clear night,
2019,Winter,09:00:00 PM,35,11,24,cloudy,
2019,Winter,04:00:00 PM,1531,713,818,clear day,
2019,Summer,02:00:00 AM,1,0,1,clear night,
2019,Fall,11:00:00 PM,0,0,0,cloudy,
2019,Spring,10:00:00 PM,99,88,11,clear night,
2019,Winter,05:00:00 PM,292,181,111,partly cloudy night,
2019,Fall,03:00:00 AM,1,0,1,clear night,
2019,Winter,11:00:00 PM,6,5,1,cloudy,
2019,Summer,01:00:00 AM,0,0,0,cloudy,
2019,Winter,10:00:00 PM,62,61,1,clear night,Christmas Day
2019,Fall,02:00:00 PM,911,392,519,clear day,
2019,Fall,01:00:00 AM,4,2,2,partly cloudy night,
2019,Winter,01:00:00 AM,0,0,0,clear night,
2019,Fall,02:00:00 AM,1,0,1,clear night,
2019,Spring,01:00:00 AM,3,0,3,partly cloudy night,
2019,Winter,03:00:00 PM,0,0,0,partly cloudy day,
2019,Winter,04:00:00 PM,2274,1014,1260,partly cloudy day,
2019,Summer,04:00:00 PM,1827,872,955,partly cloudy day,
2019,Summer,09:00:00 PM,48,23,25,clear night,
2019,Fall,01:00:00 PM,2100,855,1245,clear day,
2019,Spring,10:00:00 AM,1893,1071,822,partly cloudy day,
2019,Summer,06:00:00 PM,1262,660,602,partly cloudy day,
2019,Spring,12:00:00 PM,1337,665,672,clear day,
2019,Winter,05:00:00 AM,1,0,1,rain,
2019,Fall,03:00:00 AM,0,0,0,clear night,
2019,Summer,08:00:00 PM,1680,744,936,partly cloudy day,
2019,Spring,03:00:00 PM,1973,930,1043,clear day,
2019,Spring,11:00:00 AM,1324,542,782,clear day,
2019,Summer,12:00:00 AM,5,1,4,clear night,
2019,Fall,10:00:00 PM,10,8,2,clear night,
2019,Summer,11:00:00 PM,23,16,7,clear night,
2019,Spring,07:00:00 PM,2107,1083,1024,clear day,Memorial Day
2019,Fall,09:00:00 AM,673,398,275,cloudy,
2019,Fall,01:00:00 PM,3214,1530,1684,partly cloudy day,
2019,Spring,10:00:00 PM,63,46,17,clear night,
2019,Fall,12:00:00 AM,11,9,2,clear night,
2019,Summer,12:00:00 AM,1,0,1,rain,
2019,Summer,03:00:00 PM,2514,1088,1426,partly cloudy day,
2019,Winter,09:00:00 PM,11,6,5,partly cloudy night,
2019,Summer,05:00:00 PM,1579,820,759,partly cloudy day,
2019,Summer,12:00:00 AM,13,13,0,clear night,
2019,Fall,08:00:00 AM,190,84,106,cloudy,Thanksgiving Day
2019,Fall,02:00:00 AM,1,0,1,partly cloudy night,
2019,Summer,07:00:00 AM,259,96,163,partly cloudy day,
2019,Fall,01:00:00 PM,1838,801,1037,clear day,
2019,Fall,11:00:00 PM,2,0,2,clear night,
2019,Fall,06:00:00 PM,1407,649,758,cloudy,
2019,Fall,12:00:00 PM,1746,807,939,clear day,
2019,Summer,03:00:00 PM,1939,869,1070,partly cloudy day,
2019,Winter,12:00:00 PM,740,387,353,cloudy,
2019,Summer,05:00:00 AM,28,19,9,partly cloudy night,
2019,Winter,05:00:00 PM,200,149,51,cloudy,
2019,Fall,03:00:00 AM,1,0,1,cloudy,
2019,Winter,08:00:00 AM,108,47,61,cloudy,
2019,Spring,03:00:00 PM,2130,917,1213,partly cloudy day,
2019,Winter,05:00:00 AM,1,0,1,rain,
2019,Spring,10:00:00 AM,1239,694,545,clear day,
2019,Summer,09:00:00 PM,192,109,83,clear night,
2019,Fall,08:00:00 AM,373,135,238,clear day,
2019,Winter,05:00:00 PM,556,190,366,partly cloudy night,New Year's Day
2019,Fall,02:00:00 PM,2128,816,1312,clear day,
2019,Summer,07:00:00 AM,269,127,142,partly cloudy day,
2019,Summer,02:00:00 PM,2270,1033,1237,partly cloudy day,
2019,Summer,09:00:00 AM,748,378,370,cloudy,
2019,Winter,06:00:00 AM,16,9,7,cloudy,
2019,Summer,12:00:00 AM,1,0,1,clear night,
2019,Winter,12:00:00 PM,1608,756,852,cloudy,
2019,Fall,12:00:00 PM,2702,1186,1516,partly cloudy day,
2019,Summer,03:00:00 AM,1,0,1,partly cloudy night,
2019,Summer,01:00:00 AM,4,1,3,partly cloudy night,
2019,Fall,04:00:00 AM,0,0,0,cloudy,
2019,Summer,10:00:00 PM,28,22,6,rain,
2019,Fall,02:00:00 PM,1479,686,793,partly cloudy day,
2019,Spring,02:00:00 PM,1495,710,785,cloudy,
2019,Winter,06:00:00 AM,42,21,21,cloudy,
2019,Summer,03:00:00 PM,1052,420,632,rain,
2019,Fall,12:00:00 PM,2700,1166,1534,cloudy,
2019,Fall,01:00:00 PM,1785,800,985,clear day,
2019,Summer,09:00:00 PM,167,47,120,partly cloudy night,
2019,Fall,06:00:00 AM,62,32,30,partly cloudy night,
2019,Spring,04:00:00 AM,0,0,0,clear night,
2019,Winter,05:00:00 AM,2,0,2,clear night,
2019,Spring,12:00:00 PM,1548,662,886,clear day,
2019,Fall,03:00:00 AM,0,0,0,clear night,
2019,Spring,12:00:00 AM,0,0,0,partly cloudy night,
2019,Summer,01:00:00 PM,2916,1314,1602,partly cloudy day,
2019,Summer,12:00:00 AM,6,1,5,cloudy,
2019,Spring,11:00:00 PM,18,16,2,clear night,
2019,Fall,10:00:00 PM,14,6,8,cloudy,
2019,Summer,03:00:00 AM,2,0,2,clear night,
2019,Winter,03:00:00 PM,816,395,421,cloudy,
2019,Winter,01:00:00 PM,366,181,185,clear day,
2019,Summer,06:00:00 AM,171,93,78,partly cloudy night,
2019,Summer,09:00:00 AM,611,333,278,partly cloudy day,
2019,Spring,07:00:00 AM,249,104,145,partly cloudy day,
2019,Spring,02:00:00 PM,219,100,119,rain,Mother's Day
2019,Spring,04:00:00 AM,1,0,1,clear night,
2019,Winter,01:00:00 AM,1,0,1,clear night,
2019,Winter,10:00:00 PM,5,0,5,clear night,
2019,Winter,08:00:00 AM,260,96,164,cloudy,
2019,Spring,08:00:00 AM,354,139,215,partly cloudy day,
2019,Winter,02:00:00 AM,0,0,0,cloudy,Presidents' Day (regional holiday)
2019,Fall,08:00:00 PM,81,65,16,partly cloudy night,
2019,Summer,10:00:00 AM,1373,790,583,cloudy,
2019,Winter,08:00:00 AM,53,16,37,rain,
2019,Summer,11:00:00 PM,20,9,11,clear night,
2019,Fall,06:00:00 PM,77,73,4,clear night,
2019,Fall,02:00:00 AM,0,0,0,clear night,
2019,Summer,10:00:00 AM,1022,624,398,partly cloudy day,
2019,Fall,11:00:00 AM,373,184,189,rain,
2019,Summer,08:00:00 AM,419,173,246,partly cloudy day,
2019,Summer,09:00:00 AM,287,154,133,rain,
2019,Summer,04:00:00 PM,3220,1277,1943,partly cloudy day,
2019,Fall,04:00:00 AM,0,0,0,cloudy,
2019,Fall,10:00:00 AM,2057,1122,935,clear day,
2019,Spring,12:00:00 PM,1751,832,919,clear day,
2019,Winter,04:00:00 AM,2,2,0,clear night,Christmas Day
2019,Fall,06:00:00 PM,1863,1023,840,clear day,
2019,Winter,03:00:00 AM,0,0,0,clear night,
2019,Fall,10:00:00 PM,37,36,1,clear night,
2019,Winter,10:00:00 AM,49,15,34,rain,
2019,Summer,04:00:00 PM,2128,978,1150,partly cloudy day,Father's Day
2019,Winter,04:00:00 PM,737,369,368,cloudy,
2019,Fall,08:00:00 AM,367,183,184,clear day,
2019,Winter,03:00:00 PM,1452,698,754,partly cloudy day,
2019,Spring,03:00:00 AM,0,0,0,clear night,
2019,Summer,06:00:00 AM,153,66,87,partly cloudy day,
2019,Spring,07:00:00 PM,230,147,83,rain,
2019,Summer,09:00:00 PM,36,14,22,partly cloudy night,
2019,Winter,08:00:00 AM,175,58,117,cloudy,
2019,Spring,07:00:00 PM,863,441,422,partly cloudy day,
2019,Summer,06:00:00 AM,149,61,88,clear day,
2019,Spring,09:00:00 AM,490,279,211,clear day,
2019,Summer,08:00:00 AM,480,267,213,partly cloudy day,
2019,Fall,03:00:00 PM,1073,527,546,cloudy,Halloween
2019,Fall,09:00:00 AM,328,162,166,cloudy,
2019,Fall,05:00:00 AM,0,0,0,clear night,
2019,Summer,09:00:00 PM,191,68,123,partly cloudy night,
2019,Summer,08:00:00 PM,1401,662,739,clear day,
2019,Fall,05:00:00 AM,0,0,0,partly cloudy night,
2019,Fall,11:00:00 PM,3,2,1,clear night,Black Friday
2019,Spring,10:00:00 PM,7,2,5,clear night,
2019,Fall,05:00:00 PM,43,39,4,cloudy,
2019,Spring,03:00:00 PM,2620,1172,1448,clear day,
2019,Winter,03:00:00 PM,1026,441,585,cloudy,
2019,Fall,12:00:00 PM,1978,852,1126,clear day,
2019,Spring,06:00:00 PM,2944,1107,1837,partly cloudy day,
2019,Winter,11:00:00 PM,4,3,1,clear night,
2019,Winter,10:00:00 PM,8,0,8,cloudy,
2019,Spring,07:00:00 AM,188,101,87,partly cloudy day,
2019,Fall,01:00:00 PM,2820,1287,1533,partly cloudy day,
2019,Summer,12:00:00 AM,6,2,4,clear night,
2019,Winter,11:00:00 PM,8,6,2,cloudy,
2019,Spring,08:00:00 PM,21,0,21,cloudy,
2019,Winter,06:00:00 PM,211,155,56,partly cloudy night,
2019,Winter,02:00:00 AM,0,0,0,rain,
2019,Summer,12:00:00 PM,2637,1368,1269,clear day,
2019,Spring,06:00:00 PM,1953,1061,892,partly cloudy day,
2019,Spring,08:00:00 AM,255,99,156,clear day,
2019,Fall,04:00:00 AM,0,0,0,clear night,
2019,Summer,01:00:00 PM,585,325,260,cloudy,
2019,Spring,03:00:00 AM,0,0,0,cloudy,
2019,Spring,10:00:00 AM,1380,713,667,cloudy,
2019,Fall,06:00:00 AM,90,57,33,clear night,
2019,Fall,06:00:00 AM,31,20,11,partly cloudy night,Columbus Day (regional holiday)
2019,Summer,02:00:00 AM,0,0,0,cloudy,
2019,Spring,05:00:00 PM,1665,878,787,clear day,
2019,Spring,12:00:00 AM,3,0,3,partly cloudy night,Memorial Day
2019,Winter,12:00:00 PM,372,190,182,clear day,
2019,Fall,11:00:00 PM,1,0,1,cloudy,
2019,Spring,12:00:00 PM,1437,656,781,clear day,
2019,Winter,10:00:00 PM,26,11,15,partly cloudy night,New Year's Day
2019,Fall,05:00:00 PM,405,227,178,rain,
2019,Summer,11:00:00 AM,1580,803,777,partly cloudy day,
2019,Spring,07:00:00 AM,138,60,78,clear day,
2019,Spring,08:00:00 AM,226,117,109,partly cloudy day,
2019,Summer,04:00:00 PM,2682,1258,1424,partly cloudy day,
2019,Summer,06:00:00 AM,104,41,63,cloudy,
2019,Winter,09:00:00 PM,11,7,4,cloudy,
2019,Summer,09:00:00 PM,63,18,45,cloudy,
2019,Spring,03:00:00 PM,2418,1073,1345,partly cloudy day,
2019,Winter,08:00:00 PM,82,38,44,cloudy,
2019,Fall,08:00:00 AM,273,144,129,clear day,
2019,Fall,05:00:00 PM,2381,1141,1240,clear day,Columbus Day (regional holiday)
2019,Fall,06:00:00 AM,101,65,36,clear night,
2019,Summer,07:00:00 PM,2183,1020,1163,partly cloudy day,
2019,Summer,07:00:00 PM,1180,610,570,partly cloudy day,
2019,Spring,07:00:00 AM,235,118,117,clear day,
2019,Fall,12:00:00 PM,1308,563,745,cloudy,
2019,Spring,12:00:00 AM,3,1,2,partly cloudy night,
2019,Fall,01:00:00 PM,1648,708,940,cloudy,
2019,Spring,05:00:00 AM,14,11,3,partly cloudy night,
2019,Fall,12:00:00 AM,10,0,10,clear night,
2019,Winter,03:00:00 AM,0,0,0,partly cloudy night,
2019,Spring,03:00:00 PM,3064,1375,1689,partly cloudy day,Memorial Day
2019,Winter,09:00:00 PM,27,23,4,clear night,
2019,Winter,08:00:00 PM,35,33,2,cloudy,
2019,Spring,05:00:00 AM,9,6,3,clear night,
2019,Summer,01:00:00 AM,1,0,1,clear night,
2019,Fall,12:00:00 PM,2977,1405,1572,partly cloudy day,
2019,Fall,07:00:00 AM,168,71,97,cloudy,
2019,Spring,09:00:00 AM,1154,660,494,clear day,
2019,Spring,05:00:00 PM,3639,1400,2239,partly cloudy day,Easter Sunday
2019,Summer,07:00:00 AM,255,102,153,clear day,
2019,Fall,09:00:00 AM,629,363,266,cloudy,
2019,Spring,05:00:00 PM,1756,784,972,clear day,
2019,Winter,03:00:00 AM,0,0,0,rain,
2019,Winter,09:00:00 PM,14,13,1,cloudy,
2019,Spring,04:00:00 AM,0,0,0,clear night,
2019,Winter,11:00:00 AM,1642,813,829,clear day,Christmas Eve
2019,Winter,04:00:00 AM,0,0,0,clear night,
2019,Spring,05:00:00 AM,4,2,2,rain,Cinco de Mayo
2019,Summer,03:00:00 AM,1,0,1,clear night,
2019,Summer,01:00:00 PM,1197,541,656,partly cloudy day,
2019,Fall,10:00:00 PM,17,17,0,clear night,
2019,Spring,12:00:00 PM,2454,1246,1208,clear day,
2019,Fall,05:00:00 PM,342,202,140,rain,
2019,Fall,06:00:00 AM,29,17,12,clear night,
2019,Summer,09:00:00 AM,725,462,263,partly cloudy day,
2019,Spring,04:00:00 PM,3594,1665,1929,partly cloudy day,
2019,Spring,05:00:00 PM,2145,829,1316,cloudy,
2019,Spring,05:00:00 PM,1609,855,754,clear day,
2019,Spring,02:00:00 PM,1764,766,998,cloudy,
2019,Winter,10:00:00 PM,0,0,0,cloudy,
2019,Winter,02:00:00 AM,0,0,0,clear night,
2019,Fall,07:00:00 PM,809,452,357,partly cloudy day,
2019,Fall,11:00:00 PM,1,0,1,cloudy,
2019,Fall,05:00:00 AM,1,0,1,partly cloudy night,
2019,Winter,10:00:00 PM,6,6,0,rain,
2019,Spring,12:00:00 AM,9,0,9,clear night,
2019,Fall,10:00:00 PM,1,0,1,partly cloudy night,
2019,Fall,11:00:00 PM,0,0,0,clear night,
2019,Spring,08:00:00 PM,4,0,4,cloudy,Daylight Saving Time starts
2019,Summer,04:00:00 PM,1499,736,763,partly cloudy day,
2019,Spring,09:00:00 AM,588,275,313,partly cloudy day,
2019,Summer,02:00:00 PM,1897,968,929,partly cloudy day,
2019,Spring,09:00:00 AM,247,111,136,rain,
2019,Fall,12:00:00 PM,1687,797,890,partly cloudy day,
2019,Summer,09:00:00 AM,984,620,364,partly cloudy day,
2019,Summer,06:00:00 AM,214,107,107,partly cloudy day,
2019,Spring,07:00:00 PM,1234,658,576,partly cloudy day,
2019,Summer,09:00:00 PM,138,84,54,clear night,
2019,Fall,03:00:00 PM,132,47,85,rain,
2019,Summer,11:00:00 AM,922,575,347,rain,
2019,Spring,02:00:00 AM,1,0,1,partly cloudy night,
2019,Spring,10:00:00 AM,1801,971,830,partly cloudy day,Easter Monday
2019,Spring,12:00:00 AM,2,1,1,cloudy,
2019,Spring,06:00:00 PM,1185,609,576,partly cloudy day,Tax Day
2019,Spring,12:00:00 AM,12,10,2,partly cloudy night,
2019,Winter,08:00:00 PM,30,28,2,cloudy,
2019,Spring,08:00:00 AM,452,189,263,clear day,
2019,Summer,01:00:00 AM,2,1,1,clear night,
2019,Summer,06:00:00 PM,1890,996,894,partly cloudy day,
2019,Fall,10:00:00 AM,969,524,445,cloudy,
2019,Winter,01:00:00 PM,908,478,430,cloudy,
2019,Winter,11:00:00 AM,1353,570,783,partly cloudy day,
2019,Winter,11:00:00 PM,0,0,0,clear night,
2019,Winter,07:00:00 PM,8,7,1,partly cloudy night,
2019,Summer,11:00:00 PM,21,15,6,clear night,
2019,Fall,01:00:00 PM,1753,704,1049,clear day,
2019,Winter,11:00:00 AM,876,481,395,clear day,
2019,Winter,10:00:00 AM,672,386,286,clear day,
2019,Winter,01:00:00 AM,0,0,0,cloudy,
2019,Summer,08:00:00 PM,290,127,163,partly cloudy night,
2019,Winter,03:00:00 PM,398,157,241,cloudy,
2019,Summer,12:00:00 AM,4,1,3,partly cloudy night,
2019,Summer,05:00:00 AM,55,33,22,clear night,
2019,Winter,10:00:00 AM,808,426,382,cloudy,
2019,Winter,08:00:00 AM,507,286,221,cloudy,
2019,Summer,01:00:00 AM,6,4,2,cloudy,
2019,Fall,09:00:00 AM,882,510,372,clear day,
2019,Winter,03:00:00 AM,0,0,0,partly cloudy night,
2019,Winter,03:00:00 AM,6,1,5,cloudy,
2019,Summer,12:00:00 PM,1809,816,993,partly cloudy day,
2019,Summer,09:00:00 PM,195,189,6,rain,
2019,Summer,10:00:00 AM,1107,575,532,clear day,
2019,Summer,11:00:00 AM,1689,761,928,partly cloudy day,
2019,Spring,11:00:00 PM,4,4,0,clear night,
2019,Fall,11:00:00 PM,1,0,1,cloudy,
2019,Fall,08:00:00 PM,25,14,11,partly cloudy night,
2019,Spring,10:00:00 PM,56,48,8,clear night,
2019,Spring,03:00:00 PM,809,383,426,rain,Cinco de Mayo
2019,Winter,10:00:00 PM,0,0,0,clear night,
2019,Fall,08:00:00 AM,618,338,280,clear day,
2019,Winter,11:00:00 AM,1031,524,507,clear day,
2019,Winter,11:00:00 AM,1735,866,869,partly cloudy day,
2019,Winter,03:00:00 AM,0,0,0,rain,
2019,Summer,09:00:00 AM,740,447,293,partly cloudy day,
2019,Spring,02:00:00 AM,3,2,1,partly cloudy night,
2019,Winter,10:00:00 PM,9,8,1,clear night,
2019,Fall,08:00:00 AM,425,226,199,clear day,
2019,Winter,06:00:00 AM,40,33,7,clear night,
2019,Fall,10:00:00 AM,1376,833,543,clear day,
2019,Spring,07:00:00 PM,601,187,414,partly cloudy night,
2019,Spring,09:00:00 PM,3,2,1,clear night,
2019,Winter,03:00:00 AM,1,0,1,cloudy,New Year's Eve
2019,Spring,02:00:00 PM,2352,958,1394,partly cloudy day,
2019,Spring,10:00:00 PM,36,35,1,clear night,
2019,Summer,08:00:00 AM,372,224,148,clear day,
2019,Winter,12:00:00 PM,1858,834,1024,clear day,Christmas Eve
2019,Fall,04:00:00 AM,1,0,1,partly cloudy night,
2019,Fall,06:00:00 PM,4,3,1,clear night,Thanksgiving Day
2019,Spring,04:00:00 AM,0,0,0,partly cloudy night,
2019,Spring,04:00:00 AM,1,0,1,partly cloudy night,
2019,Winter,03:00:00 AM,0,0,0,partly cloudy night,
2019,Summer,01:00:00 PM,1978,896,1082,partly cloudy day,
2019,Summer,03:00:00 PM,2395,1088,1307,partly cloudy day,
2019,Summer,10:00:00 PM,11,5,6,clear night,
2019,Fall,06:00:00 AM,23,10,13,rain,
2019,Fall,11:00:00 PM,4,3,1,clear night,
2019,Fall,07:00:00 PM,1108,490,618,partly cloudy day,
2019,Summer,07:00:00 AM,202,94,108,rain,
2019,Spring,09:00:00 PM,3,2,1,clear night,
2019,Fall,07:00:00 AM,219,106,113,clear day,
2019,Summer,06:00:00 AM,168,77,91,partly cloudy day,
2019,Summer,07:00:00 AM,316,155,161,clear day,
2019,Fall,10:00:00 AM,721,428,293,cloudy,
2019,Spring,08:00:00 AM,266,97,169,clear day,
2019,Spring,08:00:00 PM,829,347,482,clear day,
2019,Summer,04:00:00 AM,0,0,0,rain,
2019,Summer,04:00:00 AM,0,0,0,partly cloudy night,
2019,Spring,09:00:00 AM,763,438,325,cloudy,
2019,Fall,03:00:00 AM,0,0,0,clear night,
2019,Summer,04:00:00 PM,1082,588,494,cloudy,
2019,Summer,06:00:00 AM,100,49,51,cloudy,
2019,Summer,05:00:00 PM,1447,736,711,cloudy,
2019,Summer,03:00:00 PM,2208,1085,1123,clear day,
2019,Winter,08:00:00 PM,20,14,6,clear night,
2019,Summer,07:00:00 AM,217,104,113,cloudy,
2019,Winter,05:00:00 PM,0,0,0,partly cloudy night,
2019,Fall,06:00:00 AM,51,27,24,cloudy,
2019,Summer,02:00:00 AM,0,0,0,clear night,
2019,Winter,12:00:00 PM,1074,513,561,partly cloudy day,
2019,Spring,07:00:00 AM,309,122,187,clear day,
2019,Winter,08:00:00 AM,308,132,176,clear day,
2019,Winter,02:00:00 AM,0,0,0,rain,
2019,Summer,06:00:00 AM,178,67,111,clear day,
2019,Winter,05:00:00 PM,413,221,192,cloudy,
2019,Spring,12:00:00 AM,10,3,7,snow,
2019,Spring,07:00:00 PM,948,470,478,cloudy,
2019,Fall,02:00:00 PM,766,429,337,rain,
2019,Winter,07:00:00 PM,42,40,2,clear night,
2019,Fall,09:00:00 AM,612,330,282,cloudy,
2019,Spring,10:00:00 PM,14,12,2,clear night,
2019,Fall,01:00:00 PM,1251,527,724,clear day,
2019,Summer,05:00:00 PM,2274,1124,1150,partly cloudy day,
2019,Winter,03:00:00 AM,2,1,1,clear night,
2019,Fall,06:00:00 AM,37,25,12,clear night,
2019,Spring,11:00:00 PM,11,6,5,cloudy,
2019,Spring,07:00:00 AM,180,86,94,cloudy,
2019,Winter,05:00:00 AM,9,3,6,cloudy,
2019,Spring,09:00:00 PM,15,10,5,rain,
2019,Summer,03:00:00 PM,1216,540,676,partly cloudy day,
2019,Winter,05:00:00 PM,724,318,406,partly cloudy day,
2019,Winter,11:00:00 PM,25,23,2,cloudy,
2019,Spring,12:00:00 PM,1041,508,533,cloudy,
2019,Winter,04:00:00 AM,0,0,0,clear night,
2019,Spring,07:00:00 AM,302,124,178,clear day,
2019,Winter,08:00:00 AM,252,150,102,clear day,Christmas Day
2019,Fall,06:00:00 PM,36,31,5,clear night,
2019,Spring,01:00:00 AM,0,0,0,clear night,
2019,Summer,03:00:00 AM,1,0,1,partly cloudy night,
2019,Summer,02:00:00 PM,1937,946,991,partly cloudy day,
2019,Summer,01:00:00 AM,2,1,1,clear night,
2019,Winter,11:00:00 PM,5,4,1,partly cloudy night,
2019,Fall,01:00:00 PM,696,334,362,cloudy,
2019,Winter,07:00:00 AM,106,46,60,clear night,
2019,Winter,11:00:00 AM,1724,890,834,clear day,
2019,Fall,06:00:00 PM,814,413,401,partly cloudy night,
2019,Summer,04:00:00 AM,1,1,0,clear night,
2019,Winter,01:00:00 PM,1624,636,988,cloudy,
2019,Spring,03:00:00 PM,1713,962,751,partly cloudy day,
2019,Summer,01:00:00 AM,1,0,1,partly cloudy night,
2019,Summer,09:00:00 PM,88,33,55,partly cloudy night,
2019,Winter,12:00:00 PM,2831,1412,1419,partly cloudy day,New Year's Day
2019,Summer,02:00:00 AM,0,0,0,clear night,
2019,Spring,09:00:00 AM,470,228,242,clear day,
2019,Spring,10:00:00 AM,1252,661,591,partly cloudy day,
2019,Spring,11:00:00 PM,10,1,9,partly cloudy night,
2019,Summer,11:00:00 PM,8,1,7,clear night,
2019,Summer,03:00:00 AM,0,0,0,partly cloudy night,
2019,Winter,01:00:00 PM,2131,1004,1127,clear day,
2019,Summer,10:00:00 PM,16,8,8,clear night,
2019,Spring,01:00:00 PM,2004,935,1069,clear day,
2019,Winter,01:00:00 PM,1728,788,940,cloudy,
2019,Fall,08:00:00 AM,389,152,237,clear day,
2019,Summer,10:00:00 AM,1708,1015,693,partly cloudy day,
2019,Winter,06:00:00 PM,60,0,60,partly cloudy night,
2019,Summer,05:00:00 AM,169,148,21,clear night,
2019,Winter,12:00:00 AM,13,12,1,clear night,
2019,Spring,10:00:00 PM,22,17,5,partly cloudy night,
2019,Summer,05:00:00 PM,1893,1068,825,partly cloudy day,
2019,Summer,07:00:00 AM,257,106,151,partly cloudy day,
2019,Winter,10:00:00 PM,75,62,13,partly cloudy night,
2019,Winter,06:00:00 AM,21,15,6,cloudy,
2019,Summer,11:00:00 PM,43,33,10,clear night,
2019,Spring,12:00:00 PM,1630,721,909,clear day,
2019,Fall,01:00:00 AM,1,0,1,clear night,
2019,Summer,04:00:00 AM,6,5,1,clear night,
2019,Winter,08:00:00 PM,35,25,10,partly cloudy night,
2019,Fall,03:00:00 PM,344,182,162,rain,
2019,Summer,11:00:00 PM,10,5,5,clear night,
2019,Spring,01:00:00 PM,1421,595,826,clear day,
2019,Summer,10:00:00 AM,1303,736,567,clear day,
2019,Fall,01:00:00 AM,3,1,2,rain,
2019,Summer,04:00:00 PM,833,420,413,cloudy,
2019,Spring,10:00:00 PM,13,8,5,partly cloudy night,
2019,Fall,07:00:00 PM,311,163,148,partly cloudy night,
2019,Spring,03:00:00 AM,0,0,0,clear night,
2019,Winter,01:00:00 AM,0,0,0,clear night,
2019,Summer,06:00:00 AM,179,85,94,partly cloudy day,
2019,Summer,11:00:00 AM,1945,997,948,clear day,
2019,Winter,04:00:00 AM,0,0,0,clear night,
2019,Spring,01:00:00 PM,3131,1583,1548,clear day,
2019,Spring,03:00:00 AM,1,1,0,cloudy,
2019,Fall,01:00:00 AM,0,0,0,cloudy,
2019,Winter,03:00:00 AM,0,0,0,clear night,
2019,Summer,11:00:00 PM,31,5,26,cloudy,
2019,Summer,08:00:00 PM,1235,596,639,partly cloudy day,
2019,Fall,09:00:00 PM,93,81,12,clear night,
2019,Spring,11:00:00 AM,1299,600,699,cloudy,
2019,Summer,07:00:00 PM,2198,1132,1066,partly cloudy day,
2019,Summer,06:00:00 AM,151,75,76,partly cloudy day,
2019,Fall,10:00:00 PM,47,44,3,cloudy,Halloween
2019,Winter,11:00:00 PM,5,4,1,clear night,
2019,Spring,04:00:00 AM,0,0,0,clear night,
2019,Winter,03:00:00 PM,2162,952,1210,cloudy,
2019,Winter,03:00:00 AM,0,0,0,cloudy,
2019,Summer,01:00:00 PM,766,306,460,partly cloudy day,
2019,Winter,07:00:00 AM,161,81,80,clear night,
2019,Spring,05:00:00 AM,35,22,13,clear night,
2019,Summer,01:00:00 PM,2551,1162,1389,partly cloudy day,
2019,Fall,07:00:00 PM,27,23,4,clear night,
2019,Winter,05:00:00 AM,0,0,0,clear night,
2019,Winter,06:00:00 PM,136,112,24,rain,
2019,Winter,04:00:00 PM,971,393,578,cloudy,
2019,Summer,10:00:00 PM,44,14,30,partly cloudy night,
2019,Fall,02:00:00 PM,2019,994,1025,clear day,Black Friday
2019,Summer,08:00:00 AM,77,32,45,rain,
2019,Fall,01:00:00 AM,0,0,0,cloudy,
2019,Winter,11:00:00 AM,1188,626,562,partly cloudy day,
2019,Fall,04:00:00 AM,1,0,1,partly cloudy night,
2019,Fall,09:00:00 PM,48,45,3,partly cloudy night,Veterans Day
2019,Winter,12:00:00 PM,2266,1173,1093,partly cloudy day,
2019,Winter,07:00:00 PM,0,0,0,partly cloudy night,
2019,Fall,08:00:00 AM,236,123,113,cloudy,
2019,Fall,04:00:00 AM,0,0,0,partly cloudy night,
2019,Summer,03:00:00 AM,0,0,0,partly cloudy night,
2019,Summer,03:00:00 AM,1,0,1,clear night,
2019,Fall,03:00:00 AM,1,0,1,partly cloudy night,Labor Day
2019,Summer,11:00:00 PM,3,0,3,clear night,
2019,Winter,04:00:00 PM,377,182,195,rain,
2019,Summer,07:00:00 PM,981,583,398,partly cloudy day,
2019,Fall,02:00:00 PM,647,334,313,cloudy,
2019,Winter,12:00:00 AM,0,0,0,clear night,
2019,Winter,09:00:00 PM,17,16,1,clear night,Christmas Eve
2019,Spring,06:00:00 PM,2114,955,1159,partly cloudy day,
2019,Spring,02:00:00 AM,2,0,2,clear night,
2019,Summer,09:00:00 PM,194,84,110,clear night,
2019,Summer,07:00:00 PM,1834,872,962,clear day,
2019,Spring,04:00:00 PM,959,442,517,cloudy,
2019,Winter,12:00:00 AM,3,0,3,clear night,
2019,Summer,03:00:00 AM,1,0,1,clear night,
2019,Summer,02:00:00 AM,1,0,1,partly cloudy night,
2019,Winter,05:00:00 PM,137,87,50,cloudy,
2019,Summer,12:00:00 PM,1522,695,827,clear day,
2019,Summer,03:00:00 PM,2394,1029,1365,partly cloudy day,
2019,Spring,05:00:00 PM,1344,689,655,partly cloudy day,
2019,Summer,06:00:00 PM,1250,664,586,partly cloudy day,
2019,Winter,06:00:00 PM,30,8,22,clear night,Martin Luther King Jr. Day
2019,Spring,03:00:00 AM,1,0,1,cloudy,Daylight Saving Time starts
2019,Fall,02:00:00 AM,0,0,0,clear night,
2019,Summer,04:00:00 PM,2104,998,1106,partly cloudy day,
2019,Spring,07:00:00 AM,225,93,132,cloudy,
2019,Fall,07:00:00 AM,275,158,117,clear night,
2019,Spring,02:00:00 AM,2,0,2,cloudy,
2019,Summer,10:00:00 PM,23,9,14,clear night,
2019,Spring,05:00:00 AM,0,0,0,cloudy,
2019,Fall,02:00:00 AM,1,0,1,partly cloudy night,
2019,Winter,06:00:00 AM,11,10,1,partly cloudy night,
2019,Fall,07:00:00 AM,190,92,98,clear night,
2019,Summer,09:00:00 PM,122,46,76,partly cloudy night,Independence Day
2019,Fall,07:00:00 PM,878,443,435,clear day,
2019,Winter,07:00:00 AM,154,83,71,partly cloudy night,
2019,Winter,02:00:00 AM,0,0,0,cloudy,Valentine's Day
2019,Winter,03:00:00 AM,1,0,1,clear night,
2019,Fall,02:00:00 PM,2188,970,1218,clear day,
2019,Fall,05:00:00 AM,0,0,0,clear night,
2019,Spring,04:00:00 AM,0,0,0,rain,
2019,Spring,06:00:00 PM,175,52,123,cloudy,
2019,Summer,01:00:00 PM,1629,727,902,partly cloudy day,
2019,Summer,10:00:00 PM,20,8,12,partly cloudy night,
2019,Winter,08:00:00 AM,425,235,190,cloudy,New Year's Eve
2019,Winter,07:00:00 PM,40,0,40,clear night,
2019,Winter,03:00:00 PM,1759,849,910,partly cloudy day,
2019,Spring,05:00:00 AM,0,0,0,cloudy,
2019,Winter,07:00:00 PM,16,13,3,clear night,
2019,Summer,12:00:00 PM,2424,1203,1221,partly cloudy day,
2019,Fall,06:00:00 AM,45,36,9,partly cloudy night,Thanksgiving Day
2019,Winter,12:00:00 PM,875,425,450,partly cloudy day,
2019,Fall,01:00:00 AM,0,0,0,clear night,
2019,Summer,12:00:00 PM,1127,519,608,cloudy,
2019,Fall,02:00:00 PM,2130,974,1156,clear day,
2019,Spring,03:00:00 AM,2,2,0,cloudy,
2019,Winter,01:00:00 AM,4,2,2,cloudy,
2019,Spring,06:00:00 PM,1048,491,557,cloudy,
2019,Spring,11:00:00 PM,12,8,4,cloudy,
2019,Fall,03:00:00 AM,0,0,0,clear night,
2019,Summer,06:00:00 AM,165,69,96,partly cloudy night,
2019,Spring,05:00:00 PM,1220,597,623,cloudy,
2019,Summer,11:00:00 PM,12,6,6,clear night,
2019,Spring,04:00:00 AM,0,0,0,clear night,
2019,Summer,03:00:00 PM,2052,893,1159,partly cloudy day,
2019,Winter,03:00:00 PM,174,112,62,cloudy,
2019,Fall,11:00:00 PM,15,0,15,partly cloudy night,
2019,Summer,10:00:00 AM,1992,1218,774,clear day,
2019,Spring,07:00:00 AM,243,144,99,partly cloudy day,
2019,Winter,10:00:00 AM,220,137,83,rain,
2019,Fall,02:00:00 PM,2704,1207,1497,partly cloudy day,
2019,Winter,06:00:00 PM,10,0,10,cloudy,
2019,Spring,03:00:00 PM,1623,745,878,clear day,
2019,Fall,02:00:00 AM,0,0,0,clear night,Daylight Saving Time ends
2019,Winter,12:00:00 PM,1238,613,625,cloudy,
2019,Summer,04:00:00 AM,1,0,1,clear night,
2019,Winter,11:00:00 PM,3,0,3,clear night,
2019,Summer,04:00:00 AM,0,0,0,cloudy,
2019,Spring,06:00:00 PM,2556,1327,1229,clear day,
2019,Fall,02:00:00 PM,1961,867,1094,clear day,
2019,Summer,03:00:00 PM,2203,999,1204,partly cloudy day,
2019,Summer,01:00:00 AM,1,0,1,partly cloudy night,
2019,Fall,12:00:00 AM,18,0,18,cloudy,
2019,Fall,05:00:00 PM,2385,1208,1177,partly cloudy day,
2019,Summer,04:00:00 PM,2712,1175,1537,clear day,
2019,Spring,06:00:00 AM,87,50,37,clear night,
2019,Summer,07:00:00 PM,1732,853,879,partly cloudy day,
2019,Fall,12:00:00 PM,2339,923,1416,partly cloudy day,
2019,Fall,02:00:00 PM,1227,523,704,cloudy,
2019,Spring,01:00:00 PM,1533,702,831,partly cloudy day,
2019,Winter,10:00:00 AM,658,395,263,cloudy,
2019,Winter,08:00:00 PM,24,0,24,partly cloudy night,
2019,Spring,07:00:00 PM,1618,856,762,partly cloudy day,
2019,Fall,11:00:00 PM,1,0,1,partly cloudy night,Veterans Day
2019,Spring,03:00:00 AM,0,0,0,cloudy,
2019,Spring,09:00:00 AM,752,519,233,cloudy,
2019,Winter,03:00:00 AM,0,0,0,rain,
2019,Summer,06:00:00 AM,205,66,139,partly cloudy day,
2019,Spring,01:00:00 AM,0,0,0,partly cloudy night,
2019,Fall,01:00:00 AM,4,3,1,clear night,
2019,Winter,12:00:00 AM,29,0,29,clear night,
2019,Winter,07:00:00 AM,108,52,56,cloudy,
2019,Spring,01:00:00 PM,2549,1127,1422,partly cloudy day,
2019,Summer,08:00:00 AM,404,233,171,clear day,
2019,Summer,05:00:00 PM,2596,1202,1394,partly cloudy day,
2019,Fall,03:00:00 AM,0,0,0,partly cloudy night,
2019,Winter,12:00:00 PM,1505,709,796,clear day,
2019,Winter,01:00:00 PM,889,434,455,cloudy,
2019,Summer,11:00:00 PM,3,0,3,partly cloudy night,
2019,Winter,03:00:00 PM,3650,1896,1754,cloudy,
2019,Fall,10:00:00 PM,108,107,1,clear night,
2019,Spring,01:00:00 AM,6,5,1,cloudy,
2019,Fall,06:00:00 PM,34,31,3,clear night,
2019,Spring,08:00:00 AM,95,40,55,rain,
2019,Summer,01:00:00 AM,1,0,1,clear night,
2019,Fall,08:00:00 AM,457,179,278,partly cloudy day,
2019,Winter,10:00:00 AM,1039,549,490,partly cloudy day,
2019,Winter,03:00:00 AM,0,0,0,clear night,
2019,Winter,08:00:00 AM,152,50,102,clear day,
2019,Summer,10:00:00 PM,33,14,19,partly cloudy night,
2019,Fall,06:00:00 AM,10,7,3,cloudy,
2019,Fall,09:00:00 PM,21,11,10,cloudy,
2019,Fall,10:00:00 PM,56,50,6,clear night,
2019,Fall,09:00:00 PM,38,27,11,clear night,
2019,Spring,04:00:00 PM,3140,1327,1813,clear day,
2019,Summer,12:00:00 AM,1,0,1,clear night,
2019,Fall,06:00:00 PM,77,0,77,clear night,
2019,Fall,01:00:00 PM,156,86,70,rain,
2019,Spring,07:00:00 PM,697,337,360,cloudy,
2019,Spring,12:00:00 AM,5,0,5,partly cloudy night,
2019,Spring,02:00:00 AM,4,1,3,partly cloudy night,
2019,Winter,11:00:00 AM,1128,605,523,clear day,
2019,Fall,12:00:00 PM,1387,597,790,clear day,
2019,Winter,05:00:00 PM,63,60,3,clear night,
2019,Spring,02:00:00 PM,3430,1636,1794,clear day,
2019,Fall,05:00:00 PM,43,41,2,clear night,
2019,Winter,10:00:00 AM,837,440,397,cloudy,
2019,Spring,04:00:00 PM,1737,728,1009,cloudy,
2019,Spring,06:00:00 AM,7,2,5,sleet,Daylight Saving Time starts
2019,Summer,03:00:00 PM,1800,805,995,cloudy,
2019,Spring,07:00:00 PM,1238,710,528,partly cloudy day,
2019,Fall,07:00:00 PM,65,63,2,clear night,
2019,Fall,01:00:00 AM,0,0,0,clear night,
2019,Fall,01:00:00 PM,1476,500,976,cloudy,
2019,Summer,08:00:00 AM,403,169,234,partly cloudy day,
2019,Summer,09:00:00 PM,152,69,83,partly cloudy night,
2019,Winter,12:00:00 AM,0,0,0,rain,
2019,Fall,04:00:00 PM,640,326,314,cloudy,
2019,Spring,05:00:00 AM,5,1,4,partly cloudy night,
2019,Spring,12:00:00 PM,892,424,468,rain,
2019,Summer,11:00:00 PM,11,3,8,partly cloudy night,
2019,Summer,10:00:00 AM,943,564,379,partly cloudy day,
2019,Spring,06:00:00 AM,111,57,54,cloudy,
2019,Fall,05:00:00 PM,64,54,10,cloudy,
2019,Spring,03:00:00 PM,2746,1153,1593,clear day,
2019,Winter,11:00:00 PM,0,0,0,clear night,
2019,Summer,05:00:00 PM,9,5,4,clear day,Independence Day
2019,Winter,12:00:00 PM,980,454,526,clear day,
2019,Winter,02:00:00 PM,797,329,468,clear day,
2019,Winter,08:00:00 PM,65,65,0,clear night,
2019,Fall,04:00:00 PM,2568,1112,1456,partly cloudy day,
2019,Spring,02:00:00 AM,0,0,0,cloudy,
2019,Fall,09:00:00 PM,34,29,5,clear night,
2019,Winter,11:00:00 AM,1285,594,691,cloudy,
2019,Summer,06:00:00 PM,2042,1014,1028,partly cloudy day,
2019,Fall,05:00:00 PM,2044,1064,980,clear day,
2019,Spring,07:00:00 PM,453,176,277,clear night,
2019,Winter,12:00:00 PM,739,341,398,cloudy,
2019,Summer,12:00:00 PM,1531,689,842,clear day,
2019,Summer,12:00:00 PM,1479,649,830,cloudy,
2019,Fall,12:00:00 PM,1271,545,726,cloudy,
2019,Winter,02:00:00 PM,2166,972,1194,clear day,
2019,Fall,05:00:00 PM,231,114,117,clear night,
2019,Spring,04:00:00 AM,2,0,2,clear night,
2019,Fall,09:00:00 PM,34,21,13,clear night,
2019,Winter,03:00:00 PM,1020,472,548,partly cloudy day,
2019,Winter,12:00:00 AM,2,1,1,clear night,
2019,Fall,12:00:00 AM,0,0,0,partly cloudy night,
2019,Spring,02:00:00 PM,1775,885,890,partly cloudy day,Tax Day
2019,Winter,08:00:00 PM,27,25,2,clear night,
2019,Winter,07:00:00 PM,61,57,4,partly cloudy night,
2019,Fall,01:00:00 PM,1594,741,853,cloudy,
2019,Fall,02:00:00 AM,0,0,0,partly cloudy night,
2019,Fall,09:00:00 AM,654,339,315,partly cloudy day,
2019,Winter,04:00:00 AM,0,0,0,clear night,
2019,Fall,06:00:00 AM,19,16,3,clear night,
2019,Winter,06:00:00 PM,34,33,1,rain,
2019,Winter,06:00:00 PM,355,355,0,clear night,
2019,Fall,09:00:00 AM,648,351,297,clear day,Veterans Day
2019,Fall,12:00:00 AM,42,41,1,partly cloudy night,
2019,Winter,11:00:00 AM,1365,636,729,clear day,
2019,Spring,06:00:00 PM,1612,865,747,partly cloudy day,
2019,Summer,12:00:00 PM,1765,695,1070,partly cloudy day,
2019,Summer,06:00:00 AM,150,78,72,clear day,
2019,Fall,04:00:00 PM,2420,1156,1264,cloudy,
2019,Winter,01:00:00 AM,0,0,0,rain,
2019,Fall,10:00:00 PM,7,4,3,clear night,
2019,Spring,03:00:00 PM,1936,855,1081,clear day,
2019,Spring,09:00:00 AM,576,234,342,partly cloudy day,
2019,Fall,12:00:00 AM,3,2,1,cloudy,
2019,Spring,07:00:00 AM,138,70,68,clear day,
2019,Spring,05:00:00 AM,22,12,10,cloudy,
2019,Spring,01:00:00 AM,1,0,1,clear night,
2019,Fall,02:00:00 PM,1165,455,710,rain,Labor Day
2019,Summer,02:00:00 PM,1794,722,1072,partly cloudy day,
2019,Winter,07:00:00 PM,36,19,17,cloudy,
2019,Fall,10:00:00 PM,1,0,1,clear night,
2019,Winter,09:00:00 AM,349,184,165,partly cloudy day,
2019,Winter,07:00:00 AM,20,9,11,rain,
2019,Spring,09:00:00 AM,981,539,442,clear day,
2019,Fall,10:00:00 PM,3,2,1,partly cloudy night,
2019,Spring,07:00:00 AM,186,86,100,cloudy,
2019,Summer,07:00:00 AM,232,95,137,clear day,
2019,Spring,04:00:00 PM,1748,892,856,partly cloudy day,
2019,Winter,03:00:00 AM,0,0,0,clear night,
2019,Summer,05:00:00 PM,2207,1025,1182,partly cloudy day,
2019,Winter,07:00:00 PM,32,31,1,clear night,
2019,Winter,12:00:00 PM,764,340,424,cloudy,
2019,Winter,10:00:00 PM,22,11,11,cloudy,
2019,Spring,03:00:00 PM,818,305,513,cloudy,Easter Monday
2019,Summer,12:00:00 AM,7,2,5,clear night,
2019,Summer,07:00:00 AM,465,142,323,partly cloudy day,
2019,Fall,11:00:00 AM,1397,773,624,cloudy,
2019,Summer,04:00:00 AM,0,0,0,partly cloudy night,
2019,Fall,08:00:00 PM,15,7,8,clear night,
2019,Fall,06:00:00 AM,86,53,33,cloudy,
2019,Summer,09:00:00 AM,630,333,297,clear day,
2019,Fall,06:00:00 AM,22,17,5,partly cloudy night,
2019,Winter,04:00:00 AM,0,0,0,cloudy,
2019,Winter,03:00:00 PM,1395,741,654,clear day,
2019,Winter,11:00:00 PM,1,0,1,clear night,
2019,Fall,12:00:00 PM,1509,700,809,cloudy,
2019,Winter,05:00:00 PM,110,74,36,cloudy,
2019,Summer,04:00:00 AM,3,1,2,partly cloudy night,
2019,Winter,09:00:00 AM,229,115,114,cloudy,
2019,Fall,09:00:00 AM,312,164,148,clear day,
2019,Summer,12:00:00 PM,2046,965,1081,partly cloudy day,Father's Day
2019,Summer,07:00:00 AM,222,108,114,clear day,
2019,Spring,06:00:00 PM,2105,1059,1046,clear day,
2019,Fall,06:00:00 AM,79,47,32,clear night,
2019,Spring,05:00:00 AM,0,0,0,clear night,
2019,Fall,01:00:00 AM,0,0,0,partly cloudy night,
2019,Winter,04:00:00 PM,1220,512,708,clear day,
2019,Fall,08:00:00 PM,40,36,4,clear night,
2019,Fall,11:00:00 AM,2047,952,1095,partly cloudy day,
2019,Summer,07:00:00 AM,276,131,145,partly cloudy day,
2019,Fall,01:00:00 PM,581,264,317,rain,
2019,Summer,10:00:00 AM,1438,879,559,partly cloudy day,
2019,Winter,10:00:00 AM,1030,515,515,partly cloudy day,
2019,Spring,06:00:00 AM,79,44,35,partly cloudy night,
2019,Spring,11:00:00 AM,1835,868,967,partly cloudy day,
2019,Winter,03:00:00 AM,1,0,1,cloudy,
2019,Summer,01:00:00 AM,2,0,2,clear night,
2019,Fall,02:00:00 AM,0,0,0,clear night,
2019,Spring,03:00:00 PM,627,318,309,cloudy,
2019,Spring,02:00:00 AM,3,1,2,partly cloudy night,Easter Sunday
2019,Fall,10:00:00 AM,1240,685,555,clear day,
2019,Spring,11:00:00 AM,223,137,86,rain,Mother's Day
2019,Spring,09:00:00 PM,31,30,1,clear night,
2019,Summer,11:00:00 PM,55,46,9,clear night,
2019,Summer,10:00:00 AM,1389,712,677,partly cloudy day,
2019,Spring,08:00:00 PM,25,0,25,clear night,
2019,Winter,10:00:00 AM,0,0,0,partly cloudy day,
2019,Fall,08:00:00 AM,383,134,249,cloudy,
2019,Spring,10:00:00 PM,48,32,16,cloudy,
2019,Spring,06:00:00 AM,98,56,42,clear night,
2019,Winter,02:00:00 AM,0,0,0,rain,
2019,Spring,07:00:00 AM,243,116,127,clear day,
2019,Spring,08:00:00 AM,52,27,25,rain,
2019,Fall,11:00:00 AM,2032,1124,908,partly cloudy day,
2019,Summer,12:00:00 PM,1649,793,856,partly cloudy day,
2019,Fall,09:00:00 PM,28,26,2,rain,
2019,Summer,08:00:00 PM,1023,499,524,partly cloudy day,
2019,Spring,03:00:00 PM,1607,659,948,partly cloudy day,
2019,Summer,03:00:00 PM,2031,1026,1005,partly cloudy day,
2019,Spring,10:00:00 PM,9,8,1,clear night,
2019,Spring,09:00:00 PM,33,15,18,cloudy,Tax Day
2019,Spring,11:00:00 AM,644,262,382,rain,Cinco de Mayo
2019,Summer,12:00:00 AM,10,0,10,clear night,
2019,Winter,04:00:00 PM,0,0,0,partly cloudy day,
2019,Spring,02:00:00 PM,2094,886,1208,partly cloudy day,
2019,Spring,09:00:00 PM,37,19,18,partly cloudy night,Easter Sunday
2019,Summer,09:00:00 PM,52,21,31,clear night,
2019,Winter,10:00:00 PM,10,0,10,partly cloudy night,
2019,Spring,11:00:00 PM,9,7,2,partly cloudy night,
2019,Spring,10:00:00 PM,32,30,2,cloudy,
2019,Summer,09:00:00 AM,775,462,313,partly cloudy day,
2019,Fall,09:00:00 AM,487,260,227,partly cloudy day,
2019,Fall,10:00:00 AM,1328,722,606,clear day,
2019,Fall,11:00:00 AM,1319,678,641,clear day,
2019,Winter,01:00:00 PM,2366,1104,1262,clear day,
2019,Fall,04:00:00 PM,3450,1445,2005,partly cloudy day,
2019,Summer,12:00:00 PM,2090,939,1151,partly cloudy day,
2019,Spring,02:00:00 PM,1118,444,674,cloudy,
2019,Fall,12:00:00 PM,2205,971,1234,clear day,
2019,Spring,06:00:00 AM,29,22,7,partly cloudy night,St. Patrick's Day
2019,Fall,05:00:00 AM,0,0,0,clear night,
2019,Winter,03:00:00 AM,0,0,0,cloudy,
2019,Winter,11:00:00 AM,724,384,340,cloudy,
2019,Fall,03:00:00 AM,2,0,2,partly cloudy night,
2019,Summer,09:00:00 PM,117,59,58,clear night,
2019,Spring,02:00:00 PM,386,202,184,rain,
2019,Fall,01:00:00 AM,2,1,1,partly cloudy night,
2019,Spring,11:00:00 PM,112,104,8,partly cloudy night,
2019,Fall,08:00:00 PM,31,26,5,partly cloudy night,
2019,Winter,09:00:00 AM,500,281,219,partly cloudy day,
2019,Fall,11:00:00 PM,29,29,0,partly cloudy night,
2019,Summer,11:00:00 AM,1869,951,918,partly cloudy day,
2019,Winter,09:00:00 AM,416,221,195,clear day,
2019,Spring,12:00:00 PM,1282,543,739,clear day,
2019,Summer,04:00:00 AM,0,0,0,clear night,
2019,Spring,11:00:00 AM,2750,1364,1386,clear day,Memorial Day
2019,Summer,11:00:00 AM,2242,1033,1209,clear day,
2019,Winter,04:00:00 AM,0,0,0,cloudy,
2019,Spring,02:00:00 AM,0,0,0,fog,
2019,Fall,10:00:00 AM,1205,655,550,clear day,
2019,Spring,11:00:00 AM,758,386,372,partly cloudy day,
2019,Winter,04:00:00 PM,716,350,366,snow,
2019,Fall,02:00:00 AM,0,0,0,cloudy,Columbus Day (regional holiday)
2019,Fall,05:00:00 AM,0,0,0,partly cloudy night,
2019,Fall,10:00:00 PM,3,0,3,clear night,
2019,Fall,04:00:00 PM,1398,626,772,cloudy,
2019,Winter,04:00:00 PM,367,217,150,clear day,
2019,Summer,06:00:00 PM,2010,1203,807,partly cloudy day,
2019,Summer,07:00:00 PM,1652,889,763,clear day,
2019,Winter,05:00:00 AM,1,0,1,clear night,
2019,Winter,07:00:00 AM,216,103,113,partly cloudy night,
2019,Summer,03:00:00 PM,2255,1033,1222,partly cloudy day,
2019,Summer,11:00:00 PM,14,6,8,clear night,
2019,Summer,07:00:00 PM,2496,1193,1303,partly cloudy day,
2019,Fall,09:00:00 PM,0,0,0,clear night,
2019,Winter,11:00:00 PM,57,56,1,partly cloudy night,
2019,Fall,08:00:00 AM,431,216,215,clear day,
2019,Spring,09:00:00 AM,596,280,316,cloudy,
2019,Fall,09:00:00 PM,42,25,17,partly cloudy night,Labor Day
2019,Spring,06:00:00 AM,135,61,74,partly cloudy day,
2019,Winter,05:00:00 PM,560,282,278,partly cloudy night,
2019,Spring,01:00:00 AM,0,0,0,clear night,
2019,Spring,05:00:00 AM,4,0,4,clear night,
2019,Winter,06:00:00 AM,40,26,14,cloudy,
2019,Summer,12:00:00 PM,1509,790,719,clear day,
2019,Winter,12:00:00 PM,908,411,497,cloudy,
2019,Spring,04:00:00 AM,0,0,0,cloudy,
2019,Spring,01:00:00 PM,1274,641,633,cloudy,
2019,Spring,03:00:00 AM,0,0,0,cloudy,
2019,Spring,02:00:00 PM,1881,863,1018,clear day,
2019,Spring,04:00:00 AM,0,0,0,snow,
2019,Winter,04:00:00 AM,0,0,0,partly cloudy night,
2019,Spring,07:00:00 PM,14,12,2,partly cloudy night,
2019,Fall,09:00:00 AM,990,562,428,clear day,
2019,Winter,10:00:00 AM,1727,893,834,clear day,
2019,Spring,07:00:00 PM,1738,646,1092,clear day,
2019,Winter,12:00:00 PM,824,390,434,clear day,
2019,Summer,07:00:00 PM,2358,1097,1261,partly cloudy day,
2019,Winter,02:00:00 PM,801,364,437,partly cloudy day,
2019,Fall,09:00:00 PM,66,55,11,clear night,
2019,Summer,05:00:00 PM,902,465,437,rain,
2019,Spring,10:00:00 AM,1337,668,669,partly cloudy day,
2019,Fall,10:00:00 AM,491,275,216,rain,Halloween
2019,Spring,12:00:00 PM,3292,1674,1618,partly cloudy day,
2019,Fall,12:00:00 AM,3,1,2,partly cloudy night,
2019,Spring,06:00:00 AM,51,30,21,clear night,
2019,Winter,09:00:00 PM,24,23,1,rain,
2019,Winter,02:00:00 AM,4,0,4,clear night,
2019,Fall,07:00:00 AM,159,61,98,cloudy,
2019,Winter,07:00:00 PM,71,38,33,cloudy,
2019,Winter,08:00:00 PM,118,79,39,partly cloudy night,
2019,Fall,04:00:00 AM,0,0,0,clear night,
2019,Winter,04:00:00 AM,1,0,1,clear night,
2019,Winter,03:00:00 PM,110,61,49,rain,
2019,Winter,07:00:00 AM,226,102,124,partly cloudy night,New Year's Day
2019,Spring,06:00:00 PM,793,399,394,clear day,
2019,Fall,04:00:00 PM,3593,1479,2114,clear day,
2019,Summer,02:00:00 PM,1392,655,737,partly cloudy day,
2019,Fall,10:00:00 AM,1475,765,710,clear day,
2019,Summer,05:00:00 AM,99,87,12,clear night,
2019,Winter,08:00:00 AM,324,139,185,cloudy,
2019,Spring,05:00:00 AM,25,19,6,partly cloudy night,Easter Monday
2019,Winter,06:00:00 AM,18,9,9,rain,
2019,Fall,05:00:00 PM,3430,1538,1892,clear day,
2019,Summer,02:00:00 PM,1835,821,1014,partly cloudy day,
2019,Summer,11:00:00 AM,2673,1419,1254,partly cloudy day,
2019,Winter,04:00:00 PM,2374,1085,1289,clear day,
2019,Winter,05:00:00 AM,0,0,0,clear night,
2019,Summer,02:00:00 AM,1,0,1,cloudy,
2019,Spring,04:00:00 AM,0,0,0,cloudy,
2019,Winter,12:00:00 PM,1023,479,544,cloudy,
2019,Spring,07:00:00 AM,235,124,111,clear day,
2019,Summer,06:00:00 PM,1919,1080,839,partly cloudy day,
2019,Spring,07:00:00 PM,489,237,252,partly cloudy night,
2019,Spring,03:00:00 PM,1941,918,1023,cloudy,
2019,Summer,02:00:00 PM,2202,898,1304,clear day,
2019,Winter,05:00:00 PM,231,103,128,clear day,
2019,Summer,02:00:00 PM,2023,991,1032,partly cloudy day,
2019,Winter,06:00:00 AM,19,9,10,partly cloudy night,
2019,Summer,07:00:00 AM,254,113,141,partly cloudy day,
2019,Fall,05:00:00 PM,1399,714,685,cloudy,
2019,Spring,05:00:00 PM,1796,850,946,cloudy,
2019,Summer,01:00:00 PM,1278,633,645,cloudy,
2019,Winter,05:00:00 AM,1,0,1,clear night,
2019,Fall,03:00:00 PM,2311,1015,1296,partly cloudy day,Daylight Saving Time ends
2019,Summer,08:00:00 AM,381,191,190,partly cloudy day,
2019,Fall,06:00:00 AM,15,10,5,partly cloudy night,
2019,Spring,05:00:00 AM,18,12,6,cloudy,
2019,Winter,04:00:00 PM,744,348,396,partly cloudy day,
2019,Winter,03:00:00 PM,2913,1441,1472,partly cloudy day,
2019,Winter,01:00:00 AM,2,0,2,clear night,
2019,Summer,06:00:00 PM,2395,1013,1382,partly cloudy day,
2019,Summer,05:00:00 PM,1273,638,635,cloudy,
2019,Winter,11:00:00 AM,999,473,526,rain,
2019,Spring,01:00:00 AM,0,0,0,partly cloudy night,St. Patrick's Day
2019,Summer,05:00:00 AM,54,37,17,partly cloudy night,
2019,Winter,02:00:00 AM,6,1,5,clear night,
2019,Summer,11:00:00 AM,1643,803,840,partly cloudy day,
2019,Summer,02:00:00 AM,2,0,2,clear night,
2019,Fall,01:00:00 AM,1,0,1,clear night,
2019,Winter,12:00:00 PM,1307,542,765,clear day,
2019,Summer,11:00:00 AM,1944,1014,930,clear day,
2019,Spring,06:00:00 PM,2333,1055,1278,clear day,
2019,Fall,05:00:00 PM,136,106,30,partly cloudy night,
2019,Summer,12:00:00 AM,3,1,2,clear night,
2019,Fall,10:00:00 AM,1764,1078,686,cloudy,
2019,Winter,05:00:00 AM,0,0,0,clear night,
2019,Spring,08:00:00 PM,1294,643,651,partly cloudy day,Memorial Day
2019,Spring,06:00:00 PM,2860,1072,1788,partly cloudy day,
2019,Winter,02:00:00 AM,2,1,1,rain,
2019,Summer,01:00:00 AM,1,0,1,clear night,
2019,Fall,05:00:00 AM,0,0,0,clear night,
2019,Fall,11:00:00 PM,5,0,5,partly cloudy night,
2019,Winter,04:00:00 PM,1827,847,980,partly cloudy day,
2019,Winter,03:00:00 PM,1156,586,570,partly cloudy day,
2019,Fall,04:00:00 AM,0,0,0,rain,
2019,Winter,06:00:00 PM,54,41,13,clear night,
2019,Summer,04:00:00 AM,1,1,0,clear night,
2019,Summer,05:00:00 AM,72,61,11,cloudy,
2019,Fall,04:00:00 PM,2404,1054,1350,clear day,
2019,Spring,02:00:00 AM,0,0,0,clear night,
2019,Summer,11:00:00 AM,1774,852,922,clear day,
2019,Winter,07:00:00 AM,0,0,0,partly cloudy night,
2019,Summer,06:00:00 AM,166,85,81,clear day,
2019,Winter,04:00:00 PM,2640,1340,1300,clear day,
2019,Spring,10:00:00 AM,641,405,236,cloudy,
2019,Spring,02:00:00 PM,372,189,183,rain,
2019,Spring,06:00:00 PM,1596,863,733,clear day,
2019,Spring,04:00:00 PM,1569,718,851,cloudy,
2019,Spring,10:00:00 AM,1406,897,509,cloudy,
2019,Fall,05:00:00 PM,442,179,263,partly cloudy night,Daylight Saving Time ends
2019,Winter,04:00:00 PM,964,452,512,partly cloudy day,
2019,Fall,05:00:00 PM,1794,876,918,partly cloudy day,
2019,Fall,04:00:00 AM,1,0,1,partly cloudy night,
2019,Spring,12:00:00 AM,4,3,1,clear night,
2019,Fall,08:00:00 PM,31,17,14,cloudy,
2019,Fall,01:00:00 PM,2429,1116,1313,clear day,
2019,Summer,09:00:00 PM,120,84,36,cloudy,
2019,Fall,09:00:00 PM,13,10,3,clear night,
2019,Spring,11:00:00 AM,960,433,527,partly cloudy day,
2019,Winter,11:00:00 PM,23,22,1,clear night,
2019,Summer,12:00:00 AM,23,15,8,rain,
2019,Spring,03:00:00 PM,1783,835,948,cloudy,
2019,Winter,08:00:00 AM,233,85,148,cloudy,
2019,Summer,09:00:00 PM,119,38,81,partly cloudy night,
2019,Spring,11:00:00 PM,9,2,7,cloudy,
2019,Fall,04:00:00 AM,0,0,0,clear night,
2019,Fall,11:00:00 AM,2264,1039,1225,clear day,
2019,Spring,01:00:00 PM,1453,580,873,partly cloudy day,
2019,Summer,01:00:00 PM,2234,1017,1217,partly cloudy day,
2019,Summer,03:00:00 AM,0,0,0,cloudy,
2019,Spring,01:00:00 AM,0,0,0,clear night,
2019,Fall,02:00:00 AM,0,0,0,rain,
2019,Fall,02:00:00 PM,1240,608,632,cloudy,
2019,Summer,11:00:00 AM,1943,839,1104,partly cloudy day,
2019,Spring,04:00:00 PM,192,112,80,rain,Mother's Day
2019,Winter,11:00:00 AM,551,303,248,cloudy,
2019,Fall,09:00:00 PM,45,43,2,partly cloudy night,
2019,Winter,11:00:00 PM,4,2,2,clear night,
2019,Spring,01:00:00 AM,0,0,0,clear night,
2019,Fall,12:00:00 AM,2,2,0,,
2019,Winter,11:00:00 AM,2071,1087,984,clear day,
2019,Summer,08:00:00 PM,1159,550,609,partly cloudy day,
2019,Winter,11:00:00 PM,28,28,0,clear night,Presidents' Day (regional holiday)
2019,Winter,02:00:00 AM,2,1,1,cloudy,
2019,Fall,09:00:00 AM,780,477,303,partly cloudy day,
2019,Spring,12:00:00 AM,3,2,1,clear night,
2019,Spring,11:00:00 AM,1924,971,953,clear day,
2019,Spring,08:00:00 PM,2,1,1,clear night,
2019,Spring,03:00:00 AM,0,0,0,cloudy,
2019,Summer,08:00:00 AM,362,158,204,partly cloudy day,
2019,Summer,07:00:00 PM,1786,1006,780,partly cloudy day,
2019,Winter,09:00:00 PM,24,8,16,clear night,
2019,Spring,04:00:00 PM,1877,826,1051,partly cloudy day,
2019,Fall,06:00:00 PM,2029,879,1150,partly cloudy day,
2019,Summer,02:00:00 PM,1989,840,1149,clear day,
2019,Summer,03:00:00 AM,1,0,1,partly cloudy night,
2019,Summer,03:00:00 AM,0,0,0,clear night,
2019,Summer,02:00:00 AM,1,0,1,partly cloudy night,
2019,Winter,07:00:00 PM,59,57,2,partly cloudy night,
2019,Spring,10:00:00 PM,2,1,1,clear night,
2019,Fall,01:00:00 AM,0,0,0,cloudy,
2019,Fall,03:00:00 PM,2479,1129,1350,clear day,
2019,Winter,03:00:00 AM,3,2,1,clear night,
2019,Summer,03:00:00 PM,2181,976,1205,partly cloudy day,
2019,Summer,03:00:00 PM,2270,988,1282,partly cloudy day,
2019,Fall,04:00:00 AM,0,0,0,partly cloudy night,
2019,Winter,10:00:00 PM,1,0,1,cloudy,New Year's Eve
2019,Fall,03:00:00 PM,1443,666,777,clear day,
2019,Summer,09:00:00 AM,728,411,317,partly cloudy day,
2019,Summer,08:00:00 AM,541,286,255,partly cloudy day,
2019,Winter,03:00:00 AM,0,0,0,clear night,
2019,Summer,02:00:00 PM,967,288,679,clear day,Independence Day
2019,Winter,12:00:00 PM,2644,1530,1114,clear day,Christmas Day
2019,Summer,04:00:00 PM,1769,794,975,partly cloudy day,
2019,Fall,09:00:00 PM,94,62,32,cloudy,
2019,Summer,07:00:00 PM,1751,954,797,partly cloudy day,
2019,Spring,05:00:00 AM,0,0,0,clear night,
2019,Spring,07:00:00 AM,129,63,66,partly cloudy day,
2019,Summer,06:00:00 PM,2197,1225,972,partly cloudy day,
2019,Fall,03:00:00 PM,1301,641,660,partly cloudy day,
2019,Summer,03:00:00 AM,0,0,0,partly cloudy night,
2019,Winter,07:00:00 AM,187,89,98,clear night,
2019,Winter,02:00:00 PM,297,167,130,partly cloudy day,Martin Luther King Jr. Day
2019,Spring,09:00:00 AM,405,220,185,clear day,
2019,Spring,04:00:00 AM,0,0,0,partly cloudy night,
2019,Winter,12:00:00 AM,47,44,3,clear night,
2019,Summer,05:00:00 PM,3213,1450,1763,partly cloudy day,
2019,Spring,04:00:00 PM,3105,1608,1497,cloudy,
2019,Summer,05:00:00 AM,72,44,28,clear night,
2019,Winter,07:00:00 AM,88,50,38,partly cloudy night,
2019,Spring,06:00:00 AM,186,98,88,clear night,
2019,Winter,04:00:00 PM,2600,1454,1146,partly cloudy day,
2019,Fall,06:00:00 PM,88,86,2,cloudy,
2019,Fall,04:00:00 PM,1278,608,670,partly cloudy day,
2019,Winter,02:00:00 PM,661,336,325,partly cloudy day,
2019,Winter,07:00:00 PM,20,19,1,clear night,
2019,Summer,04:00:00 AM,0,0,0,clear night,Independence Day
2019,Fall,03:00:00 AM,2,0,2,rain,Halloween
2019,Summer,05:00:00 AM,72,42,30,cloudy,
2019,Spring,01:00:00 PM,3414,1572,1842,partly cloudy day,
2019,Spring,06:00:00 PM,2252,1015,1237,partly cloudy day,
2019,Spring,03:00:00 AM,0,0,0,partly cloudy night,
2019,Winter,09:00:00 AM,248,139,109,clear day,
2019,Summer,10:00:00 AM,775,419,356,cloudy,
2019,Spring,01:00:00 PM,3258,1567,1691,clear day,
2019,Winter,06:00:00 PM,128,118,10,partly cloudy night,
2019,Winter,07:00:00 AM,125,50,75,partly cloudy night,
2019,Spring,07:00:00 AM,296,120,176,partly cloudy day,
2019,Summer,11:00:00 PM,92,90,2,partly cloudy night,
2019,Spring,09:00:00 PM,5,2,3,clear night,
2019,Summer,01:00:00 AM,0,0,0,,
2019,Winter,12:00:00 AM,6,4,2,cloudy,
2019,Spring,10:00:00 AM,1473,886,587,clear day,
2019,Fall,03:00:00 PM,2081,969,1112,clear day,
2019,Spring,05:00:00 PM,3023,1264,1759,partly cloudy day,
2019,Winter,07:00:00 AM,124,51,73,partly cloudy night,
2019,Spring,03:00:00 PM,1909,988,921,partly cloudy day,
2019,Fall,09:00:00 AM,747,392,355,clear day,
2019,Summer,06:00:00 PM,1725,976,749,partly cloudy day,
2019,Summer,08:00:00 PM,759,307,452,partly cloudy day,
2019,Winter,07:00:00 PM,16,14,2,partly cloudy night,
2019,Spring,09:00:00 AM,126,70,56,rain,
2019,Summer,09:00:00 AM,793,391,402,partly cloudy day,
2019,Fall,02:00:00 PM,2187,913,1274,partly cloudy day,
2019,Winter,12:00:00 AM,1,0,1,clear night,
2019,Summer,06:00:00 PM,706,395,311,rain,
2019,Winter,07:00:00 AM,55,28,27,cloudy,
2019,Summer,09:00:00 AM,480,195,285,clear day,
2019,Fall,08:00:00 PM,3,1,2,cloudy,
2019,Summer,10:00:00 PM,58,21,37,cloudy,
2019,Summer,03:00:00 PM,2394,1030,1364,partly cloudy day,
2019,Fall,06:00:00 PM,2673,1248,1425,cloudy,
2019,Winter,09:00:00 AM,337,195,142,clear day,
2019,Spring,11:00:00 PM,38,0,38,partly cloudy night,
2019,Spring,01:00:00 AM,0,0,0,partly cloudy night,
2019,Winter,02:00:00 PM,1320,552,768,partly cloudy day,
2019,Fall,09:00:00 AM,1358,882,476,partly cloudy day,
2019,Winter,08:00:00 PM,4,0,4,clear night,
2019,Summer,03:00:00 PM,2466,1011,1455,partly cloudy day,
2019,Winter,11:00:00 AM,578,279,299,clear day,
2019,Summer,08:00:00 AM,335,148,187,cloudy,
2019,Spring,10:00:00 PM,16,14,2,clear night,
2019,Spring,01:00:00 AM,0,0,0,cloudy,
2019,Fall,05:00:00 AM,0,0,0,partly cloudy night,
2019,Winter,08:00:00 PM,32,31,1,clear night,
2019,Fall,02:00:00 PM,1973,845,1128,partly cloudy day,
2019,Summer,06:00:00 PM,1360,726,634,partly cloudy day,
2019,Fall,05:00:00 AM,0,0,0,clear night,
2019,Spring,08:00:00 PM,35,24,11,rain,
2019,Spring,11:00:00 AM,761,344,417,cloudy,
2019,Fall,08:00:00 AM,385,159,226,clear day,
2019,Summer,03:00:00 AM,1,0,1,partly cloudy night,
2019,Summer,08:00:00 PM,850,367,483,partly cloudy day,
2019,Summer,07:00:00 AM,206,107,99,clear day,
2019,Fall,07:00:00 AM,180,88,92,partly cloudy day,Labor Day
2019,Spring,05:00:00 AM,0,0,0,partly cloudy night,
2019,Summer,03:00:00 PM,2308,1142,1166,partly cloudy day,
2019,Spring,09:00:00 PM,0,0,0,clear night,St. Patrick's Day
2019,Spring,03:00:00 AM,0,0,0,cloudy,
2019,Summer,08:00:00 AM,402,187,215,partly cloudy day,
2019,Summer,04:00:00 PM,1725,798,927,partly cloudy day,
2019,Winter,06:00:00 PM,80,76,4,clear night,
2019,Fall,07:00:00 PM,1,0,1,clear night,
2019,Fall,06:00:00 AM,3,2,1,clear night,
2019,Fall,05:00:00 AM,0,0,0,cloudy,
2019,Winter,08:00:00 PM,19,11,8,partly cloudy night,
2019,Fall,02:00:00 PM,2740,1198,1542,partly cloudy day,
2019,Fall,05:00:00 PM,2454,1167,1287,partly cloudy day,
2019,Winter,07:00:00 AM,94,58,36,clear night,
2019,Fall,04:00:00 AM,1,0,1,partly cloudy night,
2019,Spring,08:00:00 PM,70,42,28,rain,
2019,Summer,08:00:00 PM,744,360,384,cloudy,
2019,Spring,01:00:00 PM,466,175,291,rain,
2019,Summer,01:00:00 AM,2,0,2,cloudy,
2019,Winter,09:00:00 PM,13,8,5,partly cloudy night,
2019,Fall,07:00:00 PM,38,38,0,clear night,
2019,Winter,10:00:00 AM,720,379,341,cloudy,Presidents' Day (regional holiday)
2019,Winter,06:00:00 AM,8,7,1,clear night,
2019,Summer,05:00:00 PM,2592,1228,1364,partly cloudy day,
2019,Summer,12:00:00 PM,2537,1093,1444,partly cloudy day,
2019,Summer,07:00:00 AM,287,128,159,partly cloudy day,
2019,Summer,06:00:00 AM,195,105,90,clear night,
2019,Winter,01:00:00 PM,3453,1762,1691,cloudy,New Year's Eve
2019,Spring,10:00:00 PM,38,36,2,rain,
2019,Summer,05:00:00 AM,46,25,21,partly cloudy night,
2019,Fall,01:00:00 AM,0,0,0,rain,
2019,Winter,09:00:00 PM,70,67,3,partly cloudy night,
2019,Spring,09:00:00 PM,32,18,14,cloudy,
2019,Winter,07:00:00 PM,76,50,26,clear night,
2019,Fall,07:00:00 AM,175,82,93,clear day,
2019,Spring,09:00:00 PM,39,30,9,cloudy,
2019,Winter,02:00:00 AM,0,0,0,partly cloudy night,
2019,Spring,02:00:00 PM,1695,740,955,partly cloudy day,
2019,Summer,08:00:00 AM,148,62,86,rain,
2019,Summer,05:00:00 AM,72,43,29,clear night,
2019,Fall,02:00:00 PM,1870,844,1026,clear day,Veterans Day
2019,Fall,09:00:00 PM,29,26,3,clear night,
2019,Winter,03:00:00 AM,0,0,0,partly cloudy night,Martin Luther King Jr. Day
2019,Fall,07:00:00 AM,218,78,140,clear night,
2019,Fall,06:00:00 AM,138,60,78,clear night,
2019,Winter,08:00:00 AM,352,119,233,partly cloudy day,
2019,Fall,09:00:00 AM,547,321,226,clear day,Black Friday
2019,Summer,12:00:00 PM,1934,847,1087,partly cloudy day,
2019,Spring,12:00:00 AM,8,4,4,cloudy,
2019,Winter,04:00:00 AM,0,0,0,clear night,
2019,Winter,04:00:00 PM,1027,466,561,clear day,
2019,Winter,06:00:00 PM,134,111,23,partly cloudy night,
2019,Winter,08:00:00 AM,273,161,112,clear day,
2019,Spring,10:00:00 AM,1346,790,556,partly cloudy day,
2019,Winter,12:00:00 AM,2,0,2,partly cloudy night,
2019,Summer,05:00:00 PM,2834,1192,1642,partly cloudy day,
2019,Winter,11:00:00 AM,664,297,367,clear day,
2019,Fall,06:00:00 PM,989,449,540,clear night,
2019,Fall,03:00:00 AM,0,0,0,cloudy,
2019,Spring,10:00:00 AM,993,564,429,cloudy,
2019,Spring,07:00:00 PM,945,491,454,partly cloudy day,
2019,Summer,04:00:00 PM,1709,853,856,partly cloudy day,
2019,Spring,02:00:00 PM,1763,782,981,partly cloudy day,
2019,Winter,05:00:00 AM,0,0,0,partly cloudy night,
2019,Spring,02:00:00 PM,2681,1264,1417,partly cloudy day,
2019,Spring,01:00:00 AM,0,0,0,cloudy,
2019,Fall,01:00:00 AM,0,0,0,clear night,
2019,Fall,09:00:00 PM,6,5,1,clear night,
2019,Spring,01:00:00 AM,1,0,1,clear night,
2019,Winter,09:00:00 PM,11,0,11,rain,
2019,Fall,06:00:00 AM,35,26,9,cloudy,
2019,Summer,02:00:00 AM,3,2,1,partly cloudy night,
2019,Winter,07:00:00 AM,125,53,72,cloudy,
2019,Spring,06:00:00 AM,166,74,92,clear day,
2019,Spring,07:00:00 PM,1915,939,976,clear day,
2019,Summer,04:00:00 PM,3257,1502,1755,partly cloudy day,
2019,Winter,09:00:00 PM,14,9,5,cloudy,
2019,Winter,04:00:00 AM,0,0,0,clear night,
2019,Fall,07:00:00 AM,323,171,152,partly cloudy day,
2019,Summer,02:00:00 PM,3363,1544,1819,partly cloudy day,
2019,Fall,08:00:00 AM,440,160,280,partly cloudy day,
2019,Fall,01:00:00 PM,2259,1057,1202,partly cloudy day,
2019,Spring,10:00:00 AM,1927,1127,800,clear day,
2019,Summer,08:00:00 PM,2070,898,1172,clear day,
2019,Winter,07:00:00 PM,39,0,39,clear night,
2019,Spring,06:00:00 PM,1483,795,688,partly cloudy day,
2019,Fall,09:00:00 PM,19,16,3,clear night,
2019,Fall,02:00:00 PM,580,269,311,cloudy,
2019,Summer,12:00:00 AM,8,4,4,clear night,
2019,Winter,02:00:00 AM,0,0,0,partly cloudy night,
2019,Winter,03:00:00 AM,2,1,1,rain,
2019,Summer,06:00:00 PM,2128,1156,972,partly cloudy day,
2019,Fall,01:00:00 AM,11,10,1,partly cloudy night,
2019,Winter,03:00:00 PM,349,161,188,sleet,
2019,Fall,08:00:00 PM,2,0,2,clear night,
2019,Fall,06:00:00 PM,92,91,1,clear night,
2019,Fall,05:00:00 AM,3,2,1,clear night,
2019,Spring,03:00:00 AM,0,0,0,cloudy,
2019,Summer,11:00:00 AM,2290,1232,1058,partly cloudy day,
2019,Spring,07:00:00 AM,221,89,132,cloudy,
2019,Fall,10:00:00 AM,267,68,199,rain,
2019,Winter,12:00:00 AM,1,0,1,clear night,
2019,Spring,08:00:00 PM,16,10,6,clear night,
2019,Winter,01:00:00 AM,0,0,0,clear night,
2019,Spring,10:00:00 PM,44,30,14,cloudy,
2019,Spring,08:00:00 PM,24,12,12,cloudy,
2019,Winter,12:00:00 AM,12,10,2,partly cloudy night,
2019,Spring,09:00:00 AM,989,572,417,cloudy,
2019,Summer,08:00:00 PM,902,359,543,partly cloudy day,
2019,Fall,08:00:00 PM,89,66,23,partly cloudy night,
2019,Spring,07:00:00 AM,174,97,77,cloudy,Easter Sunday
2019,Fall,07:00:00 AM,283,132,151,clear night,
2019,Winter,07:00:00 AM,118,41,77,clear night,
2019,Winter,02:00:00 PM,233,116,117,fog,
2019,Fall,10:00:00 AM,1218,711,507,cloudy,
2019,Summer,10:00:00 PM,33,19,14,partly cloudy night,
2019,Spring,08:00:00 PM,48,45,3,clear night,
2019,Spring,12:00:00 AM,2,1,1,clear night,Easter Monday
2019,Summer,09:00:00 PM,34,23,11,cloudy,
2019,Fall,02:00:00 AM,0,0,0,cloudy,
2019,Fall,09:00:00 AM,467,215,252,cloudy,
2019,Winter,09:00:00 PM,11,7,4,cloudy,
2019,Summer,01:00:00 AM,7,4,3,clear night,
2019,Spring,10:00:00 PM,16,0,16,rain,
2019,Fall,02:00:00 PM,1672,685,987,partly cloudy day,
2019,Spring,09:00:00 AM,756,390,366,cloudy,
2019,Summer,03:00:00 PM,2086,898,1188,partly cloudy day,
2019,Winter,08:00:00 PM,6,5,1,clear night,
2019,Fall,03:00:00 PM,798,295,503,rain,
2019,Winter,11:00:00 AM,808,427,381,partly cloudy day,
2019,Spring,12:00:00 AM,28,26,2,cloudy,
2019,Winter,11:00:00 AM,2710,1433,1277,cloudy,
2019,Fall,01:00:00 AM,0,0,0,cloudy,
2019,Fall,04:00:00 PM,1806,785,1021,clear day,
2019,Fall,10:00:00 AM,1084,439,645,cloudy,
2019,Winter,06:00:00 AM,25,14,11,partly cloudy night,
2019,Winter,01:00:00 AM,9,9,0,clear night,
2019,Winter,01:00:00 PM,704,299,405,partly cloudy day,
2019,Fall,08:00:00 PM,37,32,5,cloudy,
2019,Spring,01:00:00 PM,3043,1458,1585,partly cloudy day,
2019,Spring,10:00:00 PM,93,70,23,cloudy,Cinco de Mayo
2019,Winter,02:00:00 PM,1280,563,717,clear day,
2019,Winter,12:00:00 PM,503,272,231,rain,
2019,Fall,01:00:00 AM,6,0,6,rain,
2019,Winter,06:00:00 PM,135,128,7,clear night,
2019,Summer,10:00:00 AM,1157,664,493,cloudy,
2019,Summer,11:00:00 AM,1982,1003,979,partly cloudy day,
2019,Winter,12:00:00 AM,7,0,7,clear night,
2019,Spring,06:00:00 AM,16,4,12,rain,Mother's Day
2019,Spring,01:00:00 AM,0,0,0,cloudy,
2019,Winter,11:00:00 AM,1406,725,681,cloudy,
2019,Summer,04:00:00 AM,0,0,0,clear night,
2019,Spring,10:00:00 AM,1734,955,779,clear day,
2019,Winter,06:00:00 AM,7,5,2,rain,
2019,Winter,08:00:00 PM,34,30,4,clear night,
2019,Fall,08:00:00 PM,87,80,7,cloudy,
2019,Fall,06:00:00 AM,167,98,69,partly cloudy night,
2019,Winter,05:00:00 AM,0,0,0,partly cloudy night,Valentine's Day
2019,Spring,08:00:00 AM,177,96,81,partly cloudy day,
2019,Winter,12:00:00 PM,191,94,97,rain,
2019,Summer,05:00:00 AM,63,40,23,clear night,
2019,Summer,08:00:00 PM,131,78,53,clear night,
2019,Spring,10:00:00 PM,62,45,17,partly cloudy night,
2019,Fall,12:00:00 AM,0,0,0,clear night,
2019,Spring,07:00:00 AM,207,84,123,cloudy,
2019,Summer,06:00:00 PM,1606,931,675,clear day,
2019,Fall,12:00:00 PM,2658,1240,1418,clear day,
2019,Spring,08:00:00 PM,32,0,32,clear night,St. Patrick's Day
2019,Summer,10:00:00 PM,73,48,25,clear night,
2019,Winter,01:00:00 PM,2355,1068,1287,partly cloudy day,
2019,Fall,04:00:00 PM,1566,744,822,partly cloudy day,
2019,Winter,08:00:00 AM,267,128,139,clear day,
2019,Fall,11:00:00 AM,2629,1354,1275,clear day,
2019,Fall,04:00:00 AM,0,0,0,clear night,
2019,Spring,10:00:00 AM,1315,776,539,cloudy,
2019,Spring,08:00:00 AM,259,84,175,partly cloudy day,
2019,Winter,12:00:00 AM,2,1,1,cloudy,
2019,Winter,10:00:00 PM,12,0,12,cloudy,
2019,Winter,11:00:00 PM,29,0,29,clear night,
2019,Winter,01:00:00 PM,570,260,310,cloudy,
2019,Fall,02:00:00 PM,2709,1319,1390,clear day,
2019,Winter,05:00:00 PM,542,245,297,partly cloudy night,
2019,Spring,12:00:00 AM,9,4,5,cloudy,
2019,Winter,07:00:00 PM,1391,232,1159,partly cloudy night,Presidents' Day (regional holiday)
2019,Spring,11:00:00 AM,533,251,282,cloudy,
2019,Spring,10:00:00 AM,999,537,462,cloudy,
2019,Winter,11:00:00 PM,3,1,2,cloudy,
2019,Spring,11:00:00 AM,1296,675,621,clear day,
2019,Spring,06:00:00 PM,1143,521,622,cloudy,
2019,Winter,11:00:00 AM,584,286,298,cloudy,
2019,Summer,01:00:00 PM,1864,865,999,partly cloudy day,
2019,Fall,03:00:00 PM,1840,821,1019,partly cloudy day,
2019,Summer,08:00:00 PM,1265,510,755,partly cloudy day,
2019,Summer,08:00:00 AM,491,305,186,partly cloudy day,
2019,Fall,01:00:00 PM,784,308,476,clear day,
2019,Summer,12:00:00 PM,2610,1247,1363,partly cloudy day,
2019,Winter,10:00:00 PM,59,59,0,clear night,
2019,Fall,01:00:00 PM,866,398,468,clear day,
2019,Fall,09:00:00 AM,896,556,340,clear day,
2019,Summer,05:00:00 PM,1804,911,893,partly cloudy day,
2019,Summer,04:00:00 PM,1655,803,852,partly cloudy day,
2019,Winter,10:00:00 AM,923,520,403,cloudy,
2019,Winter,03:00:00 PM,1433,646,787,partly cloudy day,
2019,Spring,05:00:00 PM,1462,730,732,cloudy,
2019,Winter,04:00:00 AM,0,0,0,cloudy,
2019,Fall,06:00:00 PM,74,73,1,clear night,
2019,Fall,10:00:00 PM,9,2,7,clear night,
2019,Spring,03:00:00 PM,2402,1063,1339,partly cloudy day,
2019,Spring,06:00:00 AM,10,9,1,rain,
2019,Winter,03:00:00 PM,921,416,505,partly cloudy day,
2019,Summer,06:00:00 AM,169,92,77,cloudy,
2019,Spring,10:00:00 AM,1595,852,743,cloudy,
2019,Summer,10:00:00 PM,29,26,3,rain,
2019,Summer,03:00:00 PM,2229,1073,1156,partly cloudy day,
2019,Fall,07:00:00 PM,78,58,20,cloudy,
2019,Spring,01:00:00 PM,1105,456,649,cloudy,
2019,Spring,10:00:00 AM,1378,801,577,partly cloudy day,
2019,Summer,08:00:00 AM,514,195,319,partly cloudy day,
2019,Fall,10:00:00 PM,9,8,1,rain,
2019,Spring,10:00:00 PM,4,0,4,clear night,
2019,Fall,03:00:00 AM,1,0,1,clear night,
2019,Winter,06:00:00 PM,48,0,48,rain,
2019,Spring,01:00:00 PM,2609,1119,1490,clear day,
2019,Spring,01:00:00 AM,0,0,0,clear night,
2019,Spring,10:00:00 AM,879,523,356,clear day,
2019,Spring,07:00:00 PM,292,151,141,clear night,
2019,Fall,05:00:00 PM,1777,968,809,partly cloudy day,
2019,Summer,06:00:00 PM,2168,1202,966,partly cloudy day,
2019,Spring,04:00:00 AM,1,0,1,partly cloudy night,
2019,Winter,07:00:00 AM,112,58,54,clear night,
2019,Summer,03:00:00 AM,0,0,0,clear night,
2019,Fall,03:00:00 PM,2641,1122,1519,cloudy,
2019,Winter,11:00:00 PM,12,11,1,clear night,
2019,Summer,08:00:00 PM,764,371,393,clear night,
2019,Spring,11:00:00 AM,1235,646,589,clear day,
2019,Fall,05:00:00 PM,884,480,404,rain,
2019,Winter,07:00:00 PM,10,9,1,clear night,Christmas Day
2019,Winter,01:00:00 PM,483,231,252,snow,
2019,Summer,08:00:00 AM,379,132,247,partly cloudy day,
2019,Fall,09:00:00 AM,150,72,78,rain,
2019,Winter,12:00:00 AM,0,0,0,,
2019,Summer,03:00:00 PM,1875,851,1024,partly cloudy day,
2019,Summer,10:00:00 PM,38,23,15,clear night,
2019,Winter,11:00:00 AM,965,454,511,clear day,
2019,Fall,02:00:00 PM,1444,607,837,clear day,
2019,Spring,03:00:00 AM,0,0,0,clear night,
2019,Summer,01:00:00 AM,0,0,0,partly cloudy night,
2019,Fall,07:00:00 PM,45,36,9,clear night,
2019,Summer,01:00:00 PM,2168,977,1191,clear day,
2019,Spring,11:00:00 AM,1078,614,464,clear day,
2019,Winter,04:00:00 AM,0,0,0,clear night,Christmas Eve
2019,Summer,06:00:00 AM,189,91,98,partly cloudy day,
2019,Spring,05:00:00 AM,5,3,2,rain,
2019,Fall,02:00:00 PM,1987,876,1111,clear day,
2019,Spring,03:00:00 PM,1743,751,992,partly cloudy day,
2019,Winter,12:00:00 PM,1641,723,918,partly cloudy day,
2019,Winter,12:00:00 PM,1078,438,640,rain,
2019,Spring,06:00:00 AM,176,106,70,cloudy,
2019,Winter,11:00:00 PM,6,5,1,cloudy,
2019,Winter,09:00:00 PM,39,38,1,clear night,
2019,Spring,09:00:00 AM,714,440,274,partly cloudy day,
2019,Summer,10:00:00 AM,1185,680,505,partly cloudy day,
2019,Winter,10:00:00 AM,717,425,292,partly cloudy day,Valentine's Day
2019,Fall,06:00:00 PM,27,26,1,rain,
2019,Winter,02:00:00 PM,0,0,0,partly cloudy day,
2019,Fall,10:00:00 AM,1105,569,536,partly cloudy day,
2019,Fall,06:00:00 PM,1604,694,910,clear day,
2019,Winter,06:00:00 AM,2,0,2,rain,
2019,Winter,03:00:00 AM,0,0,0,clear night,
2019,Spring,05:00:00 AM,1,0,1,snow,
2019,Spring,04:00:00 PM,1108,498,610,clear day,
2019,Spring,04:00:00 AM,0,0,0,rain,
2019,Fall,08:00:00 AM,366,145,221,clear day,
2019,Summer,01:00:00 AM,1,1,0,clear night,
2019,Winter,04:00:00 AM,0,0,0,clear night,
2019,Fall,04:00:00 AM,0,0,0,cloudy,
2019,Spring,02:00:00 PM,1685,883,802,rain,
2019,Spring,10:00:00 PM,25,0,25,partly cloudy night,
2019,Summer,10:00:00 AM,1876,1113,763,cloudy,
2019,Winter,12:00:00 PM,0,0,0,clear day,
2019,Fall,07:00:00 AM,291,114,177,cloudy,
2019,Fall,06:00:00 PM,1310,676,634,partly cloudy day,
2019,Summer,02:00:00 PM,2592,1118,1474,partly cloudy day,
2019,Winter,07:00:00 PM,14,0,14,clear night,
2019,Summer,06:00:00 AM,180,91,89,partly cloudy night,
2019,Summer,05:00:00 AM,94,59,35,clear night,
2019,Spring,11:00:00 AM,256,134,122,rain,Daylight Saving Time starts
2019,Fall,12:00:00 AM,0,0,0,clear night,
2019,Fall,02:00:00 PM,2654,1084,1570,clear day,
2019,Fall,06:00:00 AM,136,68,68,clear night,
2019,Summer,05:00:00 AM,34,16,18,partly cloudy night,
2019,Summer,08:00:00 PM,290,166,124,partly cloudy night,
2019,Fall,04:00:00 AM,0,0,0,clear night,
2019,Fall,07:00:00 AM,303,147,156,clear day,
2019,Fall,03:00:00 PM,2126,920,1206,partly cloudy day,
2019,Spring,03:00:00 AM,0,0,0,clear night,
2019,Winter,11:00:00 PM,9,4,5,sleet,
2019,Summer,03:00:00 PM,2124,997,1127,clear day,
2019,Summer,04:00:00 PM,1303,540,763,rain,
2019,Winter,07:00:00 PM,64,62,2,cloudy,
2019,Summer,02:00:00 PM,3102,1321,1781,clear day,
2019,Summer,05:00:00 AM,14,4,10,fog,
2019,Spring,03:00:00 PM,190,93,97,rain,Mother's Day
2019,Spring,12:00:00 AM,0,0,0,clear night,
2019,Spring,05:00:00 PM,593,343,250,cloudy,
2019,Fall,02:00:00 PM,1726,746,980,clear day,
2019,Summer,06:00:00 PM,1898,1024,874,partly cloudy day,
2019,Fall,04:00:00 AM,0,0,0,cloudy,
2019,Winter,07:00:00 AM,130,52,78,cloudy,
2019,Fall,03:00:00 PM,2022,1115,907,partly cloudy day,Thanksgiving Day
2019,Summer,02:00:00 AM,0,0,0,partly cloudy night,
2019,Winter,12:00:00 AM,16,16,0,clear night,
2019,Fall,12:00:00 AM,37,0,37,partly cloudy night,
2019,Fall,02:00:00 PM,1978,795,1183,clear day,
2019,Winter,07:00:00 AM,105,43,62,cloudy,
2019,Winter,08:00:00 AM,191,88,103,clear day,
2019,Summer,03:00:00 AM,2,0,2,clear night,
2019,Fall,12:00:00 AM,56,0,56,cloudy,
2019,Spring,03:00:00 AM,1,0,1,cloudy,
2019,Summer,02:00:00 AM,0,0,0,clear night,
2019,Winter,10:00:00 AM,445,242,203,partly cloudy day,
2019,Summer,07:00:00 AM,228,99,129,partly cloudy day,
2019,Winter,02:00:00 AM,1,0,1,cloudy,
2019,Winter,06:00:00 PM,48,37,11,partly cloudy night,
2019,Spring,08:00:00 AM,298,141,157,cloudy,
2019,Fall,08:00:00 AM,378,170,208,cloudy,
2019,Summer,05:00:00 PM,2221,1152,1069,partly cloudy day,
2019,Winter,03:00:00 PM,2504,1085,1419,partly cloudy day,
2019,Spring,01:00:00 AM,5,0,5,cloudy,
2019,Fall,12:00:00 AM,10,0,10,cloudy,
2019,Winter,09:00:00 AM,592,367,225,clear day,
2019,Winter,02:00:00 PM,2452,1112,1340,clear day,
2019,Fall,04:00:00 AM,0,0,0,clear night,
2019,Winter,08:00:00 PM,62,60,2,clear night,
2019,Spring,01:00:00 PM,3462,1643,1819,partly cloudy day,
2019,Spring,04:00:00 PM,2687,1179,1508,partly cloudy day,
2019,Winter,11:00:00 AM,40,30,10,rain,
2019,Spring,11:00:00 PM,2,0,2,rain,
2019,Spring,12:00:00 AM,4,3,1,clear night,
2019,Spring,12:00:00 PM,1697,792,905,clear day,
2019,Winter,04:00:00 PM,1054,507,547,cloudy,
2019,Spring,04:00:00 PM,2078,717,1361,partly cloudy day,
2019,Spring,07:00:00 PM,25,18,7,cloudy,
2019,Summer,10:00:00 PM,37,19,18,partly cloudy night,
2019,Spring,05:00:00 PM,2966,1406,1560,partly cloudy day,
2019,Spring,06:00:00 AM,65,42,23,clear night,
2019,Spring,03:00:00 AM,0,0,0,clear night,
2019,Spring,10:00:00 PM,42,26,16,clear night,
2019,Winter,11:00:00 AM,745,386,359,partly cloudy day,
2019,Fall,05:00:00 PM,416,173,243,clear night,
2019,Fall,05:00:00 PM,3302,1630,1672,partly cloudy day,
2019,Spring,01:00:00 PM,1995,818,1177,partly cloudy day,
2019,Fall,03:00:00 AM,1,0,1,rain,
2019,Summer,10:00:00 AM,1193,694,499,clear day,
2019,Fall,12:00:00 AM,0,0,0,clear night,
2019,Spring,01:00:00 PM,2803,1185,1618,clear day,
2019,Fall,04:00:00 AM,0,0,0,partly cloudy night,
2019,Summer,01:00:00 PM,1978,802,1176,partly cloudy day,
2019,Spring,10:00:00 PM,60,48,12,cloudy,Mother's Day
2019,Summer,11:00:00 PM,12,8,4,clear night,
2019,Spring,03:00:00 PM,3077,1323,1754,clear day,
2019,Winter,04:00:00 PM,937,365,572,partly cloudy day,
2019,Spring,01:00:00 PM,1805,842,963,cloudy,
2019,Summer,08:00:00 AM,401,240,161,partly cloudy day,
2019,Winter,11:00:00 AM,3199,1928,1271,partly cloudy day,
2019,Winter,10:00:00 AM,380,209,171,partly cloudy day,
2019,Winter,03:00:00 AM,14,10,4,cloudy,New Year's Day
2019,Spring,10:00:00 PM,1,0,1,partly cloudy night,
2019,Winter,08:00:00 PM,13,12,1,clear night,
2019,Summer,09:00:00 AM,847,506,341,partly cloudy day,
2019,Summer,10:00:00 AM,1272,678,594,clear day,
2019,Fall,09:00:00 PM,2,0,2,clear night,
2019,Spring,03:00:00 PM,3511,1645,1866,partly cloudy day,
2019,Spring,02:00:00 PM,1787,770,1017,clear day,
2019,Winter,02:00:00 AM,0,0,0,clear night,
2019,Fall,09:00:00 PM,0,0,0,clear night,
2019,Summer,03:00:00 AM,2,1,1,cloudy,
2019,Spring,08:00:00 AM,175,82,93,cloudy,
2019,Summer,07:00:00 PM,1944,1036,908,partly cloudy day,
2019,Summer,08:00:00 PM,1151,545,606,partly cloudy day,
2019,Fall,01:00:00 PM,2601,1112,1489,clear day,
2019,Fall,07:00:00 PM,48,43,5,partly cloudy night,
2019,Spring,11:00:00 PM,39,38,1,clear night,
2019,Fall,12:00:00 PM,2530,1191,1339,partly cloudy day,
2019,Fall,05:00:00 AM,0,0,0,clear night,
2019,Winter,03:00:00 AM,3,1,2,clear night,
2019,Spring,08:00:00 AM,464,278,186,clear day,Memorial Day
2019,Winter,11:00:00 AM,870,470,400,partly cloudy day,
2019,Fall,03:00:00 AM,0,0,0,partly cloudy night,
2019,Spring,10:00:00 AM,470,220,250,cloudy,
2019,Winter,10:00:00 PM,16,7,9,partly cloudy night,
2019,Fall,09:00:00 PM,41,0,41,clear night,
2019,Summer,03:00:00 AM,0,0,0,partly cloudy night,
2019,Summer,09:00:00 AM,911,523,388,cloudy,
2019,Fall,02:00:00 PM,795,333,462,cloudy,
2019,Summer,10:00:00 AM,1096,655,441,clear day,
2019,Summer,06:00:00 PM,1759,1002,757,clear day,
2019,Winter,01:00:00 AM,0,0,0,clear night,
2019,Winter,10:00:00 AM,992,493,499,clear day,
2019,Spring,11:00:00 PM,14,13,1,rain,
2019,Summer,05:00:00 AM,7,5,2,partly cloudy night,
2019,Spring,12:00:00 PM,1563,729,834,partly cloudy day,
2019,Spring,08:00:00 PM,41,35,6,partly cloudy night,
2019,Summer,01:00:00 AM,0,0,0,clear night,
2019,Winter,06:00:00 AM,6,4,2,clear night,
2019,Summer,11:00:00 PM,47,38,9,partly cloudy night,
2019,Summer,11:00:00 AM,1592,822,770,cloudy,
2019,Fall,07:00:00 PM,52,0,52,clear night,
2019,Spring,11:00:00 PM,0,0,0,cloudy,
2019,Summer,10:00:00 PM,23,13,10,partly cloudy night,
2019,Winter,11:00:00 PM,0,0,0,partly cloudy night,
2019,Summer,03:00:00 AM,0,0,0,partly cloudy night,
2019,Summer,06:00:00 PM,1295,712,583,cloudy,
2019,Fall,06:00:00 PM,67,65,2,clear night,
2019,Winter,01:00:00 AM,0,0,0,partly cloudy night,
2019,Fall,11:00:00 AM,1647,803,844,clear day,Daylight Saving Time ends
2019,Winter,08:00:00 AM,283,103,180,clear day,
2019,Winter,05:00:00 AM,0,0,0,clear night,
2019,Fall,05:00:00 AM,0,0,0,partly cloudy night,
2019,Summer,08:00:00 PM,1003,434,569,partly cloudy day,
2019,Fall,08:00:00 AM,358,133,225,cloudy,
2019,Fall,05:00:00 AM,0,0,0,partly cloudy night,
2019,Summer,12:00:00 PM,1879,846,1033,partly cloudy day,
2019,Fall,08:00:00 PM,72,55,17,cloudy,
2019,Spring,02:00:00 PM,1395,583,812,partly cloudy day,
2019,Winter,10:00:00 AM,319,190,129,cloudy,
2019,Winter,03:00:00 PM,3040,1499,1541,clear day,
2019,Winter,11:00:00 PM,11,3,8,partly cloudy night,
2019,Fall,02:00:00 AM,0,0,0,cloudy,
2019,Fall,11:00:00 AM,1855,789,1066,clear day,
2019,Spring,05:00:00 AM,32,24,8,partly cloudy night,
2019,Winter,06:00:00 PM,7,6,1,rain,
2019,Summer,09:00:00 PM,81,48,33,clear night,
2019,Fall,05:00:00 PM,113,91,22,cloudy,
2019,Summer,09:00:00 AM,284,178,106,rain,
2019,Spring,08:00:00 AM,121,37,84,rain,Cinco de Mayo
2019,Spring,05:00:00 AM,0,0,0,clear night,
2019,Fall,04:00:00 PM,1881,817,1064,partly cloudy day,
2019,Winter,11:00:00 AM,2290,1285,1005,clear day,
2019,Summer,05:00:00 PM,2594,1190,1404,partly cloudy day,
2019,Winter,08:00:00 AM,157,74,83,clear day,
2019,Fall,05:00:00 PM,2243,1081,1162,partly cloudy day,
2019,Summer,06:00:00 AM,152,56,96,clear day,
2019,Spring,05:00:00 AM,0,0,0,clear night,St. Patrick's Day
2019,Spring,05:00:00 AM,0,0,0,clear night,
2019,Fall,10:00:00 AM,1084,590,494,partly cloudy day,
2019,Spring,11:00:00 AM,1390,724,666,cloudy,
2019,Fall,08:00:00 PM,50,40,10,clear night,
2019,Winter,10:00:00 AM,554,313,241,clear day,
2019,Spring,10:00:00 AM,1313,547,766,partly cloudy day,Tax Day
2019,Spring,10:00:00 AM,1911,1094,817,clear day,
2019,Summer,03:00:00 AM,0,0,0,rain,
2019,Summer,09:00:00 AM,847,476,371,partly cloudy day,
2019,Spring,08:00:00 PM,830,311,519,clear day,
2019,Spring,02:00:00 AM,1,0,1,clear night,
2019,Winter,12:00:00 AM,2,1,1,partly cloudy night,
2019,Fall,08:00:00 PM,68,65,3,partly cloudy night,
2019,Summer,04:00:00 AM,0,0,0,rain,
2019,Fall,02:00:00 AM,1,0,1,partly cloudy night,
2019,Fall,05:00:00 PM,2590,1375,1215,partly cloudy day,
2019,Spring,01:00:00 PM,1260,577,683,cloudy,
2019,Winter,06:00:00 PM,9,0,9,rain,
2019,Winter,09:00:00 PM,6,4,2,clear night,
2019,Fall,11:00:00 AM,1400,678,722,partly cloudy day,
2019,Summer,04:00:00 AM,0,0,0,clear night,
2019,Winter,05:00:00 PM,468,196,272,partly cloudy night,
2019,Winter,08:00:00 PM,57,54,3,clear night,Valentine's Day
2019,Summer,05:00:00 PM,1936,1033,903,clear day,
2019,Summer,09:00:00 PM,56,32,24,partly cloudy night,
2019,Fall,10:00:00 PM,38,35,3,partly cloudy night,
2019,Fall,12:00:00 AM,0,0,0,cloudy,
2019,Summer,11:00:00 AM,2015,926,1089,partly cloudy day,
2019,Spring,06:00:00 PM,535,214,321,clear night,
2019,Summer,03:00:00 PM,2559,1107,1452,cloudy,
2019,Fall,12:00:00 PM,1944,886,1058,cloudy,
2019,Spring,06:00:00 PM,2296,1099,1197,partly cloudy day,Memorial Day
2019,Winter,07:00:00 PM,8,7,1,clear night,
2019,Summer,11:00:00 AM,1724,871,853,partly cloudy day,
2019,Spring,09:00:00 AM,1219,591,628,clear day,
2019,Fall,06:00:00 PM,1972,807,1165,partly cloudy day,
2019,Spring,02:00:00 PM,1334,601,733,clear day,
2019,Summer,04:00:00 AM,0,0,0,clear night,
2019,Winter,02:00:00 AM,0,0,0,clear night,
2019,Summer,10:00:00 AM,1275,784,491,partly cloudy day,Independence Day
2019,Summer,07:00:00 AM,36,17,19,rain,
2019,Spring,04:00:00 AM,0,0,0,cloudy,
2019,Spring,12:00:00 PM,2362,1056,1306,partly cloudy day,
2019,Summer,01:00:00 PM,1416,680,736,partly cloudy day,
2019,Winter,02:00:00 AM,0,0,0,rain,
2019,Summer,12:00:00 AM,1,0,1,partly cloudy night,
2019,Fall,07:00:00 AM,263,108,155,partly cloudy day,
2019,Spring,07:00:00 AM,215,94,121,clear day,
2019,Winter,10:00:00 AM,275,130,145,partly cloudy day,Martin Luther King Jr. Day
2019,Winter,03:00:00 AM,0,0,0,clear night,
2019,Summer,01:00:00 PM,1989,842,1147,cloudy,
2019,Summer,11:00:00 AM,1947,915,1032,partly cloudy day,
2019,Summer,06:00:00 PM,1909,1022,887,partly cloudy day,
2019,Fall,02:00:00 AM,0,0,0,clear night,
2019,Summer,07:00:00 PM,1174,638,536,rain,
2019,Spring,10:00:00 AM,1659,925,734,partly cloudy day,
2019,Spring,07:00:00 AM,299,124,175,cloudy,
2019,Spring,08:00:00 AM,304,172,132,cloudy,
2019,Spring,11:00:00 PM,1,0,1,clear night,
2019,Fall,08:00:00 AM,482,267,215,partly cloudy day,
2019,Summer,10:00:00 AM,1134,649,485,clear day,
2019,Spring,09:00:00 AM,453,270,183,partly cloudy day,St. Patrick's Day
2019,Summer,12:00:00 AM,1,0,1,partly cloudy night,
2019,Spring,12:00:00 AM,16,14,2,cloudy,
2019,Spring,06:00:00 AM,200,91,109,clear night,
2019,Summer,02:00:00 AM,1,0,1,partly cloudy night,
2019,Fall,11:00:00 AM,1247,573,674,clear day,
2019,Summer,01:00:00 AM,1,0,1,partly cloudy night,
2019,Summer,08:00:00 AM,496,271,225,clear day,
2019,Spring,10:00:00 PM,30,27,3,rain,
2019,Spring,08:00:00 AM,266,97,169,cloudy,
2019,Winter,08:00:00 AM,28,13,15,rain,
2019,Spring,01:00:00 AM,0,0,0,clear night,
2019,Fall,10:00:00 AM,1265,734,531,clear day,
2019,Fall,01:00:00 AM,1,0,1,clear night,
2019,Spring,01:00:00 AM,0,0,0,cloudy,
2019,Fall,05:00:00 PM,2323,1126,1197,partly cloudy day,
2019,Spring,07:00:00 PM,835,461,374,partly cloudy day,
2019,Summer,05:00:00 AM,42,30,12,partly cloudy night,
2019,Winter,06:00:00 PM,0,0,0,cloudy,
2019,Fall,01:00:00 PM,2667,1059,1608,cloudy,
2019,Summer,12:00:00 AM,6,5,1,rain,
2019,Fall,12:00:00 PM,1884,879,1005,partly cloudy day,
2019,Spring,06:00:00 AM,8,6,2,partly cloudy night,
2019,Summer,05:00:00 AM,44,30,14,partly cloudy night,
2019,Fall,01:00:00 PM,2028,854,1174,clear day,
2019,Fall,11:00:00 PM,17,0,17,clear night,
2019,Winter,02:00:00 PM,1393,655,738,partly cloudy day,Presidents' Day (regional holiday)
2019,Spring,07:00:00 PM,579,273,306,cloudy,
2019,Fall,06:00:00 AM,182,108,74,clear night,
2019,Summer,08:00:00 AM,365,165,200,partly cloudy day,
2019,Fall,09:00:00 AM,589,310,279,clear day,
2019,Winter,03:00:00 AM,3,3,0,clear night,
2019,Fall,12:00:00 AM,9,8,1,cloudy,
2019,Winter,08:00:00 AM,184,76,108,clear day,
2019,Fall,05:00:00 PM,117,90,27,partly cloudy night,
2019,Winter,01:00:00 PM,1303,586,717,clear day,
2019,Fall,02:00:00 PM,1985,884,1101,partly cloudy day,
2019,Winter,06:00:00 PM,160,121,39,cloudy,
2019,Summer,06:00:00 PM,2846,1344,1502,partly cloudy day,
2019,Spring,12:00:00 AM,3,1,2,cloudy,
2019,Fall,12:00:00 AM,4,0,4,cloudy,
2019,Fall,01:00:00 AM,1,0,1,partly cloudy night,
2019,Winter,03:00:00 AM,0,0,0,clear night,
2019,Fall,12:00:00 PM,1795,758,1037,clear day,
2019,Winter,08:00:00 AM,179,108,71,clear day,
2019,Spring,01:00:00 AM,1,0,1,clear night,Easter Monday
2019,Summer,08:00:00 PM,81,42,39,rain,
2019,Fall,09:00:00 AM,656,327,329,clear day,
2019,Fall,05:00:00 PM,165,130,35,clear night,
2019,Fall,10:00:00 AM,253,129,124,rain,
2019,Spring,03:00:00 AM,1,0,1,partly cloudy night,
2019,Summer,02:00:00 PM,1661,742,919,cloudy,
2019,Fall,10:00:00 AM,974,559,415,cloudy,
2019,Summer,12:00:00 PM,1349,594,755,partly cloudy day,
2019,Summer,01:00:00 PM,101,30,71,partly cloudy day,
2019,Fall,05:00:00 PM,2289,986,1303,clear day,
2019,Summer,08:00:00 PM,1431,638,793,partly cloudy day,
2019,Fall,06:00:00 AM,46,39,7,clear night,Black Friday
2019,Spring,06:00:00 PM,492,180,312,rain,Cinco de Mayo
2019,Summer,09:00:00 AM,605,292,313,clear day,
2019,Winter,03:00:00 AM,0,0,0,clear night,
2019,Fall,12:00:00 AM,76,75,1,clear night,
2019,Spring,02:00:00 PM,3046,1280,1766,clear day,
2019,Fall,02:00:00 AM,0,0,0,clear night,
2019,Spring,11:00:00 AM,1385,700,685,clear day,
2019,Spring,12:00:00 AM,12,0,12,cloudy,
2019,Spring,03:00:00 PM,658,295,363,cloudy,
2019,Winter,08:00:00 AM,161,54,107,cloudy,
2019,Summer,04:00:00 PM,2944,1413,1531,partly cloudy day,
2019,Spring,02:00:00 PM,1373,546,827,cloudy,
2019,Winter,03:00:00 PM,787,343,444,clear day,
2019,Spring,12:00:00 PM,3383,1611,1772,cloudy,Easter Sunday
2019,Spring,05:00:00 AM,60,36,24,clear night,
2019,Spring,11:00:00 PM,65,59,6,clear night,
2019,Summer,01:00:00 AM,1,0,1,clear night,
2019,Fall,02:00:00 AM,0,0,0,rain,
2019,Summer,02:00:00 PM,1733,630,1103,partly cloudy day,
2019,Winter,08:00:00 PM,12,10,2,partly cloudy night,
2019,Spring,05:00:00 PM,222,103,119,rain,Mother's Day
2019,Fall,06:00:00 AM,101,57,44,partly cloudy night,
2019,Summer,12:00:00 AM,4,0,4,cloudy,
2019,Summer,07:00:00 AM,250,118,132,partly cloudy day,
2019,Spring,09:00:00 AM,127,62,65,cloudy,
2019,Winter,11:00:00 PM,3,0,3,clear night,
2019,Spring,04:00:00 AM,0,0,0,cloudy,
2019,Winter,10:00:00 AM,855,415,440,cloudy,
2019,Winter,03:00:00 PM,1499,717,782,clear day,
2019,Summer,09:00:00 PM,32,20,12,partly cloudy night,
2019,Summer,05:00:00 PM,2165,1151,1014,partly cloudy day,
2019,Fall,11:00:00 AM,2442,1266,1176,clear day,
2019,Spring,09:00:00 PM,6,6,0,clear night,
2019,Winter,02:00:00 PM,752,378,374,partly cloudy day,
2019,Fall,01:00:00 AM,0,0,0,clear night,
2019,Summer,09:00:00 PM,147,89,58,partly cloudy night,Father's Day
2019,Winter,03:00:00 PM,1122,518,604,clear day,
2019,Fall,04:00:00 PM,1427,691,736,clear day,
2019,Fall,02:00:00 AM,1,0,1,cloudy,Veterans Day
2019,Fall,07:00:00 AM,178,80,98,partly cloudy night,
2019,Spring,10:00:00 PM,10,6,4,partly cloudy night,
2019,Spring,07:00:00 AM,69,35,34,rain,Tax Day
2019,Spring,04:00:00 AM,0,0,0,clear night,
2019,Winter,05:00:00 AM,0,0,0,clear night,
2019,Summer,08:00:00 PM,227,118,109,rain,
2019,Spring,12:00:00 PM,2746,1381,1365,clear day,
2019,Spring,02:00:00 AM,1,0,1,clear night,
2019,Winter,03:00:00 AM,0,0,0,partly cloudy night,
2019,Fall,11:00:00 PM,16,13,3,clear night,
2019,Fall,12:00:00 AM,2,1,1,,
2019,Fall,02:00:00 AM,1,0,1,cloudy,
2019,Summer,11:00:00 PM,46,37,9,partly cloudy night,
2019,Winter,06:00:00 AM,44,26,18,clear night,
2019,Winter,12:00:00 AM,2,0,2,partly cloudy night,
2019,Spring,02:00:00 AM,2,0,2,rain,Mother's Day
2019,Fall,12:00:00 AM,2,0,2,clear night,
2019,Winter,05:00:00 PM,382,223,159,partly cloudy night,
2019,Fall,11:00:00 PM,24,20,4,clear night,
2019,Summer,07:00:00 AM,50,26,24,rain,
2019,Winter,07:00:00 AM,31,21,10,partly cloudy night,Martin Luther King Jr. Day
2019,Winter,08:00:00 AM,249,105,144,clear day,
2019,Summer,08:00:00 PM,1253,593,660,partly cloudy day,
2019,Spring,01:00:00 AM,11,10,1,rain,
2019,Winter,04:00:00 PM,542,250,292,rain,
2019,Winter,08:00:00 PM,5,3,2,clear night,
2019,Spring,09:00:00 PM,6,2,4,cloudy,
2019,Winter,01:00:00 AM,2,1,1,clear night,
2019,Fall,08:00:00 AM,406,144,262,cloudy,
2019,Winter,05:00:00 AM,0,0,0,clear night,
2019,Fall,11:00:00 PM,1,0,1,clear night,
2019,Summer,01:00:00 AM,2,1,1,clear night,
2019,Winter,06:00:00 PM,41,0,41,rain,
2019,Spring,11:00:00 PM,103,103,0,cloudy,
2019,Summer,03:00:00 PM,3373,1600,1773,partly cloudy day,
2019,Spring,01:00:00 PM,2356,1219,1137,cloudy,
2019,Fall,02:00:00 PM,281,145,136,rain,
2019,Spring,10:00:00 PM,25,24,1,partly cloudy night,
2019,Spring,12:00:00 AM,3,2,1,,
2019,Winter,05:00:00 PM,807,334,473,partly cloudy day,
2019,Summer,02:00:00 PM,2888,1258,1630,partly cloudy day,
2019,Summer,06:00:00 AM,207,97,110,partly cloudy day,
2019,Winter,02:00:00 AM,5,3,2,cloudy,
2019,Winter,12:00:00 PM,790,338,452,clear day,
2019,Summer,11:00:00 AM,1654,798,856,partly cloudy day,
2019,Spring,08:00:00 PM,91,56,35,cloudy,
2019,Summer,05:00:00 AM,51,44,7,clear night,
2019,Spring,06:00:00 PM,671,391,280,cloudy,
2019,Fall,01:00:00 PM,2671,1231,1440,partly cloudy day,
2019,Fall,10:00:00 PM,19,18,1,clear night,
2019,Winter,05:00:00 PM,52,0,52,partly cloudy night,
2019,Winter,03:00:00 AM,0,0,0,clear night,
2019,Fall,04:00:00 AM,0,0,0,partly cloudy night,
2019,Summer,09:00:00 AM,72,42,30,rain,
2019,Fall,10:00:00 PM,6,0,6,clear night,
2019,Winter,08:00:00 PM,24,0,24,clear night,
2019,Fall,01:00:00 PM,3371,1338,2033,partly cloudy day,
2019,Winter,04:00:00 PM,2930,1605,1325,cloudy,
2019,Fall,03:00:00 AM,0,0,0,clear night,
2019,Fall,08:00:00 PM,38,0,38,partly cloudy night,
2019,Winter,06:00:00 AM,34,17,17,clear night,
2019,Fall,06:00:00 PM,907,436,471,clear night,
2019,Winter,03:00:00 AM,3,0,3,clear night,
2019,Spring,11:00:00 PM,8,4,4,clear night,
2019,Fall,02:00:00 AM,1,0,1,partly cloudy night,
2019,Spring,08:00:00 AM,309,191,118,partly cloudy day,
2019,Winter,08:00:00 PM,10,10,0,cloudy,
2019,Summer,08:00:00 AM,443,178,265,clear day,
2019,Spring,05:00:00 AM,0,0,0,cloudy,
2019,Winter,05:00:00 PM,1756,748,1008,clear day,
2019,Fall,12:00:00 PM,1411,627,784,partly cloudy day,
2019,Spring,02:00:00 PM,2404,1010,1394,clear day,
2019,Winter,10:00:00 AM,201,95,106,fog,
2019,Fall,12:00:00 PM,1575,719,856,cloudy,
2019,Fall,02:00:00 PM,2089,937,1152,cloudy,
2019,Spring,12:00:00 AM,11,0,11,clear night,
2019,Summer,09:00:00 AM,223,134,89,rain,
2019,Spring,08:00:00 PM,131,80,51,partly cloudy night,
2019,Spring,02:00:00 PM,1704,773,931,cloudy,
2019,Fall,05:00:00 AM,0,0,0,clear night,
2019,Spring,05:00:00 AM,11,9,2,clear night,
2019,Summer,09:00:00 PM,133,65,68,partly cloudy night,
2019,Spring,02:00:00 PM,2695,1314,1381,clear day,
2019,Summer,10:00:00 PM,18,8,10,clear night,
2019,Winter,07:00:00 PM,115,90,25,clear night,
2019,Fall,03:00:00 AM,0,0,0,clear night,
2019,Summer,12:00:00 PM,2870,1292,1578,clear day,
2019,Winter,10:00:00 AM,344,179,165,partly cloudy day,
2019,Fall,09:00:00 AM,818,482,336,clear day,
2019,Summer,11:00:00 AM,1704,912,792,clear day,
2019,Summer,03:00:00 AM,0,0,0,partly cloudy night,
2019,Fall,01:00:00 PM,1277,546,731,cloudy,
2019,Summer,11:00:00 PM,7,5,2,clear night,
2019,Fall,01:00:00 PM,752,308,444,cloudy,
2019,Winter,01:00:00 AM,0,0,0,cloudy,
2019,Fall,08:00:00 AM,747,578,169,partly cloudy day,
2019,Fall,08:00:00 AM,413,164,249,clear day,
2019,Fall,05:00:00 AM,0,0,0,cloudy,
2019,Spring,04:00:00 AM,0,0,0,clear night,
2019,Fall,07:00:00 PM,344,185,159,cloudy,
2019,Winter,04:00:00 AM,1,0,1,cloudy,
2019,Spring,07:00:00 PM,510,245,265,cloudy,
2019,Winter,03:00:00 AM,0,0,0,clear night,
2019,Fall,04:00:00 PM,3064,1299,1765,clear day,
2019,Fall,02:00:00 PM,3208,1348,1860,clear day,
2019,Summer,06:00:00 AM,204,96,108,clear night,
2019,Winter,09:00:00 AM,743,448,295,clear day,
2019,Summer,09:00:00 PM,53,33,20,partly cloudy night,
2019,Winter,08:00:00 AM,228,134,94,clear day,
2019,Summer,06:00:00 PM,1679,1019,660,partly cloudy day,
2019,Winter,02:00:00 AM,6,4,2,rain,
2019,Winter,05:00:00 AM,7,7,0,clear night,
2019,Winter,08:00:00 AM,49,16,33,rain,
2019,Winter,07:00:00 AM,136,64,72,clear night,
2019,Summer,12:00:00 PM,109,59,50,partly cloudy day,
2019,Fall,11:00:00 PM,4,2,2,rain,
2019,Fall,01:00:00 PM,1890,950,940,partly cloudy day,Black Friday
2019,Fall,01:00:00 PM,2579,1121,1458,partly cloudy day,
2019,Summer,04:00:00 PM,2327,1075,1252,partly cloudy day,
2019,Winter,08:00:00 PM,10,9,1,clear night,
2019,Spring,03:00:00 PM,862,450,412,partly cloudy day,
2019,Summer,11:00:00 AM,1726,904,822,clear day,
2019,Summer,06:00:00 PM,2629,1246,1383,partly cloudy day,
2019,Summer,04:00:00 PM,2509,1112,1397,clear day,
2019,Fall,05:00:00 AM,1,0,1,cloudy,
2019,Fall,12:00:00 PM,2087,882,1205,partly cloudy day,
2019,Fall,03:00:00 PM,3325,1434,1891,partly cloudy day,
2019,Spring,02:00:00 PM,2221,1011,1210,cloudy,
2019,Fall,02:00:00 PM,1187,525,662,cloudy,
2019,Winter,02:00:00 AM,0,0,0,cloudy,
2019,Spring,07:00:00 PM,42,29,13,rain,
2019,Winter,01:00:00 AM,1,0,1,clear night,
2019,Fall,05:00:00 PM,2220,1098,1122,partly cloudy day,
2019,Summer,09:00:00 AM,580,306,274,cloudy,
2019,Fall,10:00:00 AM,934,459,475,cloudy,
2019,Fall,11:00:00 AM,2128,984,1144,partly cloudy day,Columbus Day (regional holiday)
2019,Winter,05:00:00 PM,531,242,289,cloudy,
2019,Summer,02:00:00 PM,2238,1033,1205,cloudy,
2019,Fall,03:00:00 PM,864,388,476,cloudy,
2019,Fall,12:00:00 PM,2340,1154,1186,partly cloudy day,
2019,Summer,01:00:00 PM,330,106,224,rain,
2019,Summer,02:00:00 AM,5,1,4,clear night,
2019,Spring,02:00:00 PM,2351,1022,1329,cloudy,
2019,Fall,11:00:00 AM,503,255,248,cloudy,Halloween
2019,Summer,10:00:00 PM,24,10,14,partly cloudy night,
2019,Summer,04:00:00 AM,1,0,1,cloudy,Father's Day
2019,Spring,05:00:00 PM,1574,788,786,cloudy,Tax Day
2019,Spring,11:00:00 PM,61,57,4,cloudy,
2019,Spring,09:00:00 PM,7,1,6,partly cloudy night,
2019,Summer,09:00:00 PM,26,16,10,rain,
2019,Summer,07:00:00 AM,263,115,148,clear day,
2019,Fall,06:00:00 AM,49,22,27,clear night,
2019,Fall,02:00:00 AM,0,0,0,clear night,
2019,Summer,02:00:00 AM,0,0,0,partly cloudy night,
2019,Winter,03:00:00 PM,176,94,82,snow,
2019,Spring,11:00:00 AM,1000,465,535,partly cloudy day,
2019,Winter,08:00:00 AM,0,0,0,clear day,
2019,Fall,03:00:00 PM,1046,451,595,clear day,
2019,Fall,01:00:00 AM,2,0,2,clear night,
2019,Summer,04:00:00 AM,0,0,0,partly cloudy night,
2019,Summer,07:00:00 AM,276,132,144,clear day,
2019,Spring,08:00:00 PM,19,18,1,partly cloudy night,
2019,Winter,12:00:00 AM,1,0,1,clear night,Christmas Day
2019,Spring,10:00:00 PM,11,7,4,partly cloudy night,
2019,Spring,06:00:00 PM,2667,1097,1570,clear day,
2019,Winter,12:00:00 AM,9,3,6,cloudy,
2019,Fall,09:00:00 PM,25,13,12,clear night,
2019,Winter,09:00:00 PM,25,10,15,partly cloudy night,
2019,Fall,06:00:00 PM,159,101,58,rain,
2019,Summer,08:00:00 AM,235,102,133,rain,
2019,Summer,09:00:00 PM,25,10,15,partly cloudy night,
2019,Spring,07:00:00 AM,269,120,149,clear day,
2019,Winter,04:00:00 PM,212,145,67,cloudy,
2019,Winter,05:00:00 AM,1,0,1,cloudy,
2019,Summer,04:00:00 AM,0,0,0,partly cloudy night,
2019,Winter,11:00:00 PM,36,35,1,clear night,Christmas Day
2019,Winter,07:00:00 PM,83,75,8,partly cloudy night,
2019,Summer,05:00:00 PM,1358,717,641,partly cloudy day,
2019,Spring,06:00:00 PM,1465,744,721,partly cloudy day,
2019,Spring,04:00:00 PM,1981,979,1002,clear day,
2019,Fall,07:00:00 AM,337,156,181,clear night,
2019,Summer,02:00:00 PM,3102,1371,1731,partly cloudy day,
2019,Winter,12:00:00 AM,1,0,1,clear night,Christmas Eve
2019,Winter,04:00:00 AM,0,0,0,partly cloudy night,
2019,Fall,10:00:00 AM,1613,866,747,clear day,
2019,Fall,05:00:00 AM,0,0,0,partly cloudy night,
2019,Winter,12:00:00 PM,1011,515,496,cloudy,
2019,Winter,03:00:00 PM,1604,785,819,clear day,
2019,Spring,03:00:00 AM,1,0,1,partly cloudy night,
2019,Fall,09:00:00 AM,559,283,276,partly cloudy day,
2019,Fall,12:00:00 AM,4,3,1,cloudy,
2019,Summer,04:00:00 PM,2806,1225,1581,partly cloudy day,
2019,Winter,06:00:00 PM,72,71,1,rain,
2019,Spring,04:00:00 AM,0,0,0,clear night,
2019,Winter,03:00:00 PM,2644,1186,1458,partly cloudy day,
2019,Fall,12:00:00 AM,0,0,0,cloudy,
2019,Fall,10:00:00 AM,1124,512,612,partly cloudy day,
2019,Fall,02:00:00 PM,3343,1465,1878,partly cloudy day,
2019,Spring,07:00:00 AM,157,66,91,cloudy,
2019,Spring,03:00:00 AM,1,0,1,partly cloudy night,
2019,Spring,02:00:00 PM,1566,672,894,clear day,
2019,Fall,10:00:00 PM,7,2,5,clear night,
2019,Fall,02:00:00 AM,2,0,2,clear night,
2019,Summer,03:00:00 PM,522,263,259,partly cloudy day,
2019,Winter,04:00:00 PM,1612,743,869,partly cloudy day,
2019,Spring,05:00:00 PM,2246,949,1297,clear day,
2019,Fall,09:00:00 PM,5,3,2,cloudy,Thanksgiving Day
2019,Winter,06:00:00 AM,2,0,2,snow,
2019,Summer,03:00:00 AM,1,0,1,cloudy,
2019,Fall,11:00:00 AM,2888,1398,1490,cloudy,
2019,Fall,04:00:00 PM,2353,1046,1307,clear day,
2019,Fall,09:00:00 PM,44,40,4,clear night,
2019,Summer,04:00:00 PM,2104,1081,1023,partly cloudy day,
2019,Spring,09:00:00 PM,21,0,21,clear night,
2019,Summer,02:00:00 PM,2391,973,1418,partly cloudy day,
2019,Fall,11:00:00 PM,52,48,4,clear night,
2019,Winter,05:00:00 PM,89,43,46,fog,
2019,Summer,06:00:00 PM,942,447,495,cloudy,
2019,Spring,03:00:00 AM,0,0,0,clear night,Memorial Day
2019,Summer,10:00:00 AM,977,591,386,partly cloudy day,
2019,Winter,07:00:00 AM,73,34,39,cloudy,
2019,Winter,04:00:00 PM,431,208,223,cloudy,
2019,Fall,02:00:00 AM,3,2,1,partly cloudy night,
2019,Summer,04:00:00 PM,1461,663,798,partly cloudy day,
2019,Fall,02:00:00 AM,2,1,1,clear night,
2019,Summer,01:00:00 AM,3,0,3,partly cloudy night,
2019,Fall,03:00:00 PM,1647,695,952,partly cloudy day,
2019,Fall,12:00:00 AM,0,0,0,partly cloudy night,
2019,Winter,06:00:00 PM,79,48,31,partly cloudy night,New Year's Day
2019,Winter,06:00:00 AM,26,13,13,clear night,
2019,Winter,02:00:00 PM,1375,600,775,clear day,Valentine's Day
2019,Fall,09:00:00 AM,592,314,278,cloudy,
2019,Summer,06:00:00 PM,200,125,75,cloudy,
2019,Summer,02:00:00 AM,0,0,0,clear night,
2019,Summer,02:00:00 AM,1,0,1,partly cloudy night,
2019,Winter,07:00:00 AM,171,85,86,partly cloudy night,
2019,Spring,04:00:00 PM,1963,985,978,partly cloudy day,
2019,Winter,08:00:00 AM,229,89,140,clear day,
2019,Spring,09:00:00 PM,32,19,13,partly cloudy night,Easter Monday
2019,Summer,01:00:00 PM,2228,959,1269,partly cloudy day,
2019,Fall,11:00:00 AM,2799,1319,1480,partly cloudy day,
2019,Fall,03:00:00 AM,0,0,0,cloudy,
2019,Summer,05:00:00 PM,2002,1110,892,partly cloudy day,
2019,Fall,10:00:00 PM,6,0,6,rain,
2019,Winter,09:00:00 AM,220,103,117,clear day,
2019,Winter,06:00:00 PM,0,0,0,partly cloudy night,
2019,Spring,01:00:00 AM,7,5,2,cloudy,Cinco de Mayo
2019,Spring,03:00:00 AM,0,0,0,cloudy,
2019,Winter,04:00:00 PM,2510,1426,1084,clear day,
2019,Spring,11:00:00 PM,2,0,2,cloudy,
2019,Summer,11:00:00 PM,11,7,4,partly cloudy night,
2019,Summer,12:00:00 PM,1335,510,825,cloudy,
2019,Winter,04:00:00 AM,0,0,0,cloudy,Presidents' Day (regional holiday)
2019,Fall,03:00:00 PM,848,475,373,rain,Labor Day
2019,Winter,06:00:00 PM,23,19,4,rain,
2019,Winter,01:00:00 AM,1,0,1,rain,
2019,Winter,06:00:00 AM,15,5,10,clear night,
2019,Spring,08:00:00 PM,19,0,19,clear night,
2019,Summer,12:00:00 AM,38,37,1,clear night,
2019,Fall,09:00:00 PM,7,4,3,clear night,
2019,Spring,03:00:00 PM,1979,850,1129,partly cloudy day,
2019,Summer,07:00:00 PM,1959,1071,888,clear day,
2019,Summer,06:00:00 AM,151,50,101,cloudy,
2019,Winter,08:00:00 AM,221,81,140,partly cloudy day,
2019,Summer,11:00:00 PM,13,6,7,cloudy,
2019,Winter,11:00:00 AM,590,259,331,clear day,
2019,Summer,10:00:00 PM,15,3,12,clear night,
2019,Spring,10:00:00 AM,1004,574,430,cloudy,
2019,Fall,09:00:00 PM,36,32,4,rain,
2019,Winter,05:00:00 PM,99,71,28,clear night,
2019,Spring,08:00:00 AM,330,111,219,clear day,
2019,Summer,05:00:00 PM,2248,992,1256,partly cloudy day,
2019,Winter,11:00:00 PM,16,15,1,rain,
2019,Spring,10:00:00 PM,11,7,4,cloudy,
2019,Winter,06:00:00 AM,16,7,9,cloudy,
2019,Fall,09:00:00 PM,25,20,5,cloudy,
2019,Winter,11:00:00 AM,1182,614,568,clear day,
2019,Winter,11:00:00 PM,31,14,17,cloudy,
2019,Fall,11:00:00 AM,1319,641,678,partly cloudy day,Thanksgiving Day
2019,Winter,09:00:00 AM,88,48,40,rain,
2019,Spring,06:00:00 AM,49,23,26,clear night,
2019,Spring,07:00:00 AM,158,74,84,partly cloudy day,
2019,Fall,02:00:00 PM,2172,873,1299,clear day,
2019,Spring,08:00:00 PM,17,6,11,cloudy,
2019,Summer,04:00:00 PM,2046,1010,1036,partly cloudy day,
2019,Spring,09:00:00 PM,2,0,2,partly cloudy night,
2019,Spring,08:00:00 PM,791,333,458,clear day,
2019,Spring,08:00:00 PM,91,57,34,partly cloudy night,
2019,Winter,05:00:00 AM,0,0,0,clear night,Christmas Day
2019,Winter,03:00:00 PM,873,447,426,clear day,
2019,Summer,03:00:00 AM,0,0,0,cloudy,
2019,Fall,08:00:00 PM,29,27,2,partly cloudy night,
2019,Summer,10:00:00 AM,1047,633,414,partly cloudy day,
2019,Summer,06:00:00 AM,266,116,150,clear day,
2019,Summer,02:00:00 AM,2,1,1,partly cloudy night,
2019,Fall,07:00:00 AM,308,133,175,clear day,
2019,Summer,12:00:00 PM,1361,530,831,cloudy,
2019,Spring,03:00:00 PM,912,472,440,cloudy,Daylight Saving Time starts
2019,Summer,05:00:00 PM,2441,1041,1400,clear day,
2019,Fall,07:00:00 AM,262,141,121,clear night,
2019,Summer,11:00:00 AM,2270,1214,1056,partly cloudy day,
2019,Fall,09:00:00 AM,465,223,242,cloudy,
2019,Fall,04:00:00 PM,2105,921,1184,partly cloudy day,
2019,Summer,10:00:00 PM,21,9,12,clear night,
2019,Summer,11:00:00 AM,2082,1119,963,partly cloudy day,
2019,Spring,08:00:00 PM,379,163,216,clear night,
2019,Winter,12:00:00 PM,3291,1782,1509,cloudy,
2019,Spring,09:00:00 PM,0,0,0,clear night,
2019,Winter,06:00:00 PM,16,10,6,clear night,
2019,Winter,04:00:00 AM,0,0,0,clear night,
2019,Summer,12:00:00 PM,2692,1442,1250,partly cloudy day,
2019,Fall,10:00:00 AM,2009,1055,954,cloudy,
2019,Spring,06:00:00 AM,133,61,72,clear day,
2019,Summer,12:00:00 AM,7,4,3,partly cloudy night,
2019,Winter,02:00:00 AM,1,1,0,clear night,
2019,Summer,10:00:00 AM,1105,660,445,partly cloudy day,
2019,Summer,12:00:00 AM,4,0,4,partly cloudy night,
2019,Fall,05:00:00 PM,155,94,61,clear night,Veterans Day
2019,Spring,09:00:00 AM,1018,635,383,partly cloudy day,
2019,Summer,01:00:00 PM,2524,1139,1385,cloudy,
2019,Winter,03:00:00 PM,1637,728,909,partly cloudy day,
2019,Winter,07:00:00 PM,2,1,1,clear night,
2019,Fall,04:00:00 AM,0,0,0,cloudy,
2019,Fall,01:00:00 PM,2541,982,1559,clear day,
2019,Summer,03:00:00 AM,0,0,0,partly cloudy night,
2019,Spring,02:00:00 PM,947,355,592,cloudy,Easter Monday
2019,Spring,10:00:00 PM,3,2,1,partly cloudy night,
2019,Winter,12:00:00 AM,2,1,1,cloudy,
2019,Summer,05:00:00 AM,47,23,24,cloudy,
2019,Spring,12:00:00 PM,2240,1059,1181,partly cloudy day,
2019,Summer,09:00:00 AM,822,507,315,clear day,
2019,Summer,09:00:00 AM,597,352,245,partly cloudy day,
2019,Spring,03:00:00 PM,1604,768,836,clear day,
2019,Fall,09:00:00 PM,21,18,3,rain,
2019,Summer,03:00:00 PM,1146,566,580,partly cloudy day,
2019,Summer,05:00:00 AM,35,27,8,partly cloudy night,
2019,Spring,04:00:00 AM,0,0,0,partly cloudy night,
2019,Spring,01:00:00 PM,1559,722,837,cloudy,
2019,Winter,07:00:00 AM,149,63,86,cloudy,
2019,Spring,05:00:00 PM,852,386,466,cloudy,
2019,Summer,02:00:00 AM,1,0,1,partly cloudy night,
2019,Spring,01:00:00 AM,0,0,0,clear night,
2019,Spring,07:00:00 AM,208,86,122,partly cloudy day,
2019,Summer,06:00:00 PM,1828,977,851,partly cloudy day,
2019,Winter,07:00:00 PM,16,13,3,clear night,
2019,Summer,10:00:00 PM,60,49,11,cloudy,
2019,Summer,05:00:00 PM,1839,927,912,partly cloudy day,
2019,Spring,10:00:00 AM,1138,687,451,partly cloudy day,
2019,Spring,10:00:00 AM,1175,652,523,partly cloudy day,
2019,Summer,03:00:00 AM,0,0,0,clear night,
2019,Fall,10:00:00 PM,4,3,1,clear night,Black Friday
2019,Spring,08:00:00 AM,540,216,324,clear day,
2019,Summer,08:00:00 AM,252,109,143,cloudy,
2019,Summer,09:00:00 AM,670,327,343,clear day,
2019,Winter,09:00:00 PM,33,31,2,cloudy,
2019,Fall,01:00:00 AM,6,4,2,clear night,
2019,Summer,03:00:00 PM,880,485,395,partly cloudy day,
2019,Spring,07:00:00 PM,48,44,4,clear night,
2019,Fall,09:00:00 AM,401,211,190,partly cloudy day,
2019,Summer,04:00:00 AM,2,0,2,partly cloudy night,
2019,Summer,10:00:00 PM,64,40,24,clear night,
2019,Winter,11:00:00 AM,1942,933,1009,clear day,
2019,Winter,02:00:00 PM,1495,583,912,clear day,
2019,Fall,10:00:00 PM,50,0,50,clear night,
2019,Fall,07:00:00 PM,25,0,25,rain,
2019,Spring,08:00:00 AM,650,290,360,clear day,
2019,Winter,01:00:00 AM,5,3,2,cloudy,
2019,Winter,06:00:00 AM,33,23,10,cloudy,
2019,Spring,06:00:00 PM,1371,687,684,partly cloudy day,
2019,Fall,08:00:00 PM,78,68,10,cloudy,
2019,Spring,08:00:00 PM,5,0,5,snow,
2019,Spring,12:00:00 AM,1,0,1,clear night,
2019,Fall,03:00:00 AM,0,0,0,cloudy,
2019,Fall,10:00:00 AM,1015,626,389,partly cloudy day,
2019,Fall,01:00:00 AM,0,0,0,clear night,
2019,Winter,11:00:00 PM,14,0,14,clear night,
2019,Summer,09:00:00 AM,530,232,298,partly cloudy day,
2019,Fall,11:00:00 PM,0,0,0,clear night,
2019,Winter,06:00:00 PM,58,45,13,cloudy,
2019,Winter,10:00:00 PM,4,1,3,clear night,
2019,Spring,08:00:00 AM,371,144,227,cloudy,
2019,Spring,02:00:00 AM,0,0,0,cloudy,
2019,Summer,06:00:00 AM,174,96,78,clear night,
2019,Summer,02:00:00 AM,1,0,1,clear night,
2019,Fall,07:00:00 AM,171,82,89,clear day,
2019,Fall,12:00:00 AM,6,0,6,cloudy,
2019,Fall,04:00:00 AM,0,0,0,cloudy,
2019,Spring,11:00:00 PM,1,0,1,clear night,
2019,Winter,07:00:00 AM,215,116,99,cloudy,New Year's Eve
2019,Fall,02:00:00 AM,2,0,2,partly cloudy night,
2019,Winter,10:00:00 PM,2,1,1,cloudy,
2019,Winter,09:00:00 AM,354,191,163,cloudy,
2019,Spring,01:00:00 AM,3,1,2,cloudy,
2019,Spring,04:00:00 PM,3661,1605,2056,partly cloudy day,Easter Sunday
2019,Spring,07:00:00 AM,162,72,90,clear night,
2019,Fall,03:00:00 PM,2313,1187,1126,clear day,
2019,Spring,07:00:00 PM,1182,592,590,cloudy,
2019,Spring,08:00:00 AM,449,146,303,partly cloudy day,
2019,Spring,11:00:00 AM,2228,1147,1081,clear day,
2019,Winter,02:00:00 AM,2,1,1,cloudy,
2019,Winter,09:00:00 PM,29,24,5,partly cloudy night,
2019,Summer,08:00:00 PM,224,112,112,partly cloudy night,
2019,Spring,11:00:00 AM,1231,640,591,partly cloudy day,
2019,Fall,03:00:00 AM,2,2,0,partly cloudy night,
2019,Summer,05:00:00 PM,1880,903,977,partly cloudy day,
2019,Spring,01:00:00 AM,3,1,2,cloudy,
2019,Fall,05:00:00 AM,1,0,1,clear night,
2019,Spring,06:00:00 AM,156,62,94,partly cloudy day,
2019,Fall,07:00:00 PM,42,0,42,clear night,
2019,Summer,09:00:00 PM,1,0,1,clear night,
2019,Winter,07:00:00 PM,9,9,0,clear night,
2019,Spring,04:00:00 PM,2741,1287,1454,partly cloudy day,
2019,Summer,10:00:00 AM,619,360,259,rain,
2019,Fall,04:00:00 PM,2336,1077,1259,clear day,Columbus Day (regional holiday)
2019,Summer,06:00:00 PM,1245,654,591,rain,
2019,Summer,06:00:00 AM,178,88,90,partly cloudy night,
2019,Winter,07:00:00 PM,9,8,1,cloudy,
2019,Summer,03:00:00 AM,0,0,0,partly cloudy night,
2019,Winter,07:00:00 PM,115,114,1,cloudy,
2019,Summer,07:00:00 AM,310,132,178,clear day,
2019,Fall,04:00:00 PM,1877,891,986,clear day,
2019,Summer,07:00:00 AM,297,118,179,partly cloudy day,
2019,Winter,07:00:00 PM,41,25,16,partly cloudy night,
2019,Summer,06:00:00 PM,2236,997,1239,partly cloudy day,
2019,Fall,06:00:00 PM,527,279,248,cloudy,
2019,Winter,01:00:00 AM,0,0,0,clear night,
2019,Summer,01:00:00 AM,1,0,1,clear night,
2019,Summer,02:00:00 AM,5,0,5,clear night,
2019,Summer,06:00:00 AM,174,63,111,partly cloudy day,
2019,Winter,07:00:00 AM,145,56,89,partly cloudy night,
2019,Winter,01:00:00 AM,0,0,0,clear night,
2019,Winter,10:00:00 PM,16,15,1,cloudy,
2019,Summer,04:00:00 PM,1083,516,567,clear day,
2019,Spring,04:00:00 AM,0,0,0,partly cloudy night,
2019,Summer,12:00:00 PM,1630,786,844,cloudy,
2019,Summer,09:00:00 AM,642,334,308,partly cloudy day,
2019,Fall,04:00:00 AM,0,0,0,clear night,
2019,Spring,02:00:00 PM,2309,1130,1179,clear day,
2019,Spring,07:00:00 PM,698,288,410,clear day,
2019,Summer,08:00:00 PM,427,212,215,partly cloudy night,
2019,Spring,12:00:00 PM,1322,603,719,clear day,
2019,Summer,04:00:00 AM,3,0,3,partly cloudy night,
2019,Fall,09:00:00 PM,2,1,1,partly cloudy night,
2019,Fall,10:00:00 PM,36,0,36,clear night,
2019,Fall,04:00:00 PM,1688,830,858,cloudy,
2019,Fall,05:00:00 AM,1,0,1,clear night,
2019,Fall,12:00:00 PM,1846,797,1049,partly cloudy day,
2019,Summer,06:00:00 PM,1511,861,650,cloudy,
2019,Summer,07:00:00 PM,1963,1002,961,partly cloudy day,
2019,Spring,04:00:00 PM,1998,1072,926,clear day,
2019,Spring,06:00:00 AM,31,12,19,rain,
2019,Spring,05:00:00 PM,3127,1423,1704,clear day,
2019,Summer,07:00:00 PM,1453,722,731,partly cloudy day,
2019,Spring,04:00:00 PM,1058,531,527,cloudy,
2019,Fall,12:00:00 PM,1568,675,893,clear day,
2019,Winter,12:00:00 AM,1,0,1,clear night,
2019,Summer,02:00:00 PM,1842,797,1045,partly cloudy day,
2019,Spring,05:00:00 AM,0,0,0,clear night,
2019,Summer,02:00:00 AM,1,0,1,clear night,
2019,Summer,09:00:00 PM,134,89,45,clear night,
2019,Spring,01:00:00 PM,2102,940,1162,partly cloudy day,St. Patrick's Day
2019,Winter,04:00:00 AM,0,0,0,rain,
2019,Spring,12:00:00 PM,1321,709,612,cloudy,
2019,Summer,07:00:00 PM,1440,779,661,clear day,
2019,Spring,05:00:00 AM,1,0,1,sleet,Daylight Saving Time starts
2019,Spring,06:00:00 PM,1588,836,752,partly cloudy day,
2019,Spring,12:00:00 AM,5,0,5,cloudy,
2019,Spring,09:00:00 AM,680,362,318,clear day,
2019,Spring,10:00:00 PM,38,17,21,partly cloudy night,
2019,Summer,11:00:00 PM,40,36,4,clear night,
2019,Winter,09:00:00 AM,244,122,122,cloudy,
2019,Spring,03:00:00 PM,1815,831,984,partly cloudy day,
2019,Spring,04:00:00 PM,2082,952,1130,partly cloudy day,
2019,Fall,05:00:00 PM,1807,920,887,cloudy,
2019,Winter,11:00:00 PM,0,0,0,clear night,
2019,Fall,12:00:00 PM,1652,819,833,partly cloudy day,
2019,Winter,02:00:00 PM,949,430,519,cloudy,
2019,Fall,01:00:00 PM,1888,800,1088,partly cloudy day,
2019,Winter,07:00:00 PM,56,50,6,clear night,
2019,Winter,12:00:00 PM,990,990,0,clear day,
2019,Spring,12:00:00 PM,3066,1509,1557,clear day,
2019,Fall,12:00:00 AM,1,0,1,clear night,
2019,Winter,10:00:00 AM,622,622,0,clear day,
2019,Fall,02:00:00 AM,1,0,1,clear night,Black Friday
2019,Winter,09:00:00 AM,419,221,198,partly cloudy day,
2019,Summer,11:00:00 PM,110,91,19,partly cloudy night,
2019,Summer,02:00:00 AM,2,1,1,clear night,
2019,Summer,12:00:00 PM,1886,856,1030,cloudy,
2019,Winter,04:00:00 PM,4012,2012,2000,partly cloudy day,New Year's Day
2019,Winter,03:00:00 AM,0,0,0,partly cloudy night,
2019,Fall,01:00:00 AM,2,1,1,clear night,
2019,Fall,07:00:00 PM,28,23,5,rain,
2019,Summer,07:00:00 PM,863,435,428,cloudy,Father's Day
2019,Fall,07:00:00 AM,88,28,60,cloudy,
2019,Fall,01:00:00 PM,1616,647,969,partly cloudy day,
2019,Winter,06:00:00 AM,21,13,8,cloudy,
2019,Winter,09:00:00 AM,325,181,144,partly cloudy day,
2019,Winter,10:00:00 AM,337,167,170,cloudy,
2019,Spring,02:00:00 AM,0,0,0,partly cloudy night,
2019,Fall,08:00:00 AM,363,136,227,partly cloudy day,
2019,Winter,08:00:00 AM,279,152,127,partly cloudy day,
2019,Winter,04:00:00 AM,1,0,1,clear night,
2019,Fall,09:00:00 PM,49,29,20,clear night,
2019,Winter,09:00:00 PM,0,0,0,clear night,
2019,Winter,10:00:00 PM,10,0,10,cloudy,
2019,Spring,08:00:00 AM,416,145,271,partly cloudy day,
2019,Summer,05:00:00 PM,1194,557,637,rain,
2019,Winter,11:00:00 PM,6,0,6,clear night,
2019,Summer,01:00:00 PM,1654,702,952,clear day,
2019,Fall,02:00:00 AM,0,0,0,clear night,
2019,Fall,09:00:00 AM,820,489,331,partly cloudy day,
2019,Summer,11:00:00 AM,1493,716,777,clear day,
2019,Spring,10:00:00 AM,1101,551,550,cloudy,
2019,Summer,10:00:00 PM,20,14,6,partly cloudy night,
2019,Winter,10:00:00 PM,8,5,3,clear night,Martin Luther King Jr. Day
2019,Spring,09:00:00 PM,8,7,1,clear night,
2019,Summer,08:00:00 PM,722,166,556,partly cloudy night,
2019,Winter,12:00:00 AM,1,0,1,clear night,
2019,Fall,10:00:00 AM,1163,591,572,clear day,
2019,Spring,09:00:00 AM,538,323,215,partly cloudy day,
2019,Spring,07:00:00 PM,2557,1222,1335,partly cloudy day,
2019,Fall,07:00:00 PM,19,17,2,clear night,
2019,Fall,07:00:00 PM,2,0,2,clear night,
2019,Spring,02:00:00 AM,0,0,0,partly cloudy night,
2019,Spring,05:00:00 AM,0,0,0,cloudy,
2019,Fall,10:00:00 AM,1642,959,683,clear day,
2019,Summer,04:00:00 PM,1586,735,851,cloudy,
2019,Summer,07:00:00 AM,179,89,90,partly cloudy day,
2019,Winter,02:00:00 PM,1574,744,830,clear day,
2019,Winter,07:00:00 AM,18,11,7,rain,
2019,Fall,05:00:00 AM,0,0,0,clear night,
2019,Fall,08:00:00 PM,76,60,16,partly cloudy night,
2019,Winter,11:00:00 AM,1715,843,872,rain,
2019,Fall,09:00:00 AM,883,538,345,partly cloudy day,
2019,Fall,09:00:00 PM,54,48,6,partly cloudy night,
2019,Summer,05:00:00 PM,2909,1322,1587,partly cloudy day,
2019,Winter,07:00:00 AM,10,5,5,rain,
2019,Fall,02:00:00 AM,1,0,1,cloudy,Thanksgiving Day
2019,Summer,07:00:00 AM,193,101,92,clear day,
2019,Summer,04:00:00 PM,1751,800,951,partly cloudy day,
2019,Fall,06:00:00 AM,97,62,35,clear night,Veterans Day
2019,Fall,10:00:00 AM,1441,767,674,clear day,
2019,Spring,09:00:00 AM,479,238,241,cloudy,
2019,Spring,08:00:00 PM,11,8,3,rain,
2019,Fall,04:00:00 AM,0,0,0,clear night,
2019,Fall,06:00:00 AM,60,30,30,clear night,
2019,Winter,12:00:00 PM,1920,1137,783,clear day,
2019,Summer,02:00:00 PM,1569,761,808,partly cloudy day,
2019,Winter,07:00:00 AM,136,79,57,cloudy,
2019,Summer,09:00:00 AM,869,594,275,clear day,
2019,Fall,05:00:00 AM,0,0,0,partly cloudy night,
2019,Spring,11:00:00 AM,1596,778,818,clear day,
2019,Spring,12:00:00 PM,2362,1077,1285,clear day,
2019,Spring,04:00:00 PM,3430,1547,1883,partly cloudy day,
2019,Fall,06:00:00 AM,56,37,19,partly cloudy night,
2019,Summer,06:00:00 PM,2525,1281,1244,partly cloudy day,
2019,Summer,07:00:00 PM,2032,1018,1014,partly cloudy day,
2019,Summer,05:00:00 AM,29,23,6,clear night,
2019,Fall,07:00:00 PM,1675,772,903,partly cloudy day,
2019,Summer,06:00:00 AM,160,76,84,clear day,
2019,Winter,09:00:00 PM,4,1,3,partly cloudy night,
2019,Spring,06:00:00 AM,41,27,14,clear night,
2019,Spring,11:00:00 AM,1447,636,811,partly cloudy day,
2019,Spring,07:00:00 AM,256,123,133,partly cloudy day,
2019,Winter,07:00:00 AM,178,79,99,clear night,
2019,Summer,07:00:00 AM,236,98,138,clear day,
2019,Winter,06:00:00 AM,22,15,7,cloudy,
2019,Fall,04:00:00 PM,2242,958,1284,partly cloudy day,
2019,Winter,02:00:00 AM,2,1,1,clear night,
2019,Spring,05:00:00 AM,0,0,0,cloudy,
2019,Fall,04:00:00 PM,1137,526,611,partly cloudy day,
2019,Spring,04:00:00 PM,1297,692,605,cloudy,
2019,Fall,06:00:00 AM,99,58,41,partly cloudy night,
2019,Summer,12:00:00 PM,2667,1299,1368,clear day,
2019,Winter,05:00:00 AM,0,0,0,partly cloudy night,
2019,Summer,11:00:00 PM,3,2,1,clear night,
2019,Summer,04:00:00 PM,2618,1130,1488,partly cloudy day,
2019,Winter,02:00:00 PM,997,510,487,partly cloudy day,
2019,Winter,12:00:00 AM,4,1,3,partly cloudy night,
2019,Summer,04:00:00 AM,1,0,1,clear night,
2019,Winter,02:00:00 PM,1532,699,833,cloudy,
2019,Winter,10:00:00 PM,18,0,18,rain,
2019,Fall,05:00:00 AM,0,0,0,clear night,
2019,Winter,11:00:00 AM,1733,717,1016,cloudy,
2019,Fall,06:00:00 AM,167,119,48,clear night,Daylight Saving Time ends
2019,Spring,02:00:00 AM,0,0,0,clear night,
2019,Spring,06:00:00 PM,1470,576,894,clear day,
2019,Fall,01:00:00 AM,0,0,0,clear night,
2019,Spring,02:00:00 AM,0,0,0,partly cloudy night,
2019,Summer,09:00:00 AM,961,562,399,clear day,
2019,Spring,01:00:00 PM,3125,1321,1804,clear day,
2019,Fall,04:00:00 AM,0,0,0,clear night,
2019,Fall,10:00:00 PM,2,0,2,clear night,
2019,Spring,02:00:00 PM,2826,1125,1701,cloudy,
2019,Summer,05:00:00 PM,1623,866,757,clear day,
2019,Winter,03:00:00 PM,964,444,520,rain,
2019,Winter,03:00:00 PM,1738,798,940,clear day,
2019,Spring,01:00:00 AM,1,0,1,cloudy,
2019,Spring,07:00:00 AM,259,136,123,partly cloudy day,
2019,Summer,07:00:00 AM,178,91,87,cloudy,
2019,Spring,11:00:00 PM,3,0,3,cloudy,
2019,Winter,04:00:00 PM,1743,765,978,partly cloudy day,
2019,Summer,12:00:00 AM,11,5,6,clear night,
2019,Winter,09:00:00 PM,29,0,29,clear night,
2019,Winter,03:00:00 AM,2,0,2,cloudy,
2019,Summer,02:00:00 PM,3033,1498,1535,partly cloudy day,
2019,Spring,11:00:00 PM,42,28,14,clear night,
2019,Spring,11:00:00 PM,0,0,0,partly cloudy night,
2019,Spring,04:00:00 AM,0,0,0,partly cloudy night,
2019,Spring,12:00:00 PM,1871,791,1080,cloudy,
2019,Summer,05:00:00 AM,59,39,20,cloudy,
2019,Spring,11:00:00 PM,10,6,4,clear night,
2019,Spring,05:00:00 PM,2513,1135,1378,clear day,
2019,Spring,06:00:00 AM,75,29,46,cloudy,
2019,Summer,09:00:00 AM,550,292,258,partly cloudy day,
2019,Spring,04:00:00 AM,0,0,0,clear night,
2019,Fall,11:00:00 PM,43,0,43,clear night,
2019,Winter,11:00:00 PM,11,3,8,clear night,
2019,Winter,08:00:00 PM,15,14,1,cloudy,
2019,Fall,03:00:00 PM,3291,1458,1833,cloudy,
2019,Fall,10:00:00 AM,1861,1147,714,clear day,
2019,Winter,02:00:00 AM,2,1,1,clear night,
2019,Summer,10:00:00 PM,25,9,16,clear night,
2019,Fall,06:00:00 PM,2761,1318,1443,clear day,
2019,Summer,01:00:00 PM,1774,831,943,rain,
2019,Fall,10:00:00 PM,30,0,30,rain,
2019,Spring,07:00:00 PM,41,40,1,clear night,
2019,Winter,01:00:00 PM,2205,1053,1152,clear day,
2019,Spring,10:00:00 AM,891,539,352,partly cloudy day,
2019,Winter,06:00:00 PM,258,96,162,snow,
2019,Fall,05:00:00 AM,0,0,0,partly cloudy night,
2019,Summer,02:00:00 AM,0,0,0,partly cloudy night,
2019,Spring,05:00:00 PM,2015,1014,1001,clear day,
2019,Spring,11:00:00 PM,17,11,6,cloudy,
2019,Summer,01:00:00 PM,203,114,89,rain,
2019,Fall,02:00:00 PM,1868,863,1005,partly cloudy day,
2019,Summer,06:00:00 PM,1974,1063,911,partly cloudy day,
2019,Winter,07:00:00 AM,139,60,79,clear night,
2019,Winter,04:00:00 PM,820,368,452,clear day,
2019,Winter,07:00:00 PM,90,76,14,partly cloudy night,
2019,Summer,01:00:00 AM,1,0,1,clear night,
2019,Summer,03:00:00 AM,0,0,0,rain,
2019,Fall,01:00:00 AM,0,0,0,clear night,
2019,Fall,07:00:00 PM,77,49,28,cloudy,
2019,Summer,02:00:00 AM,0,0,0,clear night,
2019,Spring,08:00:00 PM,104,70,34,clear night,
2019,Fall,11:00:00 PM,0,0,0,clear night,
2019,Summer,09:00:00 PM,66,57,9,rain,
2019,Winter,08:00:00 PM,95,59,36,cloudy,
2019,Summer,10:00:00 PM,27,15,12,clear night,
2019,Summer,12:00:00 PM,2544,1276,1268,clear day,
2019,Summer,07:00:00 PM,1401,794,607,clear day,
2019,Spring,02:00:00 AM,0,0,0,partly cloudy night,
2019,Winter,04:00:00 PM,810,432,378,cloudy,
2019,Winter,07:00:00 PM,63,58,5,cloudy,
2019,Winter,07:00:00 AM,209,115,94,clear night,
2019,Fall,08:00:00 AM,303,117,186,cloudy,
2019,Spring,11:00:00 AM,2161,976,1185,partly cloudy day,Easter Monday
2019,Winter,02:00:00 PM,3764,2273,1491,clear day,
2019,Winter,03:00:00 PM,978,482,496,clear day,
2019,Spring,04:00:00 PM,1428,681,747,clear day,
2019,Winter,12:00:00 PM,1142,499,643,clear day,
2019,Summer,03:00:00 PM,3599,1518,2081,partly cloudy day,
2019,Winter,02:00:00 PM,1099,469,630,partly cloudy day,
2019,Spring,03:00:00 PM,1935,920,1015,clear day,
2019,Summer,11:00:00 AM,2365,1284,1081,partly cloudy day,
2019,Fall,01:00:00 AM,0,0,0,clear night,
2019,Summer,12:00:00 AM,36,0,36,partly cloudy night,
2019,Spring,02:00:00 PM,1412,690,722,cloudy,
2019,Spring,08:00:00 PM,288,142,146,cloudy,
2019,Fall,02:00:00 AM,1,0,1,partly cloudy night,
2019,Fall,02:00:00 AM,2,0,2,clear night,
2019,Fall,09:00:00 PM,63,48,15,partly cloudy night,
2019,Fall,05:00:00 AM,0,0,0,cloudy,
2019,Summer,01:00:00 AM,0,0,0,clear night,
2019,Fall,11:00:00 PM,2,0,2,cloudy,
2019,Fall,08:00:00 PM,61,52,9,partly cloudy night,
2019,Spring,11:00:00 AM,1591,818,773,cloudy,
2019,Winter,04:00:00 PM,488,229,259,rain,
2019,Spring,08:00:00 AM,612,405,207,partly cloudy day,
2019,Winter,07:00:00 AM,229,148,81,partly cloudy night,
2019,Spring,04:00:00 AM,0,0,0,partly cloudy night,Tax Day
2019,Fall,07:00:00 AM,348,164,184,clear day,
2019,Fall,03:00:00 AM,0,0,0,clear night,
2019,Winter,12:00:00 AM,1,0,1,clear night,
2019,Fall,01:00:00 AM,0,0,0,partly cloudy night,
2019,Spring,07:00:00 AM,96,50,46,clear day,
2019,Summer,02:00:00 AM,0,0,0,clear night,
2019,Spring,02:00:00 PM,1763,875,888,partly cloudy day,
2019,Winter,11:00:00 AM,1298,623,675,cloudy,
2019,Spring,11:00:00 AM,1399,723,676,partly cloudy day,
2019,Winter,12:00:00 AM,1,0,1,clear night,
2019,Fall,10:00:00 PM,39,28,11,clear night,
2019,Fall,01:00:00 AM,1,0,1,clear night,
2019,Fall,09:00:00 AM,848,502,346,cloudy,
2019,Summer,01:00:00 AM,0,0,0,cloudy,
2019,Fall,03:00:00 PM,1472,612,860,cloudy,
2019,Spring,02:00:00 AM,0,0,0,partly cloudy night,
2019,Fall,07:00:00 AM,255,115,140,cloudy,
2019,Winter,11:00:00 PM,5,4,1,partly cloudy night,
2019,Spring,01:00:00 AM,0,0,0,clear night,
2019,Fall,02:00:00 AM,1,0,1,clear night,
2019,Summer,04:00:00 AM,1,0,1,partly cloudy night,
2019,Winter,09:00:00 AM,498,272,226,clear day,
2019,Fall,03:00:00 AM,0,0,0,clear night,Daylight Saving Time ends
2019,Summer,11:00:00 AM,1945,1116,829,partly cloudy day,
2019,Summer,03:00:00 PM,2343,1166,1177,partly cloudy day,
2019,Fall,11:00:00 AM,2266,1168,1098,clear day,
2019,Fall,09:00:00 AM,874,447,427,clear day,
2019,Spring,06:00:00 AM,130,53,77,clear night,
2019,Fall,11:00:00 AM,1876,924,952,clear day,
2019,Spring,02:00:00 PM,2950,1400,1550,clear day,
2019,Summer,10:00:00 AM,1641,983,658,partly cloudy day,
2019,Spring,01:00:00 AM,0,0,0,partly cloudy night,
2019,Spring,07:00:00 AM,40,18,22,rain,
2019,Fall,01:00:00 AM,0,0,0,partly cloudy night,
2019,Winter,07:00:00 AM,81,38,43,clear night,
2019,Winter,02:00:00 AM,4,0,4,rain,
2019,Summer,12:00:00 PM,1599,842,757,cloudy,
2019,Summer,01:00:00 PM,2761,1272,1489,clear day,
2019,Summer,12:00:00 AM,3,2,1,partly cloudy night,
2019,Summer,03:00:00 PM,2370,1066,1304,partly cloudy day,
2019,Winter,01:00:00 PM,1937,890,1047,clear day,
2019,Spring,04:00:00 AM,0,0,0,rain,
2019,Spring,02:00:00 AM,3,0,3,cloudy,
2019,Summer,05:00:00 AM,95,56,39,clear night,
2019,Spring,04:00:00 PM,847,411,436,cloudy,Cinco de Mayo
2019,Spring,12:00:00 AM,8,5,3,clear night,
2019,Spring,01:00:00 PM,2806,1204,1602,clear day,
2019,Fall,12:00:00 AM,0,0,0,clear night,
2019,Winter,08:00:00 AM,213,83,130,clear day,
2019,Spring,02:00:00 AM,0,0,0,clear night,St. Patrick's Day
2019,Fall,07:00:00 AM,374,193,181,partly cloudy night,
2019,Spring,01:00:00 PM,2367,1111,1256,clear day,
2019,Winter,03:00:00 PM,193,81,112,fog,
2019,Fall,02:00:00 AM,1,0,1,partly cloudy night,
2019,Winter,02:00:00 AM,1,0,1,clear night,
2019,Fall,10:00:00 PM,0,0,0,clear night,
2019,Fall,07:00:00 PM,64,0,64,clear night,
2019,Fall,11:00:00 AM,2042,940,1102,cloudy,
2019,Fall,09:00:00 PM,62,51,11,clear night,
2019,Winter,07:00:00 PM,61,0,61,clear night,Christmas Eve
2019,Spring,10:00:00 PM,1,0,1,clear night,
2019,Spring,03:00:00 AM,0,0,0,clear night,
2019,Summer,07:00:00 PM,2329,1201,1128,partly cloudy day,
2019,Fall,10:00:00 PM,33,30,3,partly cloudy night,
2019,Winter,01:00:00 PM,1493,716,777,partly cloudy day,
2019,Summer,04:00:00 PM,2227,1071,1156,partly cloudy day,
2019,Fall,01:00:00 AM,4,2,2,cloudy,
2019,Fall,10:00:00 PM,18,14,4,cloudy,Daylight Saving Time ends
2019,Fall,06:00:00 AM,134,86,48,clear night,
2019,Summer,03:00:00 AM,0,0,0,partly cloudy night,
2019,Fall,08:00:00 PM,25,24,1,rain,
2019,Summer,08:00:00 AM,363,205,158,clear day,
2019,Summer,08:00:00 PM,3,2,1,partly cloudy day,
2019,Fall,03:00:00 AM,0,0,0,cloudy,
2019,Fall,07:00:00 AM,271,125,146,partly cloudy night,
2019,Spring,11:00:00 PM,2,0,2,cloudy,
2019,Summer,10:00:00 PM,45,35,10,partly cloudy night,
2019,Fall,10:00:00 PM,35,13,22,partly cloudy night,
2019,Spring,08:00:00 PM,942,414,528,partly cloudy day,
2019,Summer,09:00:00 PM,57,45,12,rain,
2019,Summer,08:00:00 AM,337,144,193,partly cloudy day,
2019,Fall,11:00:00 AM,1001,448,553,fog,
2019,Fall,09:00:00 AM,621,335,286,partly cloudy day,
2019,Winter,09:00:00 PM,72,44,28,cloudy,
2019,Summer,12:00:00 AM,6,3,3,partly cloudy night,
2019,Winter,10:00:00 AM,441,249,192,partly cloudy day,
2019,Fall,10:00:00 PM,19,16,3,clear night,
2019,Fall,11:00:00 PM,25,21,4,clear night,
2019,Winter,12:00:00 PM,1904,947,957,clear day,
2019,Spring,11:00:00 PM,65,56,9,cloudy,Cinco de Mayo
2019,Fall,08:00:00 PM,11,10,1,clear night,
2019,Winter,09:00:00 AM,357,186,171,clear day,
2019,Spring,11:00:00 PM,5,0,5,rain,
2019,Summer,10:00:00 PM,22,9,13,partly cloudy night,
2019,Fall,12:00:00 PM,1102,482,620,partly cloudy day,
2019,Summer,08:00:00 PM,226,48,178,partly cloudy day,
2019,Summer,08:00:00 AM,368,187,181,cloudy,
2019,Spring,05:00:00 AM,0,0,0,cloudy,
2019,Fall,12:00:00 AM,1,0,1,clear night,
2019,Winter,12:00:00 AM,19,18,1,clear night,
2019,Spring,11:00:00 AM,1826,968,858,clear day,
2019,Spring,11:00:00 AM,2248,1091,1157,clear day,
2019,Spring,09:00:00 AM,583,356,227,partly cloudy day,
2019,Spring,09:00:00 PM,4,3,1,snow,
2019,Spring,04:00:00 AM,0,0,0,clear night,
2019,Spring,04:00:00 PM,2536,1045,1491,partly cloudy day,
2019,Fall,10:00:00 PM,1,0,1,clear night,
2019,Winter,08:00:00 PM,46,43,3,clear night,
2019,Spring,11:00:00 PM,22,18,4,partly cloudy night,
2019,Summer,02:00:00 AM,3,1,2,cloudy,
2019,Summer,11:00:00 PM,71,63,8,clear night,
2019,Spring,06:00:00 PM,348,121,227,partly cloudy night,
2019,Winter,08:00:00 PM,36,33,3,snow,
2019,Fall,01:00:00 AM,1,0,1,clear night,
2019,Fall,09:00:00 PM,13,3,10,partly cloudy night,
2019,Spring,11:00:00 AM,1640,806,834,cloudy,
2019,Winter,12:00:00 AM,30,29,1,clear night,
2019,Summer,05:00:00 PM,2338,1092,1246,partly cloudy day,
2019,Winter,12:00:00 PM,1650,726,924,cloudy,
2019,Summer,05:00:00 AM,37,27,10,partly cloudy night,
2019,Spring,09:00:00 PM,10,0,10,clear night,
2019,Winter,11:00:00 AM,2368,1321,1047,partly cloudy day,New Year's Day
2019,Winter,09:00:00 AM,613,368,245,clear day,Christmas Day
2019,Fall,11:00:00 AM,2941,1498,1443,clear day,
2019,Summer,01:00:00 AM,0,0,0,clear night,
2019,Summer,03:00:00 PM,3638,1557,2081,partly cloudy day,
2019,Summer,02:00:00 PM,264,76,188,rain,
2019,Summer,12:00:00 PM,1823,849,974,partly cloudy day,
2019,Spring,08:00:00 AM,559,211,348,clear day,
2019,Fall,05:00:00 AM,0,0,0,clear night,
2019,Summer,02:00:00 AM,0,0,0,clear night,
2019,Spring,11:00:00 AM,1018,478,540,cloudy,
2019,Winter,12:00:00 AM,34,0,34,clear night,
2019,Spring,04:00:00 AM,1,0,1,clear night,
2019,Spring,04:00:00 PM,1820,955,865,partly cloudy day,
2019,Fall,07:00:00 AM,311,160,151,clear night,
2019,Winter,07:00:00 AM,49,19,30,clear night,
2019,Summer,03:00:00 PM,8,1,7,clear day,Independence Day
2019,Winter,12:00:00 AM,1,0,1,clear night,
2019,Summer,11:00:00 AM,1336,726,610,clear day,
2019,Summer,02:00:00 AM,0,0,0,partly cloudy night,
2019,Spring,01:00:00 AM,0,0,0,clear night,
2019,Winter,07:00:00 AM,80,38,42,cloudy,
2019,Winter,02:00:00 PM,1281,600,681,partly cloudy day,
2019,Winter,06:00:00 PM,68,54,14,partly cloudy night,
2019,Winter,12:00:00 PM,2173,911,1262,clear day,
2019,Winter,02:00:00 AM,6,3,3,clear night,
2019,Spring,03:00:00 PM,1910,869,1041,wind,Tax Day
2019,Summer,02:00:00 AM,1,0,1,clear night,
2019,Summer,06:00:00 PM,2050,1146,904,partly cloudy day,
2019,Fall,02:00:00 PM,1552,709,843,clear day,
2019,Fall,03:00:00 AM,0,0,0,clear night,
2019,Summer,03:00:00 PM,1791,849,942,clear day,
2019,Spring,02:00:00 PM,1984,882,1102,clear day,
2019,Summer,09:00:00 PM,105,80,25,partly cloudy night,
2019,Winter,12:00:00 AM,0,0,0,partly cloudy night,
2019,Winter,09:00:00 PM,1,0,1,cloudy,New Year's Eve
2019,Spring,09:00:00 PM,6,6,0,partly cloudy night,
2019,Spring,12:00:00 AM,0,0,0,cloudy,
2019,Summer,01:00:00 PM,1724,694,1030,cloudy,
2019,Spring,09:00:00 PM,21,11,10,partly cloudy night,
2019,Spring,04:00:00 AM,0,0,0,rain,
2019,Winter,07:00:00 PM,61,0,61,cloudy,
2019,Summer,12:00:00 PM,2111,927,1184,clear day,
2019,Spring,09:00:00 PM,41,21,20,cloudy,
2019,Spring,10:00:00 AM,2126,1376,750,clear day,
2019,Winter,12:00:00 AM,1,0,1,partly cloudy night,
2019,Spring,04:00:00 PM,2565,1137,1428,clear day,
2019,Fall,02:00:00 AM,0,0,0,clear night,
2019,Summer,07:00:00 AM,268,113,155,clear day,
2019,Fall,09:00:00 AM,638,320,318,clear day,
2019,Summer,07:00:00 PM,1459,847,612,partly cloudy day,
2019,Spring,01:00:00 PM,1418,585,833,clear day,
2019,Spring,02:00:00 PM,1334,571,763,clear day,
2019,Summer,01:00:00 AM,2,0,2,clear night,
2019,Summer,10:00:00 PM,19,9,10,partly cloudy night,
2019,Spring,11:00:00 AM,1984,982,1002,cloudy,
2019,Winter,07:00:00 AM,204,107,97,clear night,
2019,Fall,04:00:00 PM,1035,534,501,cloudy,
2019,Fall,05:00:00 AM,1,0,1,partly cloudy night,
2019,Fall,07:00:00 AM,214,102,112,cloudy,
2019,Winter,02:00:00 AM,0,0,0,cloudy,
2019,Winter,02:00:00 AM,0,0,0,clear night,
2019,Summer,05:00:00 AM,9,5,4,clear night,
2019,Summer,01:00:00 AM,4,2,2,clear night,
2019,Summer,12:00:00 AM,19,13,6,cloudy,
2019,Fall,11:00:00 AM,1658,840,818,clear day,
2019,Winter,08:00:00 AM,252,90,162,clear day,
2019,Spring,11:00:00 PM,4,2,2,clear night,
2019,Fall,07:00:00 AM,235,104,131,clear day,
2019,Fall,10:00:00 AM,678,350,328,clear day,
2019,Winter,02:00:00 PM,1919,834,1085,cloudy,
2019,Winter,07:00:00 PM,36,30,6,partly cloudy night,
2019,Winter,04:00:00 AM,0,0,0,cloudy,
2019,Winter,10:00:00 PM,3,0,3,clear night,
2019,Summer,02:00:00 PM,538,255,283,partly cloudy day,
2019,Spring,04:00:00 PM,2081,1013,1068,partly cloudy day,
2019,Summer,07:00:00 PM,748,432,316,rain,
2019,Winter,07:00:00 PM,12,10,2,clear night,
2019,Fall,05:00:00 AM,60,51,9,partly cloudy night,
2019,Fall,10:00:00 PM,59,50,9,clear night,
2019,Spring,12:00:00 PM,1480,676,804,cloudy,
2019,Spring,09:00:00 AM,443,212,231,clear day,
2019,Fall,12:00:00 AM,3,0,3,cloudy,
2019,Fall,07:00:00 AM,240,111,129,clear day,
2019,Spring,11:00:00 PM,19,13,6,clear night,
2019,Fall,05:00:00 PM,2734,1187,1547,cloudy,
2019,Winter,12:00:00 AM,6,5,1,clear night,
2019,Spring,12:00:00 PM,278,114,164,rain,Mother's Day
2019,Summer,02:00:00 AM,6,3,3,partly cloudy night,
2019,Fall,09:00:00 AM,664,379,285,clear day,
2019,Summer,12:00:00 PM,1890,863,1027,partly cloudy day,
2019,Summer,07:00:00 PM,1453,842,611,partly cloudy day,
2019,Winter,12:00:00 PM,1362,675,687,partly cloudy day,
2019,Spring,04:00:00 PM,2993,1349,1644,partly cloudy day,Memorial Day
2019,Winter,02:00:00 PM,2064,965,1099,cloudy,
2019,Winter,08:00:00 PM,31,30,1,clear night,Christmas Eve
2019,Summer,04:00:00 AM,0,0,0,clear night,
2019,Spring,04:00:00 PM,2214,913,1301,clear day,
2019,Spring,06:00:00 AM,215,77,138,partly cloudy day,
2019,Winter,11:00:00 PM,0,0,0,clear night,
2019,Fall,09:00:00 AM,527,303,224,partly cloudy day,
2019,Fall,03:00:00 AM,1,0,1,partly cloudy night,
2019,Winter,05:00:00 PM,119,44,75,clear night,Martin Luther King Jr. Day
2019,Fall,03:00:00 PM,386,179,207,cloudy,
2019,Spring,07:00:00 AM,301,142,159,clear day,
2019,Winter,07:00:00 PM,83,45,38,cloudy,
2019,Spring,10:00:00 AM,823,360,463,cloudy,
2019,Fall,09:00:00 AM,551,315,236,partly cloudy day,
2019,Summer,04:00:00 AM,0,0,0,partly cloudy night,
2019,Summer,10:00:00 PM,90,65,25,clear night,
2019,Fall,03:00:00 PM,1970,899,1071,partly cloudy day,
2019,Winter,12:00:00 PM,913,432,481,partly cloudy day,
2019,Fall,11:00:00 PM,20,20,0,clear night,
2019,Spring,04:00:00 PM,2194,1059,1135,partly cloudy day,
2019,Summer,09:00:00 AM,589,296,293,clear day,
2019,Fall,11:00:00 AM,1962,939,1023,clear day,
2019,Summer,03:00:00 PM,2080,908,1172,partly cloudy day,
2019,Winter,03:00:00 AM,0,0,0,clear night,
2019,Spring,02:00:00 PM,1883,832,1051,clear day,
2019,Summer,07:00:00 AM,171,51,120,rain,
2019,Fall,03:00:00 PM,2656,1176,1480,partly cloudy day,
2019,Fall,08:00:00 AM,359,205,154,clear day,
2019,Fall,09:00:00 AM,1086,654,432,partly cloudy day,
2019,Summer,10:00:00 PM,54,46,8,clear night,Independence Day
2019,Fall,12:00:00 AM,1,0,1,cloudy,
2019,Summer,07:00:00 PM,1690,979,711,partly cloudy day,
2019,Fall,01:00:00 PM,2111,965,1146,clear day,
2019,Winter,06:00:00 AM,21,16,5,clear night,
2019,Summer,12:00:00 PM,2106,910,1196,partly cloudy day,
2019,Winter,07:00:00 PM,90,88,2,clear night,
2019,Fall,04:00:00 AM,0,0,0,partly cloudy night,
2019,Summer,12:00:00 AM,6,4,2,partly cloudy night,
2019,Spring,12:00:00 AM,58,50,8,partly cloudy night,
2019,Fall,12:00:00 PM,1554,618,936,partly cloudy day,
2019,Fall,10:00:00 PM,20,0,20,rain,
2019,Winter,04:00:00 PM,1869,960,909,clear day,
2019,Summer,05:00:00 PM,1313,728,585,partly cloudy day,
2019,Winter,06:00:00 PM,6,0,6,clear night,
2019,Winter,07:00:00 AM,120,48,72,cloudy,
2019,Fall,11:00:00 AM,1687,750,937,clear day,
2019,Fall,10:00:00 AM,1064,629,435,cloudy,
2019,Fall,01:00:00 AM,1,0,1,partly cloudy night,
2019,Spring,09:00:00 AM,655,368,287,clear day,
2019,Spring,09:00:00 AM,536,279,257,cloudy,
2019,Fall,12:00:00 AM,16,14,2,clear night,
2019,Winter,04:00:00 PM,1550,483,1067,clear day,
2019,Spring,07:00:00 PM,1060,566,494,partly cloudy day,
2019,Summer,11:00:00 AM,1791,884,907,clear day,
2019,Fall,08:00:00 PM,66,58,8,clear night,
2019,Spring,12:00:00 AM,2,1,1,cloudy,
2019,Spring,08:00:00 PM,2,1,1,partly cloudy night,
2019,Winter,07:00:00 AM,153,72,81,partly cloudy night,
2019,Fall,03:00:00 PM,1331,606,725,cloudy,
2019,Spring,11:00:00 AM,1730,892,838,cloudy,
2019,Summer,07:00:00 AM,242,122,120,clear day,
2019,Spring,08:00:00 PM,686,296,390,partly cloudy day,
2019,Fall,10:00:00 AM,981,545,436,cloudy,
2019,Fall,04:00:00 PM,206,93,113,rain,
2019,Winter,05:00:00 AM,0,0,0,partly cloudy night,
2019,Spring,12:00:00 AM,28,27,1,cloudy,
2019,Fall,06:00:00 PM,4,3,1,partly cloudy night,Daylight Saving Time ends
2019,Spring,05:00:00 AM,1,0,1,cloudy,
2019,Fall,03:00:00 PM,2133,1068,1065,clear day,Veterans Day
2019,Spring,09:00:00 PM,3,1,2,cloudy,
2019,Fall,10:00:00 PM,38,35,3,clear night,
2019,Fall,07:00:00 PM,68,62,6,clear night,
2019,Fall,09:00:00 AM,955,501,454,clear day,
2019,Spring,04:00:00 PM,1787,849,938,clear day,
2019,Spring,08:00:00 PM,277,148,129,cloudy,
2019,Winter,10:00:00 AM,458,297,161,clear day,
2019,Winter,09:00:00 AM,70,41,29,rain,
2019,Winter,03:00:00 PM,775,392,383,partly cloudy day,
2019,Spring,10:00:00 PM,51,14,37,partly cloudy night,
2019,Spring,01:00:00 AM,1,0,1,clear night,
2019,Fall,11:00:00 AM,1520,741,779,partly cloudy day,
2019,Summer,10:00:00 AM,1650,1002,648,partly cloudy day,
2019,Summer,12:00:00 PM,1766,839,927,clear day,
2019,Fall,02:00:00 AM,2,0,2,clear night,
2019,Summer,05:00:00 PM,1632,784,848,partly cloudy day,
2019,Summer,06:00:00 AM,147,74,73,partly cloudy day,
2019,Spring,03:00:00 PM,1834,789,1045,partly cloudy day,
2019,Spring,08:00:00 AM,416,194,222,cloudy,
2019,Fall,10:00:00 AM,1914,1139,775,partly cloudy day,
2019,Spring,07:00:00 PM,1827,683,1144,cloudy,
2019,Summer,07:00:00 PM,2331,1118,1213,clear day,
2019,Spring,08:00:00 PM,1104,492,612,clear day,
2019,Fall,05:00:00 PM,1313,659,654,partly cloudy day,Labor Day
2019,Summer,06:00:00 PM,2602,1314,1288,partly cloudy day,
2019,Fall,06:00:00 PM,658,334,324,partly cloudy night,
2019,Fall,05:00:00 AM,0,0,0,partly cloudy night,
2019,Spring,08:00:00 PM,1164,433,731,clear day,
2019,Spring,10:00:00 AM,1706,1031,675,cloudy,
2019,Winter,03:00:00 AM,1,0,1,clear night,
2019,Spring,10:00:00 AM,591,338,253,rain,
2019,Spring,10:00:00 PM,7,0,7,rain,
2019,Summer,08:00:00 AM,341,184,157,clear day,Independence Day
2019,Summer,10:00:00 AM,2037,1162,875,clear day,
2019,Spring,01:00:00 AM,1,1,0,clear night,
2019,Winter,08:00:00 PM,6,4,2,partly cloudy night,
2019,Spring,05:00:00 PM,735,300,435,cloudy,Daylight Saving Time starts
2019,Fall,07:00:00 PM,8,4,4,clear night,
2019,Winter,06:00:00 PM,191,82,109,cloudy,
2019,Fall,05:00:00 AM,0,0,0,cloudy,
2019,Fall,06:00:00 AM,58,42,16,clear night,
2019,Winter,09:00:00 AM,1063,678,385,cloudy,
2019,Summer,06:00:00 PM,1969,1176,793,partly cloudy day,
2019,Spring,12:00:00 AM,0,0,0,partly cloudy night,
2019,Winter,04:00:00 AM,0,0,0,clear night,
2019,Summer,01:00:00 PM,1675,716,959,partly cloudy day,
2019,Fall,07:00:00 PM,18,17,1,clear night,
2019,Spring,07:00:00 AM,169,77,92,partly cloudy day,
2019,Fall,05:00:00 PM,1575,818,757,clear day,
2019,Fall,05:00:00 AM,1,0,1,cloudy,
2019,Summer,03:00:00 AM,1,0,1,partly cloudy night,
2019,Summer,10:00:00 PM,45,0,45,rain,
2019,Spring,01:00:00 PM,1849,801,1048,cloudy,
2019,Spring,05:00:00 PM,1956,1064,892,clear day,
2019,Summer,11:00:00 PM,18,8,10,clear night,
2019,Spring,12:00:00 AM,8,6,2,cloudy,
2019,Fall,01:00:00 PM,1358,560,798,partly cloudy day,
2019,Fall,04:00:00 PM,477,225,252,rain,
2019,Fall,03:00:00 PM,1741,774,967,partly cloudy day,
2019,Spring,01:00:00 PM,1948,825,1123,cloudy,
2019,Summer,01:00:00 PM,675,291,384,cloudy,
2019,Summer,07:00:00 PM,1765,850,915,partly cloudy day,
2019,Spring,07:00:00 PM,55,25,30,cloudy,
2019,Summer,05:00:00 AM,107,68,39,partly cloudy night,
2019,Fall,01:00:00 AM,2,0,2,clear night,
2019,Fall,02:00:00 PM,318,181,137,rain,
2019,Spring,05:00:00 AM,0,0,0,clear night,
2019,Spring,08:00:00 PM,259,130,129,cloudy,
2019,Winter,11:00:00 AM,896,461,435,cloudy,
2019,Winter,03:00:00 AM,1,0,1,rain,
2019,Summer,03:00:00 AM,0,0,0,cloudy,
2019,Summer,01:00:00 AM,0,0,0,clear night,
2019,Spring,10:00:00 AM,1343,810,533,cloudy,
2019,Spring,07:00:00 PM,1371,709,662,clear day,
2019,Winter,04:00:00 AM,6,6,0,clear night,
2019,Summer,01:00:00 PM,3117,1475,1642,partly cloudy day,
2019,Summer,06:00:00 PM,1343,697,646,cloudy,
2019,Fall,08:00:00 PM,3,0,3,clear night,
2019,Spring,10:00:00 PM,7,6,1,clear night,
2019,Winter,03:00:00 AM,0,0,0,clear night,
2019,Fall,01:00:00 AM,10,0,10,cloudy,
2019,Winter,04:00:00 AM,0,0,0,cloudy,
2019,Fall,11:00:00 AM,921,445,476,cloudy,
2019,Fall,12:00:00 AM,1,0,1,clear night,
2019,Fall,06:00:00 PM,82,81,1,clear night,
2019,Winter,07:00:00 PM,36,32,4,clear night,
2019,Spring,05:00:00 AM,0,0,0,partly cloudy night,
2019,Winter,11:00:00 AM,656,319,337,cloudy,
2019,Spring,05:00:00 AM,11,4,7,cloudy,
2019,Fall,05:00:00 PM,2080,1103,977,partly cloudy day,
2019,Fall,02:00:00 AM,0,0,0,clear night,
2019,Spring,08:00:00 AM,577,244,333,clear day,
2019,Spring,05:00:00 PM,640,348,292,partly cloudy day,
2019,Winter,03:00:00 PM,2329,1072,1257,clear day,
2019,Spring,05:00:00 AM,0,0,0,cloudy,
2019,Winter,02:00:00 AM,0,0,0,partly cloudy night,Martin Luther King Jr. Day
2019,Winter,11:00:00 AM,811,408,403,partly cloudy day,
2019,Summer,11:00:00 AM,943,482,461,rain,
2019,Fall,07:00:00 AM,271,110,161,clear night,
2019,Spring,02:00:00 PM,1487,674,813,cloudy,
2019,Summer,01:00:00 PM,2685,1250,1435,clear day,
2019,Spring,08:00:00 PM,259,87,172,partly cloudy night,
2019,Summer,04:00:00 PM,1852,943,909,partly cloudy day,
2019,Winter,11:00:00 PM,1,0,1,clear night,
2019,Spring,05:00:00 PM,1995,851,1144,clear day,St. Patrick's Day
2019,Fall,10:00:00 AM,1560,887,673,partly cloudy day,
2019,Fall,01:00:00 PM,2577,1174,1403,partly cloudy day,
2019,Fall,01:00:00 AM,2,1,1,rain,
2019,Spring,03:00:00 AM,0,0,0,cloudy,
2019,Spring,08:00:00 AM,326,175,151,cloudy,
2019,Summer,05:00:00 PM,2191,1156,1035,clear day,
2019,Fall,10:00:00 AM,1671,897,774,clear day,
2019,Summer,08:00:00 PM,317,143,174,partly cloudy night,
2019,Winter,05:00:00 AM,0,0,0,rain,Presidents' Day (regional holiday)
2019,Fall,08:00:00 PM,84,67,17,partly cloudy night,
2019,Summer,10:00:00 AM,990,581,409,partly cloudy day,
2019,Summer,12:00:00 AM,8,3,5,clear night,
2019,Fall,09:00:00 PM,2,1,1,clear night,
2019,Summer,01:00:00 AM,4,0,4,rain,
2019,Spring,02:00:00 PM,1710,760,950,clear day,
2019,Summer,03:00:00 AM,0,0,0,clear night,Independence Day
2019,Winter,01:00:00 AM,0,0,0,partly cloudy night,
2019,Spring,10:00:00 AM,840,427,413,clear day,
2019,Spring,05:00:00 PM,273,151,122,rain,
2019,Fall,09:00:00 PM,44,36,8,partly cloudy night,
2019,Summer,12:00:00 AM,23,10,13,clear night,
2019,Fall,07:00:00 PM,66,65,1,clear night,
2019,Winter,03:00:00 AM,1,0,1,rain,
2019,Spring,05:00:00 AM,42,29,13,clear night,
2019,Fall,02:00:00 PM,778,304,474,cloudy,
2019,Spring,03:00:00 PM,2936,1296,1640,partly cloudy day,
2019,Fall,03:00:00 PM,1075,600,475,cloudy,
2019,Spring,06:00:00 AM,78,39,39,clear night,
2019,Winter,04:00:00 PM,1521,614,907,clear day,
2019,Spring,08:00:00 PM,8,2,6,partly cloudy night,
2019,Fall,06:00:00 AM,208,119,89,clear night,
2019,Fall,05:00:00 PM,2384,1149,1235,partly cloudy day,
2019,Winter,04:00:00 PM,466,208,258,cloudy,
2019,Fall,10:00:00 AM,1047,592,455,clear day,Veterans Day
2019,Winter,03:00:00 PM,912,423,489,cloudy,
2019,Summer,05:00:00 AM,12,3,9,partly cloudy night,
2019,Fall,04:00:00 AM,2,0,2,clear night,
2019,Summer,10:00:00 AM,1209,614,595,partly cloudy day,
2019,Summer,05:00:00 AM,75,62,13,partly cloudy night,
2019,Spring,08:00:00 PM,113,47,66,cloudy,
2019,Winter,08:00:00 PM,77,58,19,partly cloudy night,
2019,Summer,02:00:00 PM,2336,997,1339,partly cloudy day,
2019,Winter,10:00:00 PM,62,60,2,clear night,
2019,Winter,12:00:00 PM,2047,1049,998,clear day,
2019,Spring,08:00:00 PM,365,161,204,partly cloudy day,
2019,Spring,10:00:00 AM,699,393,306,clear day,
2019,Winter,05:00:00 AM,0,0,0,cloudy,
2019,Fall,04:00:00 PM,1103,478,625,rain,Halloween
2019,Fall,07:00:00 PM,35,30,5,partly cloudy night,
2019,Spring,07:00:00 PM,903,473,430,partly cloudy day,
2019,Winter,03:00:00 PM,268,135,133,partly cloudy day,Martin Luther King Jr. Day
2019,Spring,10:00:00 PM,1,0,1,fog,Daylight Saving Time starts
2019,Winter,08:00:00 PM,27,25,2,clear night,
2019,Spring,07:00:00 AM,197,90,107,clear day,
2019,Summer,11:00:00 PM,30,27,3,clear night,
2019,Fall,12:00:00 PM,958,423,535,cloudy,
2019,Fall,06:00:00 AM,208,111,97,partly cloudy night,
2019,Summer,09:00:00 PM,38,17,21,partly cloudy night,
2019,Summer,10:00:00 AM,803,425,378,clear day,
2019,Spring,05:00:00 AM,7,4,3,clear night,
2019,Summer,03:00:00 AM,0,0,0,partly cloudy night,
2019,Summer,04:00:00 AM,0,0,0,cloudy,
2019,Spring,07:00:00 PM,1391,574,817,partly cloudy day,
2019,Spring,09:00:00 PM,16,15,1,partly cloudy night,
2019,Summer,04:00:00 PM,1401,612,789,cloudy,
2019,Fall,11:00:00 PM,14,13,1,cloudy,Halloween
2019,Summer,09:00:00 AM,716,380,336,clear day,
2019,Winter,03:00:00 PM,782,362,420,cloudy,
2019,Fall,02:00:00 AM,0,0,0,cloudy,
2019,Fall,08:00:00 PM,56,54,2,partly cloudy night,
2019,Spring,05:00:00 AM,0,0,0,partly cloudy night,
2019,Winter,04:00:00 PM,823,351,472,snow,
2019,Winter,03:00:00 AM,0,0,0,cloudy,
2019,Spring,01:00:00 AM,0,0,0,cloudy,
2019,Summer,01:00:00 AM,5,1,4,clear night,
2019,Winter,02:00:00 AM,1,0,1,partly cloudy night,
2019,Winter,10:00:00 PM,25,22,3,clear night,
2019,Summer,02:00:00 PM,2547,1120,1427,partly cloudy day,
2019,Summer,10:00:00 PM,18,12,6,cloudy,
2019,Fall,04:00:00 PM,2022,863,1159,partly cloudy day,
2019,Winter,03:00:00 PM,1483,715,768,cloudy,
2019,Summer,05:00:00 AM,39,23,16,cloudy,
2019,Fall,03:00:00 AM,1,0,1,clear night,
2019,Fall,11:00:00 PM,38,0,38,clear night,
2019,Summer,04:00:00 AM,0,0,0,clear night,
2019,Spring,07:00:00 AM,291,138,153,clear day,
2019,Fall,02:00:00 AM,0,0,0,cloudy,
2019,Spring,09:00:00 PM,15,10,5,rain,
2019,Spring,08:00:00 AM,86,55,31,cloudy,
2019,Spring,06:00:00 PM,1330,557,773,cloudy,
2019,Winter,08:00:00 AM,119,54,65,cloudy,
2019,Summer,10:00:00 PM,107,104,3,partly cloudy night,
2019,Winter,04:00:00 AM,0,0,0,clear night,
2019,Winter,07:00:00 PM,340,304,36,rain,
2019,Spring,03:00:00 AM,0,0,0,clear night,
2019,Winter,01:00:00 PM,1056,1056,0,clear day,
2019,Fall,03:00:00 AM,1,0,1,cloudy,Columbus Day (regional holiday)
2019,Spring,10:00:00 AM,1190,636,554,partly cloudy day,
2019,Summer,10:00:00 PM,49,31,18,partly cloudy night,
2019,Spring,10:00:00 PM,22,0,22,partly cloudy night,
2019,Spring,08:00:00 AM,445,241,204,partly cloudy day,
2019,Winter,02:00:00 AM,1,0,1,partly cloudy night,
2019,Winter,10:00:00 PM,4,2,2,cloudy,
2019,Spring,01:00:00 AM,0,0,0,clear night,
2019,Winter,04:00:00 PM,1385,619,766,cloudy,
2019,Spring,03:00:00 PM,2546,1138,1408,partly cloudy day,
2019,Summer,12:00:00 PM,1884,954,930,partly cloudy day,
2019,Fall,06:00:00 PM,1586,707,879,clear day,Columbus Day (regional holiday)
2019,Summer,06:00:00 PM,2081,991,1090,clear day,
2019,Spring,02:00:00 PM,1800,807,993,partly cloudy day,
2019,Fall,11:00:00 PM,2,0,2,partly cloudy night,
2019,Spring,03:00:00 PM,1055,475,580,cloudy,
2019,Fall,03:00:00 PM,2146,979,1167,cloudy,
2019,Summer,11:00:00 PM,30,12,18,cloudy,
2019,Winter,05:00:00 PM,1544,703,841,partly cloudy day,
2019,Fall,05:00:00 AM,0,0,0,clear night,Black Friday
2019,Winter,08:00:00 AM,235,88,147,partly cloudy day,
2019,Spring,08:00:00 AM,506,196,310,partly cloudy day,
2019,Winter,04:00:00 AM,0,0,0,partly cloudy night,
2019,Spring,06:00:00 PM,1296,773,523,clear day,
2019,Spring,01:00:00 PM,1519,790,729,cloudy,
2019,Spring,03:00:00 AM,2,1,1,partly cloudy night,Easter Sunday
2019,Summer,01:00:00 PM,2219,965,1254,partly cloudy day,
2019,Fall,09:00:00 AM,191,93,98,rain,
2019,Fall,04:00:00 AM,0,0,0,partly cloudy night,Labor Day
2019,Summer,04:00:00 AM,0,0,0,clear night,
2019,Summer,01:00:00 PM,1205,471,734,cloudy,
2019,Spring,06:00:00 PM,1136,606,530,partly cloudy day,
2019,Winter,09:00:00 AM,462,228,234,cloudy,
2019,Spring,07:00:00 AM,183,76,107,clear day,
2019,Winter,01:00:00 AM,1,0,1,clear night,
2019,Spring,06:00:00 PM,2838,1170,1668,partly cloudy day,Easter Sunday
2019,Summer,05:00:00 PM,1325,669,656,cloudy,
2019,Winter,10:00:00 AM,1328,753,575,clear day,Christmas Eve
2019,Fall,05:00:00 AM,1,0,1,cloudy,
2019,Spring,03:00:00 PM,819,382,437,rain,
2019,Spring,06:00:00 AM,29,16,13,partly cloudy night,
2019,Summer,04:00:00 AM,0,0,0,clear night,
2019,Summer,02:00:00 PM,1802,863,939,partly cloudy day,
2019,Spring,08:00:00 AM,507,287,220,clear day,
2019,Winter,09:00:00 PM,13,0,13,partly cloudy night,
2019,Spring,07:00:00 AM,120,76,44,clear night,St. Patrick's Day
2019,Winter,08:00:00 PM,13,7,6,partly cloudy night,
2019,Summer,05:00:00 AM,86,40,46,cloudy,
2019,Winter,03:00:00 AM,0,0,0,clear night,
2019,Summer,12:00:00 AM,1,0,1,partly cloudy night,
2019,Spring,03:00:00 AM,1,0,1,fog,
2019,Winter,04:00:00 AM,0,0,0,clear night,
2019,Fall,10:00:00 PM,5,4,1,cloudy,
2019,Summer,05:00:00 PM,1534,494,1040,partly cloudy day,
2019,Summer,02:00:00 AM,1,0,1,partly cloudy night,
2019,Summer,10:00:00 PM,35,12,23,clear night,
2019,Winter,12:00:00 AM,5,0,5,rain,
2019,Spring,03:00:00 PM,2427,1098,1329,clear day,
2019,Fall,03:00:00 PM,2142,989,1153,partly cloudy day,
2019,Fall,06:00:00 AM,37,16,21,cloudy,
2019,Spring,06:00:00 AM,56,25,31,partly cloudy night,
2019,Summer,02:00:00 PM,1680,739,941,partly cloudy day,
2019,Winter,10:00:00 AM,1019,478,541,partly cloudy day,
2019,Summer,05:00:00 AM,82,54,28,clear night,
2019,Spring,05:00:00 PM,1108,438,670,cloudy,
2019,Fall,03:00:00 AM,0,0,0,clear night,
2019,Fall,01:00:00 PM,2037,945,1092,clear day,
2019,Summer,02:00:00 AM,0,0,0,partly cloudy night,
2019,Fall,06:00:00 PM,20,18,2,clear night,
2019,Spring,09:00:00 AM,953,540,413,partly cloudy day,
2019,Winter,04:00:00 AM,0,0,0,clear night,
2019,Spring,11:00:00 PM,50,48,2,clear night,
2019,Spring,06:00:00 AM,69,41,28,clear night,
2019,Summer,03:00:00 PM,1159,476,683,partly cloudy day,
2019,Spring,02:00:00 PM,875,420,455,cloudy,Daylight Saving Time starts
2019,Fall,03:00:00 AM,0,0,0,rain,
2019,Summer,11:00:00 AM,2618,1492,1126,clear day,
2019,Fall,02:00:00 AM,0,0,0,cloudy,
2019,Summer,04:00:00 PM,2484,1201,1283,partly cloudy day,
2019,Fall,05:00:00 AM,0,0,0,partly cloudy night,Thanksgiving Day
2019,Winter,03:00:00 AM,1,0,1,cloudy,
2019,Spring,07:00:00 PM,322,172,150,cloudy,
2019,Winter,06:00:00 AM,38,18,20,partly cloudy night,
2019,Summer,09:00:00 AM,531,298,233,partly cloudy day,
2019,Summer,05:00:00 PM,2209,1066,1143,partly cloudy day,
2019,Winter,08:00:00 AM,138,63,75,rain,
2019,Summer,11:00:00 PM,48,39,9,partly cloudy night,
2019,Fall,03:00:00 PM,2063,997,1066,clear day,
2019,Winter,12:00:00 PM,1207,624,583,partly cloudy day,
2019,Spring,01:00:00 PM,2685,1279,1406,clear day,
2019,Winter,05:00:00 AM,0,0,0,clear night,
2019,Winter,03:00:00 AM,0,0,0,partly cloudy night,
2019,Spring,07:00:00 PM,1882,717,1165,partly cloudy day,
2019,Summer,05:00:00 PM,1963,936,1027,partly cloudy day,
2019,Winter,12:00:00 PM,835,470,365,rain,
2019,Winter,01:00:00 AM,2,0,2,clear night,
2019,Summer,06:00:00 AM,195,86,109,clear day,
2019,Winter,09:00:00 PM,1,0,1,clear night,
2019,Spring,12:00:00 PM,662,272,390,rain,Cinco de Mayo
2019,Summer,12:00:00 AM,3,1,2,cloudy,
2019,Winter,05:00:00 PM,546,260,286,cloudy,
2019,Spring,02:00:00 AM,2,1,1,clear night,
2019,Spring,05:00:00 PM,1018,508,510,partly cloudy day,
2019,Fall,03:00:00 PM,3379,1456,1923,partly cloudy day,
2019,Fall,02:00:00 PM,1742,751,991,clear day,
2019,Winter,05:00:00 AM,1,1,0,clear night,
2019,Fall,01:00:00 PM,3271,1529,1742,partly cloudy day,
2019,Fall,10:00:00 AM,1713,962,751,clear day,
2019,Winter,03:00:00 AM,1,0,1,clear night,
2019,Fall,05:00:00 AM,1,0,1,partly cloudy night,
2019,Winter,01:00:00 PM,839,336,503,clear day,
2019,Spring,07:00:00 AM,145,64,81,clear day,
2019,Spring,05:00:00 PM,459,226,233,rain,
2019,Spring,02:00:00 PM,1506,729,777,clear day,
2019,Summer,12:00:00 PM,1733,782,951,partly cloudy day,
2019,Fall,11:00:00 PM,0,0,0,clear night,
2019,Fall,09:00:00 AM,332,148,184,cloudy,
2019,Spring,03:00:00 AM,0,0,0,cloudy,
2019,Spring,01:00:00 PM,1785,743,1042,partly cloudy day,
2019,Winter,07:00:00 AM,120,54,66,partly cloudy night,
2019,Summer,06:00:00 AM,190,69,121,clear day,
2019,Fall,02:00:00 AM,3,0,3,cloudy,
2019,Fall,08:00:00 PM,9,0,9,clear night,
2019,Spring,12:00:00 PM,1878,898,980,partly cloudy day,
2019,Winter,09:00:00 PM,2,0,2,clear night,
2019,Winter,08:00:00 AM,211,68,143,cloudy,
2019,Fall,05:00:00 AM,1,0,1,clear night,
2019,Spring,10:00:00 AM,1098,659,439,cloudy,
2019,Winter,04:00:00 AM,0,0,0,clear night,
2019,Spring,04:00:00 AM,0,0,0,cloudy,
2019,Spring,06:00:00 PM,1468,804,664,clear day,
2019,Winter,01:00:00 AM,36,0,36,partly cloudy night,
2019,Summer,09:00:00 PM,49,25,24,partly cloudy night,
2019,Spring,11:00:00 PM,7,5,2,cloudy,
2019,Summer,01:00:00 PM,2073,898,1175,partly cloudy day,
2019,Fall,07:00:00 AM,107,48,59,rain,
2019,Spring,07:00:00 AM,42,21,21,rain,Daylight Saving Time starts
2019,Spring,09:00:00 PM,46,11,35,cloudy,
2019,Summer,04:00:00 PM,2413,1142,1271,partly cloudy day,
2019,Fall,09:00:00 AM,1014,619,395,clear day,
2019,Spring,10:00:00 AM,1711,945,766,partly cloudy day,
2019,Winter,04:00:00 PM,2742,1394,1348,partly cloudy day,
2019,Summer,07:00:00 AM,231,106,125,partly cloudy day,
2019,Spring,07:00:00 PM,868,442,426,clear day,
2019,Fall,07:00:00 PM,2,0,2,clear night,Black Friday
2019,Summer,09:00:00 AM,917,565,352,clear day,
2019,Fall,02:00:00 PM,2289,1013,1276,partly cloudy day,Daylight Saving Time ends
2019,Fall,05:00:00 PM,2454,950,1504,cloudy,
2019,Spring,07:00:00 AM,116,48,68,cloudy,
2019,Summer,10:00:00 AM,1487,865,622,partly cloudy day,
2019,Spring,11:00:00 PM,33,32,1,clear night,
2019,Summer,04:00:00 PM,2266,910,1356,partly cloudy day,
2019,Spring,06:00:00 AM,111,66,45,partly cloudy night,
2019,Fall,12:00:00 AM,14,0,14,partly cloudy night,Daylight Saving Time ends
2019,Summer,09:00:00 AM,473,277,196,fog,
2019,Summer,06:00:00 AM,214,94,120,partly cloudy night,
2019,Fall,06:00:00 AM,183,111,72,partly cloudy night,
2019,Fall,06:00:00 PM,10,9,1,clear night,
2019,Fall,05:00:00 AM,1,0,1,clear night,
2019,Fall,12:00:00 PM,2531,1139,1392,clear day,
2019,Spring,10:00:00 AM,1497,915,582,cloudy,
2019,Winter,04:00:00 PM,1248,582,666,clear day,
2019,Summer,04:00:00 AM,2,0,2,cloudy,
2019,Fall,03:00:00 PM,1833,805,1028,partly cloudy day,
2019,Winter,06:00:00 AM,62,37,25,cloudy,Valentine's Day
2019,Fall,05:00:00 PM,1417,685,732,partly cloudy day,
2019,Spring,12:00:00 PM,2844,1297,1547,clear day,
2019,Winter,02:00:00 AM,3,1,2,clear night,
2019,Summer,01:00:00 AM,3,1,2,clear night,
2019,Spring,08:00:00 PM,18,7,11,partly cloudy night,
2019,Summer,07:00:00 AM,306,144,162,partly cloudy day,
2019,Summer,04:00:00 PM,2108,957,1151,partly cloudy day,
2019,Summer,08:00:00 PM,1035,474,561,partly cloudy day,
2019,Spring,05:00:00 PM,592,172,420,cloudy,
2019,Fall,03:00:00 PM,2813,1207,1606,partly cloudy day,
2019,Summer,03:00:00 AM,1,0,1,clear night,
2019,Winter,11:00:00 AM,1366,525,841,clear day,
2019,Spring,11:00:00 PM,3,2,1,clear night,
2019,Summer,02:00:00 AM,1,0,1,clear night,
2019,Winter,10:00:00 AM,780,467,313,clear day,
2019,Winter,03:00:00 PM,2625,1379,1246,clear day,Christmas Eve
2019,Winter,09:00:00 PM,16,10,6,partly cloudy night,
2019,Winter,06:00:00 PM,143,138,5,clear night,
2019,Fall,07:00:00 PM,77,71,6,partly cloudy night,
2019,Winter,12:00:00 PM,2365,1086,1279,clear day,
2019,Winter,02:00:00 PM,1077,486,591,partly cloudy day,
2019,Winter,04:00:00 AM,0,0,0,clear night,
2019,Summer,11:00:00 PM,10,5,5,clear night,
2019,Fall,03:00:00 AM,0,0,0,clear night,
2019,Fall,04:00:00 AM,0,0,0,partly cloudy night,
2019,Winter,03:00:00 PM,820,419,401,clear day,
2019,Spring,12:00:00 AM,9,6,3,rain,
2019,Fall,03:00:00 PM,2910,1231,1679,clear day,
2019,Fall,07:00:00 PM,1324,682,642,clear day,
2019,Summer,02:00:00 AM,0,0,0,partly cloudy night,
2019,Spring,09:00:00 AM,602,280,322,partly cloudy day,
2019,Summer,10:00:00 PM,69,43,26,clear night,
2019,Spring,03:00:00 PM,2032,891,1141,cloudy,
2019,Fall,10:00:00 PM,45,0,45,partly cloudy night,
2019,Fall,03:00:00 PM,3635,1494,2141,clear day,
2019,Spring,04:00:00 AM,0,0,0,partly cloudy night,
2019,Winter,06:00:00 AM,23,11,12,clear night,
2019,Summer,10:00:00 AM,751,440,311,cloudy,
2019,Summer,06:00:00 AM,191,98,93,clear day,
2019,Spring,03:00:00 AM,0,0,0,clear night,
2019,Summer,11:00:00 AM,1755,823,932,clear day,
2019,Summer,03:00:00 PM,1993,993,1000,partly cloudy day,
2019,Spring,09:00:00 PM,33,29,4,clear night,
2019,Winter,06:00:00 PM,87,79,8,cloudy,
2019,Spring,08:00:00 AM,417,157,260,cloudy,
2019,Spring,12:00:00 PM,1213,544,669,cloudy,
2019,Summer,07:00:00 AM,120,42,78,partly cloudy day,Father's Day
2019,Fall,03:00:00 AM,0,0,0,clear night,
2019,Spring,05:00:00 PM,1542,779,763,clear day,
2019,Fall,11:00:00 PM,12,6,6,cloudy,
2019,Summer,05:00:00 AM,10,8,2,partly cloudy night,
2019,Winter,01:00:00 PM,3197,1738,1459,clear day,Christmas Day
2019,Fall,02:00:00 AM,0,0,0,cloudy,
2019,Summer,04:00:00 PM,1998,970,1028,partly cloudy day,
2019,Winter,07:00:00 AM,80,54,26,rain,
2019,Summer,04:00:00 AM,2,0,2,cloudy,
2019,Winter,07:00:00 AM,171,78,93,partly cloudy night,
2019,Summer,08:00:00 PM,679,336,343,partly cloudy day,
2019,Spring,10:00:00 AM,906,487,419,clear day,
2019,Fall,02:00:00 AM,2,0,2,rain,
2019,Summer,06:00:00 AM,138,57,81,clear day,
2019,Winter,06:00:00 PM,47,30,17,cloudy,
2019,Winter,08:00:00 AM,222,109,113,partly cloudy day,
2019,Fall,01:00:00 AM,0,0,0,clear night,
2019,Spring,07:00:00 PM,2006,859,1147,partly cloudy day,
2019,Spring,06:00:00 AM,52,24,28,clear night,
2019,Winter,05:00:00 PM,453,253,200,partly cloudy night,
2019,Winter,09:00:00 AM,338,206,132,cloudy,
2019,Summer,06:00:00 PM,2112,969,1143,partly cloudy day,
2019,Fall,02:00:00 PM,2844,1208,1636,partly cloudy day,
2019,Fall,10:00:00 PM,3,2,1,clear night,
2019,Winter,05:00:00 PM,75,64,11,cloudy,
2019,Spring,09:00:00 AM,867,531,336,partly cloudy day,
2019,Spring,04:00:00 PM,2985,1291,1694,partly cloudy day,
2019,Spring,07:00:00 PM,1455,733,722,partly cloudy day,
2019,Winter,03:00:00 AM,0,0,0,cloudy,
2019,Fall,07:00:00 PM,70,68,2,cloudy,
2019,Spring,07:00:00 AM,166,76,90,cloudy,
2019,Spring,09:00:00 PM,71,33,38,clear night,Memorial Day
2019,Winter,07:00:00 PM,97,78,19,partly cloudy night,
2019,Spring,03:00:00 AM,0,0,0,cloudy,
2019,Winter,08:00:00 PM,47,42,5,clear night,
2019,Summer,06:00:00 PM,1369,741,628,partly cloudy day,
2019,Summer,08:00:00 PM,127,115,12,rain,
2019,Summer,06:00:00 PM,2013,1005,1008,partly cloudy day,
2019,Spring,04:00:00 AM,1,0,1,cloudy,
2019,Spring,10:00:00 PM,1,0,1,clear night,St. Patrick's Day
2019,Fall,03:00:00 PM,2190,968,1222,clear day,
2019,Fall,05:00:00 AM,0,0,0,clear night,
2019,Summer,02:00:00 AM,0,0,0,cloudy,
2019,Summer,10:00:00 AM,1291,686,605,partly cloudy day,
2019,Spring,12:00:00 PM,2961,1377,1584,clear day,Memorial Day
2019,Summer,07:00:00 AM,213,127,86,cloudy,
2019,Summer,11:00:00 PM,28,22,6,partly cloudy night,
2019,Summer,11:00:00 AM,1742,793,949,partly cloudy day,
2019,Spring,11:00:00 AM,1333,603,730,clear day,
2019,Summer,01:00:00 AM,2,1,1,clear night,
2019,Fall,04:00:00 PM,1951,874,1077,clear day,
2019,Spring,06:00:00 PM,2361,1036,1325,clear day,
2019,Fall,06:00:00 PM,294,166,128,rain,
2019,Summer,07:00:00 PM,417,224,193,cloudy,
2019,Winter,11:00:00 AM,255,158,97,clear day,
2019,Spring,07:00:00 PM,1837,809,1028,partly cloudy day,
2019,Winter,10:00:00 AM,449,248,201,cloudy,
2019,Spring,04:00:00 PM,3433,1503,1930,clear day,
2019,Fall,10:00:00 AM,1560,891,669,clear day,
2019,Summer,09:00:00 AM,360,206,154,cloudy,
2019,Winter,06:00:00 PM,0,0,0,partly cloudy night,
2019,Fall,09:00:00 PM,45,43,2,clear night,
2019,Summer,04:00:00 PM,2418,1140,1278,partly cloudy day,
2019,Spring,08:00:00 AM,448,156,292,partly cloudy day,
2019,Spring,12:00:00 PM,1882,836,1046,partly cloudy day,
2019,Summer,11:00:00 PM,51,43,8,clear night,
2019,Winter,06:00:00 PM,33,0,33,clear night,
2019,Winter,03:00:00 AM,0,0,0,rain,
2019,Fall,10:00:00 PM,47,44,3,cloudy,
2019,Winter,01:00:00 PM,0,0,0,clear day,
2019,Summer,09:00:00 AM,881,548,333,partly cloudy day,
2019,Summer,01:00:00 AM,21,14,7,clear night,
2019,Summer,02:00:00 PM,2269,1039,1230,partly cloudy day,
2019,Fall,02:00:00 PM,1969,949,1020,cloudy,Thanksgiving Day
2019,Winter,12:00:00 AM,0,0,0,clear night,
2019,Spring,06:00:00 AM,198,117,81,clear night,
2019,Summer,03:00:00 PM,2135,999,1136,partly cloudy day,
2019,Spring,04:00:00 PM,1727,725,1002,partly cloudy day,
2019,Summer,12:00:00 PM,2005,975,1030,clear day,
2019,Fall,07:00:00 AM,282,129,153,clear night,
2019,Winter,11:00:00 PM,5,3,2,partly cloudy night,New Year's Day
2019,Winter,11:00:00 AM,881,441,440,partly cloudy day,
2019,Summer,04:00:00 AM,0,0,0,partly cloudy night,
2019,Spring,10:00:00 PM,13,11,2,clear night,
2019,Spring,06:00:00 AM,150,70,80,cloudy,
2019,Winter,07:00:00 AM,187,82,105,partly cloudy night,
2019,Spring,04:00:00 PM,777,391,386,cloudy,
2019,Spring,06:00:00 AM,78,45,33,clear night,
2019,Summer,11:00:00 AM,2449,1233,1216,partly cloudy day,
2019,Summer,08:00:00 AM,337,163,174,partly cloudy day,
2019,Fall,08:00:00 AM,429,156,273,partly cloudy day,
2019,Fall,03:00:00 PM,2282,1039,1243,clear day,
2019,Summer,01:00:00 PM,1334,582,752,partly cloudy day,
2019,Winter,06:00:00 AM,33,20,13,cloudy,
2019,Fall,06:00:00 PM,1224,716,508,partly cloudy day,
2019,Fall,06:00:00 PM,2354,1016,1338,partly cloudy day,
2019,Spring,06:00:00 PM,1311,744,567,clear day,
2019,Spring,01:00:00 PM,1622,722,900,cloudy,
2019,Summer,05:00:00 PM,1547,788,759,partly cloudy day,
2019,Fall,07:00:00 AM,269,161,108,clear night,
2019,Spring,11:00:00 PM,42,0,42,rain,
2019,Spring,04:00:00 PM,2177,1010,1167,cloudy,
2019,Winter,12:00:00 PM,3346,1775,1571,cloudy,New Year's Eve
2019,Spring,05:00:00 PM,1105,572,533,cloudy,
2019,Summer,06:00:00 AM,185,85,100,clear day,
2019,Summer,08:00:00 PM,74,53,21,partly cloudy night,
2019,Fall,08:00:00 PM,45,43,2,clear night,
2019,Winter,08:00:00 AM,233,107,126,partly cloudy day,New Year's Day
2019,Spring,01:00:00 PM,1632,649,983,partly cloudy day,
2019,Fall,11:00:00 PM,89,0,89,clear night,
2019,Winter,03:00:00 AM,1,0,1,clear night,
2019,Fall,12:00:00 PM,2244,1148,1096,partly cloudy day,
2019,Winter,11:00:00 AM,2253,1133,1120,clear day,
2019,Winter,10:00:00 PM,4,0,4,rain,
2019,Fall,11:00:00 AM,1563,716,847,cloudy,
2019,Spring,04:00:00 AM,0,0,0,cloudy,
2019,Fall,05:00:00 PM,1921,1015,906,partly cloudy day,
2019,Winter,09:00:00 AM,592,342,250,partly cloudy day,
2019,Spring,03:00:00 AM,0,0,0,sleet,
2019,Spring,09:00:00 AM,340,133,207,partly cloudy day,
2019,Summer,06:00:00 PM,2740,1161,1579,partly cloudy day,
2019,Summer,12:00:00 AM,5,4,1,clear night,
2019,Spring,05:00:00 PM,1477,708,769,clear day,
2019,Winter,08:00:00 PM,79,78,1,cloudy,
2019,Spring,01:00:00 PM,582,249,333,cloudy,
2019,Spring,08:00:00 AM,384,132,252,clear day,
2019,Spring,03:00:00 AM,0,0,0,partly cloudy night,
2019,Fall,08:00:00 AM,309,133,176,cloudy,
2019,Winter,03:00:00 PM,1667,853,814,clear day,
2019,Summer,07:00:00 AM,206,101,105,partly cloudy day,
2019,Summer,10:00:00 PM,10,2,8,clear night,
2019,Spring,02:00:00 AM,3,2,1,cloudy,
2019,Summer,06:00:00 PM,826,383,443,rain,
2019,Winter,04:00:00 PM,200,117,83,rain,
2019,Summer,09:00:00 PM,103,56,47,partly cloudy night,
2019,Winter,04:00:00 PM,2222,1110,1112,clear day,
2019,Spring,12:00:00 PM,2435,1164,1271,partly cloudy day,
2019,Fall,06:00:00 AM,6,1,5,rain,
2019,Fall,05:00:00 PM,2150,1214,936,clear day,
2019,Summer,05:00:00 PM,2555,1155,1400,clear day,
2019,Spring,12:00:00 PM,3514,1653,1861,partly cloudy day,
2019,Winter,03:00:00 PM,1292,631,661,partly cloudy day,
2019,Winter,02:00:00 AM,1,1,0,cloudy,
2019,Winter,11:00:00 PM,8,4,4,clear night,
2019,Summer,04:00:00 AM,0,0,0,clear night,
2019,Winter,10:00:00 AM,928,467,461,partly cloudy day,
2019,Winter,02:00:00 AM,1,0,1,rain,
2019,Winter,06:00:00 PM,226,179,47,partly cloudy night,
2019,Fall,10:00:00 PM,32,26,6,clear night,
2019,Summer,02:00:00 AM,0,0,0,partly cloudy night,
2019,Summer,09:00:00 PM,135,68,67,partly cloudy night,
2019,Summer,08:00:00 AM,326,143,183,partly cloudy day,
2019,Fall,02:00:00 PM,3528,1387,2141,partly cloudy day,
2019,Fall,11:00:00 AM,114,74,40,rain,
2019,Fall,06:00:00 PM,318,183,135,cloudy,
2019,Winter,07:00:00 PM,31,28,3,partly cloudy night,
2019,Fall,01:00:00 PM,1536,656,880,partly cloudy day,
2019,Winter,06:00:00 AM,18,11,7,clear night,
2019,Summer,08:00:00 PM,1201,564,637,partly cloudy day,
2019,Summer,12:00:00 PM,1842,743,1099,partly cloudy day,
2019,Spring,08:00:00 AM,366,143,223,cloudy,
2019,Summer,01:00:00 AM,31,29,2,clear night,
2019,Spring,11:00:00 PM,7,0,7,clear night,
2019,Spring,01:00:00 AM,3,2,1,clear night,
2019,Fall,04:00:00 AM,0,0,0,clear night,
2019,Fall,01:00:00 PM,2513,1115,1398,partly cloudy day,
2019,Summer,11:00:00 PM,12,5,7,clear night,
2019,Spring,05:00:00 PM,3083,1154,1929,partly cloudy day,
2019,Fall,10:00:00 AM,851,468,383,cloudy,
2019,Winter,01:00:00 AM,6,0,6,clear night,
2019,Summer,01:00:00 AM,26,24,2,clear night,
2019,Summer,03:00:00 PM,2266,988,1278,clear day,
2019,Winter,11:00:00 AM,1248,594,654,cloudy,
2019,Fall,02:00:00 AM,0,0,0,clear night,
2019,Summer,02:00:00 PM,1378,661,717,cloudy,
2019,Winter,06:00:00 AM,9,5,4,clear night,
2019,Summer,04:00:00 AM,3,0,3,partly cloudy night,
2019,Winter,04:00:00 AM,0,0,0,partly cloudy night,
2019,Spring,08:00:00 AM,464,291,173,partly cloudy day,Easter Sunday
2019,Spring,09:00:00 AM,587,296,291,cloudy,
2019,Spring,10:00:00 PM,49,42,7,clear night,
2019,Fall,10:00:00 PM,73,70,3,rain,
2019,Spring,01:00:00 AM,0,0,0,clear night,
2019,Summer,04:00:00 AM,0,0,0,partly cloudy night,
2019,Summer,07:00:00 AM,294,128,166,clear day,
2019,Fall,10:00:00 AM,518,228,290,cloudy,
2019,Summer,09:00:00 PM,25,19,6,clear night,
2019,Summer,07:00:00 AM,190,93,97,cloudy,
2019,Winter,03:00:00 PM,989,475,514,partly cloudy day,
2019,Winter,06:00:00 PM,52,51,1,clear night,
2019,Winter,08:00:00 AM,400,182,218,cloudy,
2019,Fall,02:00:00 AM,1,0,1,cloudy,
2019,Fall,06:00:00 PM,2191,956,1235,partly cloudy day,
2019,Winter,09:00:00 PM,10,7,3,cloudy,
2019,Spring,03:00:00 AM,1,0,1,partly cloudy night,
2019,Winter,07:00:00 PM,52,47,5,clear night,
2019,Summer,10:00:00 PM,99,65,34,cloudy,
2019,Summer,03:00:00 AM,1,0,1,clear night,
2019,Fall,09:00:00 PM,34,18,16,partly cloudy night,
2019,Spring,10:00:00 PM,55,49,6,cloudy,
2019,Fall,04:00:00 PM,2241,983,1258,clear day,
2019,Winter,11:00:00 PM,2,2,0,clear night,
2019,Winter,10:00:00 PM,17,16,1,cloudy,
2019,Summer,09:00:00 PM,80,49,31,partly cloudy night,
2019,Fall,10:00:00 AM,1219,579,640,clear day,Black Friday
2019,Spring,02:00:00 PM,3395,1539,1856,partly cloudy day,
2019,Summer,12:00:00 AM,7,3,4,clear night,
2019,Fall,05:00:00 AM,5,4,1,partly cloudy night,
2019,Spring,12:00:00 AM,2,2,0,cloudy,
2019,Fall,07:00:00 AM,320,169,151,clear night,
2019,Fall,06:00:00 PM,73,72,1,partly cloudy night,
2019,Summer,07:00:00 AM,282,119,163,clear day,
2019,Winter,05:00:00 PM,1044,480,564,clear day,
2019,Spring,05:00:00 AM,7,5,2,rain,Mother's Day
2019,Winter,07:00:00 PM,26,24,2,cloudy,
2019,Spring,02:00:00 AM,2,1,1,cloudy,
2019,Winter,12:00:00 PM,909,484,425,cloudy,
2019,Summer,09:00:00 AM,577,332,245,partly cloudy day,
2019,Fall,06:00:00 AM,115,60,55,partly cloudy night,
2019,Summer,08:00:00 AM,466,169,297,clear day,
2019,Spring,02:00:00 PM,1283,509,774,partly cloudy day,
2019,Summer,07:00:00 PM,1550,812,738,partly cloudy day,
2019,Spring,08:00:00 AM,350,117,233,cloudy,
2019,Summer,02:00:00 PM,2663,1392,1271,partly cloudy day,
2019,Spring,02:00:00 AM,1,0,1,clear night,
2019,Fall,11:00:00 PM,16,15,1,clear night,
2019,Fall,04:00:00 AM,0,0,0,clear night,
2019,Spring,01:00:00 AM,4,3,1,clear night,
2019,Spring,02:00:00 AM,0,0,0,clear night,
2019,Summer,11:00:00 AM,1564,829,735,partly cloudy day,
2019,Fall,05:00:00 PM,2452,1062,1390,partly cloudy day,
2019,Winter,05:00:00 PM,773,773,0,clear day,
2019,Winter,09:00:00 PM,18,14,4,clear night,Valentine's Day
2019,Summer,05:00:00 AM,55,39,16,clear night,
2019,Fall,05:00:00 AM,0,0,0,clear night,
2019,Winter,10:00:00 PM,11,7,4,partly cloudy night,
2019,Spring,10:00:00 AM,903,470,433,partly cloudy day,
2019,Fall,01:00:00 PM,1931,759,1172,clear day,
2019,Spring,02:00:00 AM,0,0,0,clear night,
2019,Summer,05:00:00 AM,30,19,11,clear night,
2019,Summer,12:00:00 AM,1,0,1,clear night,
2019,Fall,02:00:00 PM,1748,715,1033,cloudy,
2019,Winter,10:00:00 PM,12,11,1,rain,
2019,Fall,02:00:00 PM,2051,849,1202,clear day,
2019,Summer,01:00:00 AM,3,3,0,clear night,
2019,Spring,04:00:00 PM,642,279,363,rain,Easter Monday
2019,Spring,11:00:00 PM,0,0,0,clear night,
2019,Winter,12:00:00 PM,493,204,289,snow,
2019,Winter,01:00:00 PM,1171,526,645,partly cloudy day,
2019,Fall,10:00:00 AM,1113,577,536,clear day,
2019,Spring,11:00:00 PM,10,0,10,partly cloudy night,
2019,Winter,07:00:00 PM,10,6,4,partly cloudy night,
2019,Summer,12:00:00 PM,1944,989,955,cloudy,
2019,Fall,08:00:00 AM,432,171,261,partly cloudy day,
2019,Winter,08:00:00 AM,0,0,0,partly cloudy day,
2019,Fall,09:00:00 AM,820,495,325,partly cloudy day,
2019,Fall,12:00:00 PM,1659,753,906,partly cloudy day,
2019,Summer,08:00:00 AM,375,157,218,clear day,
2019,Spring,03:00:00 PM,1753,815,938,partly cloudy day,
2019,Winter,11:00:00 PM,25,11,14,partly cloudy night,
2019,Fall,01:00:00 PM,1064,590,474,rain,Labor Day
2019,Summer,09:00:00 AM,806,494,312,partly cloudy day,Father's Day
2019,Spring,01:00:00 AM,0,0,0,cloudy,
2019,Fall,10:00:00 PM,89,68,21,cloudy,
2019,Summer,03:00:00 AM,0,0,0,partly cloudy night,
2019,Summer,08:00:00 AM,856,444,412,partly cloudy day,
2019,Fall,05:00:00 PM,260,132,128,partly cloudy night,
2019,Fall,06:00:00 PM,9,5,4,cloudy,
2019,Winter,11:00:00 AM,691,343,348,cloudy,
2019,Spring,05:00:00 AM,19,10,9,clear night,
2019,Spring,10:00:00 PM,30,29,1,cloudy,
2019,Spring,08:00:00 AM,351,164,187,partly cloudy day,
2019,Fall,07:00:00 AM,162,72,90,partly cloudy day,
2019,Summer,07:00:00 AM,235,106,129,partly cloudy day,
2019,Summer,03:00:00 AM,1,0,1,partly cloudy night,
2019,Spring,07:00:00 AM,182,63,119,cloudy,
2019,Summer,06:00:00 PM,964,501,463,cloudy,
2019,Fall,02:00:00 AM,0,0,0,partly cloudy night,
2019,Winter,04:00:00 PM,1483,811,672,clear day,
2019,Summer,10:00:00 PM,16,11,5,clear night,
2019,Summer,06:00:00 AM,125,73,52,cloudy,
2019,Winter,12:00:00 PM,578,273,305,cloudy,
2019,Fall,05:00:00 PM,1738,999,739,clear day,
2019,Winter,08:00:00 AM,127,64,63,rain,
2019,Summer,09:00:00 PM,70,61,9,partly cloudy night,
2019,Spring,10:00:00 PM,27,0,27,clear night,
2019,Winter,10:00:00 AM,321,157,164,clear day,
2019,Spring,09:00:00 PM,7,5,2,clear night,
2019,Spring,02:00:00 PM,3371,1470,1901,clear day,
2019,Spring,08:00:00 PM,22,19,3,clear night,
2019,Winter,01:00:00 PM,996,441,555,cloudy,
2019,Summer,09:00:00 PM,59,20,39,partly cloudy night,
2019,Winter,10:00:00 AM,692,392,300,cloudy,
2019,Fall,01:00:00 PM,500,229,271,cloudy,
2019,Summer,08:00:00 AM,536,316,220,partly cloudy day,
2019,Summer,04:00:00 PM,2273,1013,1260,partly cloudy day,
2019,Fall,11:00:00 AM,1649,746,903,clear day,
2019,Spring,11:00:00 AM,2135,1163,972,clear day,
2019,Spring,03:00:00 AM,1,0,1,clear night,
2019,Winter,09:00:00 PM,7,5,2,partly cloudy night,
2019,Summer,06:00:00 PM,817,515,302,rain,
2019,Spring,10:00:00 PM,16,6,10,cloudy,Tax Day
2019,Spring,04:00:00 AM,1,0,1,snow,
2019,Fall,12:00:00 PM,1565,649,916,partly cloudy day,
2019,Fall,01:00:00 PM,1663,718,945,partly cloudy day,
2019,Summer,10:00:00 AM,968,612,356,partly cloudy day,
2019,Fall,07:00:00 AM,249,120,129,cloudy,Columbus Day (regional holiday)
2019,Fall,12:00:00 AM,12,0,12,rain,
2019,Summer,12:00:00 PM,2178,1060,1118,partly cloudy day,
2019,Spring,02:00:00 AM,9,4,5,snow,
2019,Fall,03:00:00 AM,0,0,0,cloudy,
2019,Summer,09:00:00 PM,26,17,9,rain,
2019,Spring,01:00:00 PM,2120,909,1211,partly cloudy day,
2019,Summer,04:00:00 AM,0,0,0,partly cloudy night,
2019,Spring,07:00:00 AM,35,12,23,rain,
2019,Summer,05:00:00 PM,1809,929,880,partly cloudy day,
2019,Winter,11:00:00 PM,75,75,0,clear night,
2019,Spring,02:00:00 AM,2,1,1,cloudy,
2019,Summer,10:00:00 AM,1425,837,588,partly cloudy day,
2019,Fall,06:00:00 AM,127,82,45,clear night,
2019,Summer,10:00:00 AM,1282,685,597,partly cloudy day,
2019,Summer,04:00:00 PM,2188,1066,1122,partly cloudy day,
2019,Spring,12:00:00 AM,0,0,0,partly cloudy night,
2019,Fall,07:00:00 PM,242,100,142,partly cloudy night,
2019,Summer,07:00:00 AM,304,127,177,partly cloudy day,
2019,Fall,07:00:00 AM,297,126,171,clear night,
2019,Summer,05:00:00 PM,1662,803,859,partly cloudy day,
2019,Summer,08:00:00 AM,425,232,193,clear day,
2019,Fall,12:00:00 AM,59,0,59,partly cloudy night,
2019,Spring,07:00:00 PM,396,170,226,cloudy,
2019,Winter,08:00:00 AM,180,60,120,partly cloudy day,
2019,Spring,03:00:00 AM,0,0,0,clear night,
2019,Summer,11:00:00 AM,1898,1047,851,partly cloudy day,
2019,Winter,09:00:00 PM,11,11,0,rain,
2019,Fall,06:00:00 AM,119,70,49,cloudy,
2019,Winter,10:00:00 AM,1004,588,416,clear day,
2019,Winter,01:00:00 PM,987,483,504,rain,
2019,Fall,08:00:00 AM,387,200,187,partly cloudy day,Labor Day
2019,Winter,08:00:00 PM,1,0,1,clear night,
2019,Summer,07:00:00 AM,313,154,159,clear day,
2019,Fall,01:00:00 PM,2117,916,1201,partly cloudy day,
2019,Winter,10:00:00 PM,2,2,0,partly cloudy night,
2019,Winter,09:00:00 AM,363,207,156,cloudy,Presidents' Day (regional holiday)
2019,Spring,12:00:00 PM,1269,582,687,partly cloudy day,
2019,Spring,06:00:00 AM,81,50,31,partly cloudy night,
2019,Spring,09:00:00 PM,7,0,7,cloudy,
2019,Winter,08:00:00 AM,178,99,79,clear day,
2019,Winter,11:00:00 PM,0,0,0,cloudy,
2019,Winter,12:00:00 PM,2176,1052,1124,clear day,
2019,Summer,08:00:00 AM,288,165,123,partly cloudy day,Father's Day
2019,Spring,12:00:00 PM,376,193,183,rain,
2019,Spring,11:00:00 AM,1099,534,565,cloudy,
2019,Spring,06:00:00 AM,45,31,14,partly cloudy night,
2019,Fall,07:00:00 AM,250,111,139,cloudy,
2019,Spring,07:00:00 PM,1401,796,605,clear day,
2019,Summer,10:00:00 AM,1591,872,719,partly cloudy day,
2019,Fall,12:00:00 PM,1159,482,677,cloudy,
2019,Spring,02:00:00 AM,0,0,0,cloudy,
2019,Spring,11:00:00 AM,2423,1306,1117,partly cloudy day,
2019,Summer,03:00:00 AM,0,0,0,clear night,
2019,Spring,10:00:00 AM,951,481,470,clear day,
2019,Summer,09:00:00 PM,153,61,92,partly cloudy night,
2019,Spring,02:00:00 AM,0,0,0,clear night,
2019,Winter,05:00:00 AM,0,0,0,clear night,
2019,Winter,12:00:00 PM,1849,1012,837,cloudy,
2019,Winter,07:00:00 AM,126,62,64,clear night,
2019,Summer,11:00:00 AM,1433,738,695,clear day,
2019,Fall,08:00:00 PM,95,61,34,partly cloudy night,Labor Day
2019,Spring,10:00:00 PM,5,4,1,cloudy,
2019,Summer,08:00:00 AM,170,73,97,rain,
2019,Fall,04:00:00 PM,2289,1004,1285,clear day,
2019,Winter,12:00:00 PM,884,454,430,partly cloudy day,
2019,Winter,02:00:00 AM,0,0,0,partly cloudy night,
2019,Fall,01:00:00 AM,0,0,0,cloudy,Thanksgiving Day
2019,Summer,07:00:00 AM,83,32,51,rain,
2019,Fall,04:00:00 PM,2778,1296,1482,cloudy,
2019,Winter,04:00:00 AM,0,0,0,clear night,
2019,Winter,03:00:00 PM,1070,460,610,cloudy,
2019,Spring,07:00:00 AM,186,105,81,cloudy,
2019,Winter,08:00:00 PM,16,11,5,partly cloudy night,
2019,Fall,04:00:00 PM,1899,880,1019,clear day,
2019,Summer,05:00:00 AM,48,39,9,clear night,
2019,Fall,01:00:00 AM,8,6,2,rain,
2019,Spring,10:00:00 AM,124,55,69,rain,Daylight Saving Time starts
2019,Spring,02:00:00 PM,1864,850,1014,partly cloudy day,
2019,Summer,04:00:00 PM,1293,560,733,partly cloudy day,
2019,Fall,05:00:00 AM,0,0,0,clear night,Veterans Day
2019,Winter,08:00:00 AM,121,42,79,clear day,
2019,Summer,01:00:00 PM,2661,1210,1451,partly cloudy day,
2019,Summer,09:00:00 PM,87,71,16,partly cloudy night,
2019,Fall,07:00:00 AM,276,113,163,cloudy,
2019,Winter,07:00:00 PM,12,8,4,clear night,
2019,Winter,07:00:00 PM,12,0,12,rain,
2019,Spring,12:00:00 AM,2,0,2,,
2019,Spring,10:00:00 PM,14,0,14,rain,
2019,Spring,10:00:00 PM,27,25,2,clear night,
2019,Summer,05:00:00 PM,2235,1068,1167,partly cloudy day,
2019,Spring,09:00:00 PM,10,6,4,partly cloudy night,
2019,Summer,06:00:00 PM,1515,798,717,partly cloudy day,
2019,Fall,02:00:00 PM,2878,1259,1619,clear day,
2019,Spring,07:00:00 PM,423,276,147,cloudy,Easter Monday
2019,Winter,03:00:00 PM,1785,863,922,cloudy,
2019,Winter,12:00:00 AM,2,0,2,cloudy,
2019,Fall,02:00:00 AM,1,0,1,partly cloudy night,
2019,Summer,04:00:00 PM,2348,1054,1294,partly cloudy day,
2019,Winter,03:00:00 AM,1,0,1,partly cloudy night,
2019,Fall,10:00:00 PM,1,0,1,clear night,
2019,Winter,05:00:00 AM,7,5,2,cloudy,
2019,Summer,09:00:00 AM,635,327,308,clear day,
2019,Spring,09:00:00 PM,10,9,1,partly cloudy night,
2019,Winter,08:00:00 AM,243,145,98,clear day,
2019,Fall,10:00:00 PM,0,0,0,clear night,
2019,Summer,06:00:00 AM,163,72,91,partly cloudy day,
2019,Spring,06:00:00 PM,247,124,123,partly cloudy night,
2019,Spring,01:00:00 PM,2424,1204,1220,clear day,
2019,Summer,10:00:00 AM,717,427,290,rain,
2019,Summer,05:00:00 PM,2173,1098,1075,partly cloudy day,
2019,Summer,08:00:00 AM,425,239,186,partly cloudy day,
2019,Fall,09:00:00 AM,581,307,274,cloudy,
2019,Summer,07:00:00 AM,270,118,152,partly cloudy day,
2019,Fall,08:00:00 AM,308,178,130,partly cloudy day,
2019,Summer,07:00:00 AM,247,101,146,clear day,
2019,Fall,10:00:00 AM,1246,700,546,clear day,Daylight Saving Time ends
2019,Fall,09:00:00 PM,29,25,4,cloudy,
2019,Winter,09:00:00 PM,3,2,1,rain,
2019,Spring,09:00:00 AM,653,326,327,partly cloudy day,
2019,Summer,02:00:00 AM,6,4,2,clear night,
2019,Summer,08:00:00 PM,205,103,102,cloudy,
2019,Summer,02:00:00 PM,1774,767,1007,partly cloudy day,
2019,Spring,10:00:00 PM,0,0,0,partly cloudy night,
2019,Summer,05:00:00 PM,1992,1089,903,partly cloudy day,
2019,Spring,07:00:00 AM,208,111,97,clear day,Memorial Day
2019,Summer,02:00:00 PM,682,285,397,partly cloudy day,
2019,Fall,01:00:00 AM,2,0,2,partly cloudy night,
2019,Fall,06:00:00 AM,71,34,37,cloudy,
2019,Spring,07:00:00 PM,612,257,355,partly cloudy day,
2019,Summer,10:00:00 AM,1124,715,409,clear day,
2019,Fall,07:00:00 PM,219,134,85,cloudy,
2019,Spring,02:00:00 PM,3007,1268,1739,clear day,
2019,Spring,11:00:00 PM,7,0,7,clear night,
2019,Fall,01:00:00 PM,3256,1632,1624,clear day,
2019,Spring,04:00:00 PM,2311,1058,1253,partly cloudy day,
2019,Fall,07:00:00 AM,869,733,136,partly cloudy day,
2019,Fall,07:00:00 PM,26,0,26,partly cloudy night,
2019,Fall,09:00:00 PM,54,52,2,cloudy,
2019,Spring,03:00:00 AM,2,1,1,clear night,
2019,Summer,12:00:00 PM,1814,837,977,clear day,
2019,Winter,12:00:00 AM,12,3,9,partly cloudy night,
2019,Winter,05:00:00 AM,1,0,1,partly cloudy night,
2019,Summer,01:00:00 PM,2096,895,1201,partly cloudy day,Father's Day
2019,Fall,12:00:00 PM,2132,906,1226,partly cloudy day,
2019,Fall,07:00:00 AM,282,126,156,clear day,
2019,Fall,06:00:00 AM,51,40,11,cloudy,
2019,Summer,07:00:00 PM,1525,795,730,partly cloudy day,
2019,Summer,12:00:00 PM,2133,946,1187,clear day,
2019,Winter,08:00:00 AM,254,149,105,clear day,
2019,Winter,05:00:00 PM,1060,527,533,clear day,
2019,Winter,01:00:00 AM,1,1,0,clear night,
2019,Fall,06:00:00 PM,1468,677,791,partly cloudy day,
2019,Winter,02:00:00 AM,2,1,1,cloudy,
2019,Summer,09:00:00 AM,850,452,398,clear day,
2019,Winter,12:00:00 PM,2532,1242,1290,partly cloudy day,
2019,Winter,07:00:00 AM,110,53,57,clear night,
2019,Spring,07:00:00 AM,95,22,73,rain,Cinco de Mayo
2019,Summer,01:00:00 AM,1,0,1,cloudy,
2019,Fall,09:00:00 PM,76,74,2,partly cloudy night,
2019,Spring,07:00:00 AM,274,126,148,clear day,
2019,Summer,06:00:00 AM,188,87,101,clear day,
2019,Winter,02:00:00 PM,1601,775,826,clear day,
2019,Winter,05:00:00 PM,1089,489,600,cloudy,
2019,Summer,12:00:00 PM,2037,992,1045,clear day,
2019,Summer,01:00:00 PM,1440,639,801,clear day,
2019,Winter,12:00:00 AM,3,0,3,partly cloudy night,
2019,Winter,07:00:00 PM,45,41,4,clear night,
2019,Winter,10:00:00 PM,6,5,1,clear night,
2019,Summer,11:00:00 AM,174,90,84,clear day,
2019,Fall,07:00:00 AM,224,106,118,cloudy,
2019,Spring,07:00:00 PM,1278,621,657,partly cloudy day,
2019,Winter,05:00:00 PM,77,43,34,partly cloudy night,New Year's Eve
2019,Fall,03:00:00 PM,1508,632,876,cloudy,
2019,Fall,01:00:00 AM,0,0,0,partly cloudy night,
2019,Summer,12:00:00 PM,1831,875,956,partly cloudy day,
2019,Winter,02:00:00 AM,1,0,1,clear night,
2019,Winter,05:00:00 AM,1,0,1,cloudy,
2019,Spring,01:00:00 AM,5,0,5,rain,
2019,Fall,11:00:00 AM,1645,908,737,cloudy,
2019,Spring,01:00:00 AM,0,0,0,clear night,
2019,Fall,07:00:00 PM,60,55,5,partly cloudy night,
2019,Winter,03:00:00 PM,1584,724,860,clear day,
2019,Fall,10:00:00 AM,1320,640,680,clear day,
2019,Winter,06:00:00 AM,32,17,15,clear night,
2019,Winter,11:00:00 AM,183,84,99,rain,
2019,Fall,09:00:00 AM,642,397,245,clear day,
2019,Summer,12:00:00 PM,1678,850,828,partly cloudy day,
2019,Summer,04:00:00 AM,1,0,1,clear night,
2019,Fall,11:00:00 AM,1975,919,1056,partly cloudy day,
2019,Spring,10:00:00 AM,600,289,311,clear day,
2019,Summer,10:00:00 AM,1088,554,534,clear day,
2019,Fall,01:00:00 PM,965,386,579,cloudy,
2019,Summer,06:00:00 PM,1864,984,880,clear day,
2019,Fall,02:00:00 AM,1,1,0,partly cloudy night,
2019,Fall,01:00:00 AM,0,0,0,clear night,
2019,Fall,11:00:00 AM,1594,841,753,cloudy,
2019,Winter,03:00:00 AM,2,1,1,cloudy,
2019,Winter,03:00:00 AM,3,2,1,cloudy,
2019,Summer,12:00:00 AM,5,2,3,partly cloudy night,
2019,Fall,11:00:00 AM,1929,956,973,clear day,
2019,Spring,05:00:00 PM,2438,1054,1384,clear day,
2019,Fall,06:00:00 PM,198,130,68,rain,
2019,Summer,03:00:00 AM,2,1,1,cloudy,Father's Day
2019,Winter,02:00:00 AM,0,0,0,clear night,
2019,Spring,12:00:00 AM,70,0,70,partly cloudy night,
2019,Summer,05:00:00 PM,2005,1007,998,partly cloudy day,
2019,Summer,03:00:00 PM,1676,654,1022,clear day,
2019,Fall,02:00:00 AM,1,0,1,partly cloudy night,
2019,Spring,02:00:00 AM,0,0,0,clear night,
2019,Spring,04:00:00 AM,0,0,0,cloudy,
2019,Summer,06:00:00 AM,202,100,102,partly cloudy night,
2019,Spring,01:00:00 PM,1757,723,1034,partly cloudy day,
2019,Spring,09:00:00 AM,414,213,201,clear day,
2019,Fall,12:00:00 AM,33,0,33,clear night,
2019,Summer,09:00:00 PM,103,39,64,clear night,
2019,Summer,04:00:00 AM,0,0,0,clear night,
2019,Spring,08:00:00 AM,457,268,189,clear day,
2019,Winter,12:00:00 PM,736,317,419,cloudy,
2019,Spring,12:00:00 PM,3207,1246,1961,cloudy,
2019,Fall,07:00:00 AM,106,50,56,cloudy,
2019,Spring,11:00:00 PM,16,9,7,cloudy,
2019,Fall,09:00:00 PM,90,0,90,cloudy,
2019,Summer,04:00:00 AM,0,0,0,partly cloudy night,
2019,Summer,02:00:00 PM,1249,434,815,partly cloudy day,
2019,Winter,09:00:00 PM,43,20,23,partly cloudy night,
2019,Winter,01:00:00 PM,1055,560,495,cloudy,
2019,Summer,11:00:00 AM,1004,501,503,partly cloudy day,
2019,Fall,09:00:00 PM,54,37,17,clear night,
2019,Summer,07:00:00 PM,1638,813,825,partly cloudy day,
2019,Spring,05:00:00 PM,2758,1272,1486,partly cloudy day,Memorial Day
2019,Fall,10:00:00 AM,966,611,355,clear day,
2019,Spring,04:00:00 AM,0,0,0,clear night,
2019,Spring,07:00:00 AM,127,61,66,cloudy,
2019,Fall,12:00:00 AM,5,4,1,clear night,
2019,Spring,12:00:00 AM,3,1,2,clear night,
2019,Summer,11:00:00 AM,1825,858,967,cloudy,
2019,Fall,05:00:00 PM,2173,1113,1060,clear day,
2019,Winter,02:00:00 PM,1433,699,734,clear day,
2019,Winter,10:00:00 PM,16,6,10,cloudy,
2019,Spring,04:00:00 PM,1319,609,710,cloudy,
2019,Winter,07:00:00 AM,12,3,9,rain,
2019,Summer,05:00:00 PM,1277,531,746,partly cloudy day,
2019,Spring,06:00:00 PM,1694,722,972,partly cloudy day,
2019,Summer,10:00:00 PM,68,54,14,clear night,
2019,Winter,07:00:00 AM,30,19,11,rain,
2019,Summer,02:00:00 AM,1,0,1,partly cloudy night,
2019,Spring,03:00:00 PM,1235,517,718,clear day,
2019,Winter,03:00:00 PM,746,386,360,cloudy,
2019,Fall,04:00:00 AM,2,0,2,partly cloudy night,
2019,Spring,01:00:00 AM,1,0,1,rain,
2019,Winter,07:00:00 PM,105,49,56,partly cloudy night,New Year's Day
2019,Winter,08:00:00 PM,25,9,16,cloudy,
2019,Spring,05:00:00 PM,1980,986,994,clear day,
2019,Winter,02:00:00 PM,1058,500,558,cloudy,
2019,Fall,11:00:00 PM,65,62,3,cloudy,
2019,Summer,05:00:00 AM,20,12,8,cloudy,
2019,Spring,12:00:00 PM,2984,1469,1515,clear day,
2019,Summer,07:00:00 PM,2071,1111,960,clear day,
2019,Winter,12:00:00 AM,2,1,1,clear night,
2019,Winter,10:00:00 PM,0,0,0,clear night,
2019,Fall,10:00:00 AM,2806,2231,575,partly cloudy day,
2019,Fall,06:00:00 PM,1139,602,537,clear day,
2019,Summer,07:00:00 AM,248,93,155,partly cloudy day,
2019,Spring,10:00:00 AM,617,384,233,clear day,
2019,Winter,05:00:00 AM,0,0,0,clear night,Christmas Eve
2019,Winter,03:00:00 AM,0,0,0,clear night,
2019,Summer,09:00:00 AM,580,313,267,partly cloudy day,
2019,Summer,03:00:00 AM,2,0,2,partly cloudy night,
2019,Spring,05:00:00 AM,0,0,0,clear night,
2019,Winter,04:00:00 AM,0,0,0,partly cloudy night,
2019,Fall,12:00:00 AM,3,0,3,cloudy,
2019,Summer,07:00:00 AM,201,103,98,clear day,
2019,Winter,09:00:00 AM,0,0,0,partly cloudy day,
2019,Fall,06:00:00 AM,143,93,50,cloudy,
2019,Summer,01:00:00 PM,2013,890,1123,clear day,
2019,Spring,04:00:00 PM,3388,1440,1948,partly cloudy day,
2019,Winter,08:00:00 PM,9,7,2,clear night,Christmas Day
2019,Summer,07:00:00 PM,1393,762,631,partly cloudy day,
2019,Summer,01:00:00 PM,1573,664,909,cloudy,
2019,Fall,10:00:00 AM,1912,987,925,cloudy,
2019,Summer,10:00:00 PM,86,76,10,partly cloudy night,
2019,Spring,08:00:00 AM,198,66,132,cloudy,
2019,Winter,01:00:00 AM,3,0,3,clear night,
2019,Summer,06:00:00 PM,1760,1006,754,clear day,
2019,Fall,10:00:00 AM,1139,580,559,clear day,
2019,Spring,04:00:00 PM,1722,713,1009,partly cloudy day,
2019,Fall,04:00:00 AM,0,0,0,partly cloudy night,
2019,Summer,01:00:00 PM,1935,855,1080,partly cloudy day,
2019,Winter,04:00:00 PM,1536,685,851,clear day,
2019,Summer,03:00:00 PM,763,317,446,partly cloudy day,
2019,Summer,10:00:00 PM,23,11,12,cloudy,
2019,Summer,11:00:00 PM,6,0,6,clear night,
2019,Summer,12:00:00 AM,1,0,1,partly cloudy night,
2019,Spring,11:00:00 AM,1552,679,873,cloudy,
2019,Winter,01:00:00 PM,598,310,288,cloudy,
2019,Summer,03:00:00 PM,3096,1374,1722,partly cloudy day,
2019,Winter,03:00:00 AM,1,1,0,clear night,
2019,Fall,10:00:00 PM,12,4,8,clear night,
2019,Winter,03:00:00 PM,2410,1134,1276,partly cloudy day,
2019,Fall,06:00:00 AM,138,84,54,clear night,
2019,Spring,02:00:00 PM,1754,871,883,partly cloudy day,
2019,Fall,02:00:00 PM,2170,890,1280,partly cloudy day,
2019,Winter,03:00:00 PM,359,160,199,clear day,
2019,Fall,10:00:00 AM,751,422,329,partly cloudy day,Thanksgiving Day
2019,Winter,04:00:00 AM,0,0,0,clear night,
2019,Fall,12:00:00 AM,7,2,5,cloudy,
2019,Spring,01:00:00 PM,3386,1641,1745,partly cloudy day,
2019,Summer,01:00:00 AM,1,0,1,clear night,
2019,Spring,08:00:00 PM,96,46,50,cloudy,
2019,Winter,12:00:00 PM,53,29,24,rain,
2019,Summer,03:00:00 PM,1638,827,811,partly cloudy day,
2019,Spring,09:00:00 PM,46,27,19,clear night,
2019,Summer,10:00:00 PM,102,66,36,partly cloudy night,Father's Day
2019,Winter,11:00:00 PM,3,2,1,clear night,
2019,Summer,06:00:00 AM,125,62,63,clear day,
2019,Spring,01:00:00 AM,5,3,2,cloudy,Mother's Day
2019,Spring,08:00:00 PM,216,82,134,partly cloudy night,Easter Sunday
2019,Spring,03:00:00 PM,2929,1315,1614,partly cloudy day,
2019,Fall,03:00:00 AM,0,0,0,clear night,
2019,Winter,05:00:00 PM,369,163,206,clear night,
2019,Summer,12:00:00 PM,1805,837,968,partly cloudy day,
2019,Fall,03:00:00 AM,0,0,0,clear night,
2019,Winter,09:00:00 PM,34,33,1,clear night,
2019,Fall,10:00:00 PM,1,0,1,rain,
2019,Fall,07:00:00 PM,63,61,2,partly cloudy night,
2019,Spring,08:00:00 PM,7,2,5,cloudy,
2019,Fall,07:00:00 AM,312,119,193,partly cloudy day,
2019,Spring,11:00:00 AM,1207,613,594,clear day,
2019,Winter,06:00:00 PM,122,116,6,partly cloudy night,
2019,Fall,04:00:00 PM,1649,735,914,clear day,
2019,Summer,06:00:00 PM,2694,1271,1423,partly cloudy day,
2019,Spring,03:00:00 PM,2856,1212,1644,partly cloudy day,
2019,Spring,04:00:00 PM,3310,1341,1969,partly cloudy day,
2019,Winter,02:00:00 PM,760,359,401,clear day,
2019,Winter,11:00:00 AM,472,260,212,rain,
2019,Summer,08:00:00 PM,1264,499,765,clear day,
2019,Summer,09:00:00 PM,63,24,39,partly cloudy night,
2019,Summer,02:00:00 AM,1,0,1,clear night,
2019,Fall,11:00:00 PM,0,0,0,clear night,
2019,Spring,04:00:00 PM,2677,1163,1514,clear day,
2019,Fall,02:00:00 AM,0,0,0,rain,
2019,Fall,03:00:00 AM,2,0,2,cloudy,
2019,Winter,11:00:00 PM,10,0,10,partly cloudy night,
2019,Winter,02:00:00 AM,1,0,1,partly cloudy night,
2019,Winter,04:00:00 AM,8,6,2,cloudy,New Year's Day
2019,Winter,06:00:00 AM,9,6,3,cloudy,
2019,Summer,07:00:00 AM,258,128,130,partly cloudy day,
2019,Summer,09:00:00 AM,778,400,378,clear day,
2019,Spring,05:00:00 PM,1122,509,613,partly cloudy day,
2019,Winter,06:00:00 AM,8,6,2,cloudy,
2019,Winter,06:00:00 AM,17,9,8,cloudy,
2019,Winter,09:00:00 AM,464,284,180,clear day,
2019,Summer,05:00:00 AM,58,34,24,clear night,
2019,Summer,01:00:00 AM,3,2,1,cloudy,
2019,Spring,09:00:00 PM,35,33,2,partly cloudy night,
2019,Winter,04:00:00 PM,2135,920,1215,partly cloudy day,
2019,Summer,07:00:00 PM,274,154,120,rain,
2019,Winter,11:00:00 PM,8,0,8,rain,
2019,Summer,08:00:00 PM,763,307,456,partly cloudy night,
2019,Winter,12:00:00 PM,3180,1642,1538,cloudy,
2019,Winter,07:00:00 PM,37,35,2,clear night,
2019,Winter,06:00:00 PM,56,36,20,cloudy,
2019,Fall,01:00:00 AM,4,0,4,cloudy,
2019,Summer,11:00:00 PM,72,51,21,partly cloudy night,
2019,Fall,08:00:00 PM,1,0,1,clear night,
2019,Winter,05:00:00 AM,4,1,3,clear night,
2019,Summer,06:00:00 AM,152,79,73,clear day,
2019,Winter,12:00:00 AM,10,0,10,clear night,
2019,Spring,04:00:00 PM,2060,907,1153,clear day,St. Patrick's Day
2019,Spring,07:00:00 AM,82,41,41,cloudy,
2019,Summer,03:00:00 AM,0,0,0,rain,
2019,Summer,04:00:00 AM,0,0,0,partly cloudy night,
2019,Spring,01:00:00 AM,2,0,2,partly cloudy night,
2019,Summer,04:00:00 AM,0,0,0,partly cloudy night,
2019,Fall,08:00:00 AM,84,44,40,rain,
2019,Winter,10:00:00 PM,0,0,0,partly cloudy night,
2019,Summer,01:00:00 PM,2867,1317,1550,partly cloudy day,
2019,Fall,06:00:00 AM,130,80,50,clear night,
2019,Spring,06:00:00 AM,44,23,21,cloudy,
2019,Spring,08:00:00 AM,531,218,313,partly cloudy day,
2019,Summer,09:00:00 PM,19,6,13,partly cloudy night,
2019,Summer,11:00:00 PM,40,33,7,cloudy,
2019,Spring,02:00:00 AM,1,0,1,clear night,
2019,Summer,09:00:00 AM,611,330,281,partly cloudy day,
2019,Spring,11:00:00 AM,1465,688,777,clear day,
2019,Fall,06:00:00 PM,950,386,564,cloudy,
2019,Winter,12:00:00 AM,0,0,0,cloudy,New Year's Eve
2019,Summer,02:00:00 PM,1589,711,878,partly cloudy day,
2019,Winter,11:00:00 AM,1158,601,557,clear day,
2019,Spring,01:00:00 PM,1227,528,699,cloudy,
2019,Winter,08:00:00 PM,51,50,1,clear night,
2019,Spring,06:00:00 AM,138,57,81,partly cloudy day,
2019,Fall,02:00:00 PM,3216,1407,1809,partly cloudy day,
2019,Summer,10:00:00 AM,512,297,215,cloudy,
2019,Winter,02:00:00 AM,1,0,1,clear night,
2019,Winter,04:00:00 AM,0,0,0,clear night,
2019,Summer,10:00:00 AM,1514,814,700,clear day,
2019,Summer,11:00:00 PM,33,17,16,clear night,
2019,Winter,10:00:00 PM,18,10,8,clear night,
2019,Winter,07:00:00 AM,193,97,96,clear night,
2019,Winter,03:00:00 PM,1825,809,1016,clear day,
2019,Winter,02:00:00 AM,0,0,0,clear night,
2019,Fall,04:00:00 PM,2482,1056,1426,clear day,
2019,Spring,09:00:00 AM,345,151,194,cloudy,
2019,Summer,12:00:00 PM,2439,1200,1239,clear day,
2019,Fall,08:00:00 AM,533,287,246,partly cloudy day,
2019,Winter,01:00:00 PM,2086,1016,1070,clear day,
2019,Summer,11:00:00 AM,1772,845,927,partly cloudy day,
2019,Winter,03:00:00 AM,1,1,0,partly cloudy night,
2019,Summer,11:00:00 AM,1775,920,855,partly cloudy day,Independence Day
2019,Summer,10:00:00 AM,1354,724,630,partly cloudy day,
2019,Summer,12:00:00 AM,33,13,20,clear night,
2019,Summer,11:00:00 PM,16,11,5,cloudy,
2019,Winter,08:00:00 AM,314,120,194,partly cloudy day,
2019,Fall,03:00:00 PM,2019,905,1114,partly cloudy day,
2019,Winter,12:00:00 PM,2131,1015,1116,clear day,
2019,Summer,05:00:00 PM,1995,989,1006,partly cloudy day,
2019,Spring,10:00:00 AM,1657,886,771,clear day,
2019,Fall,08:00:00 PM,61,59,2,clear night,
2019,Winter,05:00:00 AM,1,1,0,clear night,
2019,Summer,05:00:00 AM,79,51,28,clear night,
2019,Fall,06:00:00 PM,1147,486,661,clear day,
2019,Winter,03:00:00 PM,985,534,451,partly cloudy day,
2019,Spring,01:00:00 PM,1295,568,727,clear day,
2019,Summer,03:00:00 AM,3,1,2,clear night,
2019,Summer,03:00:00 AM,0,0,0,cloudy,
2019,Fall,03:00:00 AM,1,0,1,partly cloudy night,
2019,Summer,04:00:00 PM,1659,850,809,cloudy,
2019,Winter,11:00:00 PM,27,0,27,cloudy,
2019,Spring,06:00:00 AM,90,63,27,clear night,
2019,Summer,08:00:00 PM,1001,442,559,partly cloudy day,
2019,Spring,04:00:00 AM,0,0,0,partly cloudy night,
2019,Fall,06:00:00 AM,108,66,42,cloudy,
2019,Summer,01:00:00 PM,2173,967,1206,partly cloudy day,
2019,Summer,02:00:00 PM,2706,1169,1537,cloudy,
2019,Summer,10:00:00 AM,730,360,370,cloudy,
2019,Spring,01:00:00 AM,1,0,1,clear night,
2019,Fall,06:00:00 PM,1100,541,559,cloudy,
2019,Spring,04:00:00 PM,3307,1367,1940,clear day,
2019,Winter,08:00:00 PM,243,0,243,clear night,Presidents' Day (regional holiday)
2019,Winter,09:00:00 AM,298,145,153,cloudy,
2019,Winter,06:00:00 PM,78,26,52,partly cloudy night,
2019,Spring,11:00:00 PM,49,33,16,partly cloudy night,
2019,Winter,06:00:00 PM,168,78,90,clear night,
2019,Fall,02:00:00 PM,525,217,308,partly cloudy day,
2019,Summer,08:00:00 PM,318,151,167,partly cloudy night,
2019,Summer,05:00:00 AM,11,9,2,cloudy,
2019,Winter,11:00:00 PM,43,0,43,clear night,
2019,Spring,05:00:00 PM,1763,931,832,partly cloudy day,
2019,Winter,06:00:00 PM,52,50,2,cloudy,
2019,Winter,10:00:00 AM,435,227,208,cloudy,
2019,Winter,07:00:00 PM,7,7,0,clear night,
2019,Fall,09:00:00 AM,513,267,246,partly cloudy day,
2019,Winter,12:00:00 AM,1,0,1,cloudy,Valentine's Day
2019,Summer,05:00:00 PM,2538,1368,1170,partly cloudy day,
2019,Spring,01:00:00 PM,2111,911,1200,partly cloudy day,
2019,Winter,04:00:00 PM,854,413,441,clear day,
2019,Fall,09:00:00 AM,506,269,237,cloudy,
2019,Spring,02:00:00 PM,1221,533,688,cloudy,
2019,Fall,06:00:00 AM,7,0,7,rain,Halloween
2019,Fall,11:00:00 PM,3,2,1,clear night,
2019,Summer,11:00:00 AM,2121,1237,884,partly cloudy day,
2019,Fall,06:00:00 PM,1615,848,767,partly cloudy day,
2019,Winter,01:00:00 AM,0,0,0,rain,
2019,Fall,09:00:00 PM,4,1,3,cloudy,
2019,Spring,09:00:00 AM,930,569,361,cloudy,
2019,Winter,04:00:00 PM,1930,896,1034,partly cloudy day,
2019,Spring,06:00:00 AM,27,17,10,clear night,
2019,Winter,08:00:00 PM,57,0,57,clear night,
2019,Winter,04:00:00 PM,776,344,432,partly cloudy day,
2019,Winter,09:00:00 PM,107,107,0,clear night,
2019,Spring,09:00:00 AM,773,431,342,partly cloudy day,
2019,Spring,03:00:00 AM,0,0,0,cloudy,
2019,Fall,08:00:00 PM,89,67,22,cloudy,
2019,Spring,04:00:00 AM,0,0,0,clear night,
2019,Summer,06:00:00 PM,910,511,399,rain,
2019,Fall,01:00:00 AM,0,0,0,clear night,
2019,Fall,09:00:00 AM,824,467,357,clear day,
2019,Spring,11:00:00 AM,2408,1160,1248,partly cloudy day,
2019,Fall,08:00:00 AM,145,58,87,cloudy,Halloween
2019,Fall,11:00:00 AM,645,266,379,cloudy,Labor Day
2019,Spring,02:00:00 AM,1,0,1,partly cloudy night,
2019,Spring,04:00:00 AM,0,0,0,cloudy,
2019,Spring,06:00:00 PM,1131,523,608,partly cloudy day,
2019,Fall,09:00:00 AM,513,287,226,cloudy,
2019,Summer,07:00:00 PM,173,79,94,cloudy,
2019,Spring,07:00:00 PM,420,177,243,clear day,
2019,Summer,08:00:00 PM,1041,462,579,partly cloudy day,
2019,Summer,05:00:00 PM,1353,709,644,rain,
2019,Spring,06:00:00 AM,198,99,99,cloudy,
2019,Summer,02:00:00 AM,0,0,0,partly cloudy night,
2019,Winter,12:00:00 PM,1175,534,641,clear day,
2019,Summer,02:00:00 AM,1,0,1,partly cloudy night,
2019,Fall,10:00:00 PM,9,6,3,partly cloudy night,Thanksgiving Day
2019,Summer,02:00:00 AM,0,0,0,partly cloudy night,
2019,Summer,09:00:00 PM,85,43,42,partly cloudy night,
2019,Winter,11:00:00 AM,948,427,521,cloudy,
2019,Fall,11:00:00 AM,1370,624,746,cloudy,
2019,Spring,03:00:00 PM,1869,936,933,clear day,
2019,Winter,12:00:00 AM,22,21,1,clear night,
2019,Fall,10:00:00 AM,1625,1094,531,cloudy,
2019,Winter,11:00:00 AM,1246,600,646,partly cloudy day,
2019,Spring,11:00:00 AM,3194,1624,1570,partly cloudy day,
2019,Spring,09:00:00 AM,607,341,266,partly cloudy day,
2019,Summer,09:00:00 AM,979,550,429,clear day,
2019,Summer,07:00:00 AM,303,125,178,partly cloudy day,
2019,Summer,02:00:00 AM,1,0,1,partly cloudy night,
2019,Fall,07:00:00 AM,211,89,122,cloudy,
2019,Fall,02:00:00 PM,1515,685,830,partly cloudy day,
2019,Winter,07:00:00 AM,161,95,66,cloudy,
2019,Summer,05:00:00 PM,1718,941,777,partly cloudy day,
2019,Spring,03:00:00 AM,1,0,1,rain,
2019,Spring,04:00:00 PM,693,300,393,partly cloudy day,
2019,Summer,04:00:00 PM,2079,1036,1043,partly cloudy day,
2019,Fall,12:00:00 PM,381,186,195,rain,
2019,Winter,04:00:00 AM,2,1,1,partly cloudy night,
2019,Fall,09:00:00 AM,627,297,330,clear day,
2019,Winter,09:00:00 AM,340,175,165,partly cloudy day,Valentine's Day
2019,Spring,12:00:00 AM,4,2,2,clear night,
2019,Winter,12:00:00 AM,3,0,3,cloudy,
2019,Fall,04:00:00 PM,1850,868,982,partly cloudy day,
2019,Fall,05:00:00 PM,93,44,49,rain,
2019,Winter,12:00:00 AM,0,0,0,clear night,
2019,Spring,12:00:00 PM,1754,828,926,partly cloudy day,
2019,Spring,04:00:00 AM,0,0,0,clear night,Easter Monday
2019,Winter,01:00:00 PM,1406,710,696,cloudy,Presidents' Day (regional holiday)
2019,Fall,07:00:00 PM,11,4,7,cloudy,Halloween
2019,Fall,04:00:00 PM,1519,672,847,cloudy,
2019,Spring,09:00:00 PM,15,12,3,rain,
2019,Winter,05:00:00 PM,46,39,7,cloudy,
2019,Spring,02:00:00 AM,3,2,1,clear night,Memorial Day
2019,Summer,04:00:00 PM,2378,1119,1259,partly cloudy day,
2019,Summer,03:00:00 AM,3,0,3,clear night,
2019,Summer,04:00:00 PM,2389,1082,1307,clear day,
2019,Winter,07:00:00 PM,36,35,1,clear night,
2019,Summer,01:00:00 AM,1,0,1,partly cloudy night,
2019,Summer,03:00:00 AM,0,0,0,partly cloudy night,
2019,Fall,09:00:00 AM,670,368,302,clear day,
2019,Spring,05:00:00 AM,0,0,0,clear night,
2019,Summer,06:00:00 PM,2564,1208,1356,partly cloudy day,
2019,Winter,02:00:00 AM,2,1,1,clear night,
2019,Spring,11:00:00 PM,0,0,0,clear night,
2019,Spring,02:00:00 AM,0,0,0,partly cloudy night,
2019,Fall,09:00:00 PM,20,13,7,clear night,
2019,Summer,10:00:00 PM,56,42,14,partly cloudy night,
2019,Winter,10:00:00 PM,19,8,11,partly cloudy night,
2019,Summer,01:00:00 PM,2679,1307,1372,clear day,
2019,Summer,04:00:00 PM,2584,1209,1375,partly cloudy day,
2019,Spring,11:00:00 AM,3207,1665,1542,partly cloudy day,Easter Sunday
2019,Fall,09:00:00 AM,592,318,274,partly cloudy day,
2019,Spring,11:00:00 PM,14,12,2,cloudy,
2019,Fall,03:00:00 PM,1941,836,1105,clear day,
2019,Winter,04:00:00 AM,0,0,0,clear night,
2019,Fall,03:00:00 AM,0,0,0,partly cloudy night,
2019,Summer,08:00:00 PM,1274,474,800,partly cloudy night,
2019,Winter,07:00:00 PM,0,0,0,partly cloudy night,
2019,Fall,12:00:00 PM,2260,1083,1177,cloudy,
2019,Summer,10:00:00 PM,34,17,17,partly cloudy night,
2019,Winter,10:00:00 PM,18,16,2,rain,
2019,Fall,06:00:00 PM,33,32,1,clear night,
2019,Spring,02:00:00 PM,1675,703,972,clear day,
2019,Fall,05:00:00 AM,0,0,0,clear night,
2019,Fall,11:00:00 PM,40,37,3,partly cloudy night,
2019,Spring,05:00:00 AM,1,0,1,cloudy,
2019,Fall,08:00:00 PM,17,15,2,rain,
2019,Winter,04:00:00 PM,1375,654,721,partly cloudy day,
2019,Winter,03:00:00 AM,0,0,0,cloudy,
2019,Winter,07:00:00 AM,74,33,41,cloudy,
2019,Winter,01:00:00 PM,1441,673,768,cloudy,
2019,Spring,10:00:00 AM,381,239,142,cloudy,
2019,Winter,11:00:00 AM,658,342,316,clear day,
2019,Fall,06:00:00 AM,103,76,27,clear night,
2019,Fall,03:00:00 PM,2487,1108,1379,partly cloudy day,
2019,Winter,12:00:00 AM,26,23,3,clear night,
2019,Spring,01:00:00 AM,0,0,0,partly cloudy night,
2019,Winter,11:00:00 PM,2,0,2,clear night,
2019,Summer,07:00:00 PM,2008,1013,995,partly cloudy day,
2019,Fall,04:00:00 AM,1,0,1,clear night,
2019,Winter,10:00:00 AM,2100,1255,845,clear day,
2019,Fall,10:00:00 AM,1687,953,734,cloudy,Columbus Day (regional holiday)
2019,Winter,03:00:00 AM,1,0,1,clear night,
2019,Winter,08:00:00 AM,64,24,40,clear day,
2019,Summer,03:00:00 AM,0,0,0,partly cloudy night,
2019,Spring,04:00:00 AM,0,0,0,cloudy,
2019,Winter,08:00:00 PM,19,0,19,clear night,
2019,Winter,12:00:00 PM,1695,742,953,rain,
2019,Spring,06:00:00 AM,17,8,9,rain,Tax Day
2019,Fall,03:00:00 AM,0,0,0,cloudy,
2019,Spring,09:00:00 AM,591,277,314,clear day,
2019,Fall,02:00:00 PM,2741,1196,1545,cloudy,
2019,Winter,03:00:00 AM,0,0,0,cloudy,
2019,Fall,05:00:00 PM,2042,1017,1025,partly cloudy day,
2019,Fall,10:00:00 PM,54,49,5,clear night,
2019,Summer,04:00:00 AM,0,0,0,cloudy,
2019,Spring,03:00:00 PM,3379,1514,1865,clear day,
2019,Summer,12:00:00 AM,7,3,4,partly cloudy night,
2019,Winter,11:00:00 AM,737,372,365,clear day,
2019,Spring,11:00:00 PM,2,0,2,clear night,
2019,Fall,01:00:00 AM,0,0,0,cloudy,Veterans Day
2019,Fall,04:00:00 PM,2332,1100,1232,partly cloudy day,
2019,Spring,02:00:00 AM,1,0,1,clear night,
2019,Spring,02:00:00 AM,0,0,0,clear night,
2019,Winter,08:00:00 AM,229,85,144,clear day,
2019,Spring,07:00:00 PM,1661,843,818,clear day,
2019,Winter,08:00:00 AM,33,15,18,rain,
2019,Summer,08:00:00 PM,864,364,500,partly cloudy day,
2019,Spring,08:00:00 AM,467,250,217,partly cloudy day,
2019,Summer,01:00:00 AM,4,0,4,clear night,
2019,Spring,05:00:00 AM,0,0,0,clear night,
2019,Winter,01:00:00 AM,11,9,2,cloudy,
2019,Spring,09:00:00 AM,639,350,289,clear day,
2019,Winter,08:00:00 PM,6,4,2,clear night,
2019,Winter,01:00:00 AM,0,0,0,clear night,
2019,Summer,07:00:00 PM,1629,812,817,partly cloudy day,
2019,Summer,02:00:00 PM,3133,1479,1654,partly cloudy day,
2019,Winter,04:00:00 AM,0,0,0,cloudy,
2019,Spring,01:00:00 AM,2,1,1,partly cloudy night,
2019,Spring,03:00:00 AM,0,0,0,clear night,
2019,Fall,07:00:00 AM,199,105,94,clear day,
2019,Winter,01:00:00 PM,1449,695,754,clear day,
2019,Spring,02:00:00 PM,3255,1654,1601,partly cloudy day,
2019,Fall,07:00:00 AM,191,100,91,clear day,Daylight Saving Time ends
2019,Fall,04:00:00 AM,1,0,1,clear night,
2019,Spring,06:00:00 AM,79,35,44,cloudy,
2019,Fall,06:00:00 AM,49,22,27,partly cloudy night,
2019,Fall,03:00:00 AM,2,0,2,partly cloudy night,
2019,Winter,11:00:00 PM,31,0,31,rain,
2019,Spring,03:00:00 PM,1290,619,671,cloudy,
2019,Winter,08:00:00 PM,13,10,3,clear night,
2019,Fall,06:00:00 PM,4,3,1,clear night,Black Friday
2019,Winter,11:00:00 PM,10,9,1,cloudy,
2019,Summer,05:00:00 AM,57,36,21,clear night,
2019,Fall,06:00:00 PM,631,221,410,partly cloudy night,
2019,Winter,07:00:00 PM,39,0,39,partly cloudy night,
2019,Winter,12:00:00 AM,4,3,1,cloudy,Presidents' Day (regional holiday)
2019,Winter,07:00:00 PM,0,0,0,partly cloudy night,
2019,Summer,03:00:00 PM,2895,1320,1575,partly cloudy day,
2019,Summer,04:00:00 AM,1,0,1,partly cloudy night,
2019,Spring,09:00:00 AM,707,368,339,partly cloudy day,
2019,Fall,11:00:00 AM,2362,1214,1148,cloudy,
2019,Spring,07:00:00 PM,2063,789,1274,clear day,
2019,Summer,06:00:00 PM,1562,896,666,clear day,
2019,Fall,11:00:00 PM,1,0,1,clear night,
2019,Spring,08:00:00 PM,6,3,3,clear night,
2019,Fall,03:00:00 PM,2097,936,1161,cloudy,
2019,Fall,05:00:00 PM,2770,1351,1419,clear day,
2019,Fall,03:00:00 AM,0,0,0,cloudy,
2019,Winter,08:00:00 PM,80,78,2,clear night,
2019,Summer,11:00:00 PM,22,10,12,clear night,
2019,Spring,03:00:00 PM,2606,1083,1523,clear day,
2019,Spring,08:00:00 AM,504,240,264,partly cloudy day,
2019,Spring,06:00:00 PM,1018,532,486,cloudy,
2019,Summer,10:00:00 PM,12,7,5,clear night,
2019,Summer,02:00:00 PM,2192,927,1265,cloudy,
2019,Spring,06:00:00 PM,141,48,93,rain,
2019,Winter,04:00:00 PM,787,386,401,partly cloudy day,
2019,Spring,05:00:00 AM,55,34,21,clear night,
2019,Spring,03:00:00 AM,0,0,0,partly cloudy night,
2019,Spring,01:00:00 PM,2707,1295,1412,partly cloudy day,
2019,Fall,05:00:00 PM,284,171,113,clear night,
2019,Spring,01:00:00 AM,0,0,0,partly cloudy night,
2019,Summer,04:00:00 AM,0,0,0,clear night,
2019,Summer,04:00:00 AM,0,0,0,partly cloudy night,
2019,Fall,06:00:00 PM,53,52,1,clear night,
2019,Fall,03:00:00 AM,2,1,1,clear night,
2019,Spring,12:00:00 AM,4,0,4,clear night,
2019,Winter,02:00:00 AM,1,0,1,cloudy,
2019,Winter,08:00:00 PM,3,1,2,clear night,
2019,Winter,10:00:00 AM,583,312,271,cloudy,
2019,Summer,09:00:00 PM,29,14,15,partly cloudy night,
2019,Spring,10:00:00 PM,17,0,17,clear night,
2019,Spring,09:00:00 AM,432,217,215,partly cloudy day,
2019,Summer,02:00:00 PM,2254,1118,1136,cloudy,
2019,Summer,05:00:00 AM,5,3,2,rain,
2019,Fall,09:00:00 AM,1008,615,393,clear day,
2019,Winter,11:00:00 AM,260,119,141,snow,
2019,Winter,05:00:00 PM,3,2,1,rain,
2019,Summer,01:00:00 PM,1464,616,848,partly cloudy day,
2019,Winter,12:00:00 AM,8,4,4,clear night,
2019,Fall,05:00:00 PM,1773,906,867,cloudy,
2019,Fall,01:00:00 AM,1,0,1,cloudy,
2019,Spring,07:00:00 PM,1930,887,1043,clear day,
2019,Fall,01:00:00 PM,1336,547,789,clear day,
2019,Summer,04:00:00 AM,1,0,1,clear night,
2019,Summer,09:00:00 PM,33,12,21,clear night,
2019,Fall,11:00:00 PM,4,1,3,partly cloudy night,
2019,Summer,04:00:00 AM,1,0,1,cloudy,
2019,Spring,08:00:00 AM,233,127,106,clear day,
2019,Winter,08:00:00 PM,64,60,4,partly cloudy night,
2019,Winter,04:00:00 AM,0,0,0,partly cloudy night,
2019,Fall,11:00:00 PM,39,33,6,cloudy,
2019,Spring,02:00:00 PM,878,408,470,partly cloudy day,
2019,Fall,01:00:00 PM,1875,841,1034,partly cloudy day,
2019,Summer,07:00:00 PM,2575,1312,1263,clear day,
2019,Fall,04:00:00 PM,1079,542,537,cloudy,
2019,Winter,01:00:00 PM,987,488,499,clear day,
2019,Summer,06:00:00 PM,2443,1127,1316,partly cloudy day,
2019,Winter,03:00:00 AM,4,2,2,rain,
2019,Fall,05:00:00 PM,2174,1140,1034,partly cloudy day,
2019,Spring,03:00:00 PM,2257,944,1313,cloudy,
2019,Fall,03:00:00 PM,1183,510,673,cloudy,
2019,Spring,07:00:00 PM,1495,833,662,partly cloudy day,
2019,Summer,10:00:00 AM,1008,573,435,cloudy,
2019,Summer,08:00:00 PM,1310,624,686,rain,
2019,Fall,11:00:00 AM,1263,551,712,cloudy,
2019,Summer,12:00:00 AM,5,2,3,clear night,
2019,Winter,08:00:00 PM,108,106,2,cloudy,
2019,Fall,04:00:00 AM,0,0,0,clear night,
2019,Spring,09:00:00 AM,1084,666,418,clear day,
2019,Winter,08:00:00 AM,234,89,145,cloudy,
2019,Fall,07:00:00 AM,147,66,81,partly cloudy day,
2019,Summer,01:00:00 AM,2,1,1,clear night,
2019,Spring,12:00:00 PM,1454,742,712,partly cloudy day,
2019,Fall,03:00:00 PM,2295,1109,1186,clear day,
2019,Fall,03:00:00 AM,0,0,0,partly cloudy night,
2019,Summer,05:00:00 AM,92,64,28,clear night,
2019,Spring,03:00:00 AM,1,0,1,rain,
2019,Spring,05:00:00 AM,32,25,7,cloudy,
2019,Winter,03:00:00 AM,0,0,0,clear night,
2019,Summer,05:00:00 PM,2810,1227,1583,partly cloudy day,
2019,Summer,08:00:00 PM,877,422,455,clear day,
2019,Winter,05:00:00 PM,23,21,2,rain,
2019,Summer,06:00:00 PM,1712,926,786,partly cloudy day,
2019,Spring,08:00:00 PM,379,145,234,cloudy,
2019,Summer,03:00:00 PM,752,363,389,clear day,
2019,Fall,05:00:00 PM,1943,1078,865,clear day,
2019,Winter,06:00:00 AM,35,18,17,clear night,
2019,Fall,06:00:00 PM,63,59,4,clear night,
2019,Fall,04:00:00 AM,0,0,0,clear night,
2019,Summer,07:00:00 AM,211,111,100,clear day,
2019,Fall,03:00:00 AM,0,0,0,cloudy,
2019,Spring,11:00:00 AM,635,309,326,partly cloudy day,Tax Day
2019,Fall,01:00:00 AM,0,0,0,clear night,
2019,Fall,10:00:00 AM,1203,750,453,partly cloudy day,
2019,Fall,06:00:00 AM,191,100,91,partly cloudy night,
2019,Spring,08:00:00 AM,432,119,313,clear day,
2019,Winter,11:00:00 AM,1448,758,690,partly cloudy day,
2019,Winter,12:00:00 PM,1604,705,899,partly cloudy day,
2019,Summer,08:00:00 AM,419,162,257,clear day,
2019,Fall,05:00:00 PM,380,193,187,rain,
2019,Summer,07:00:00 AM,198,81,117,cloudy,
2019,Winter,11:00:00 PM,29,8,21,cloudy,
2019,Fall,12:00:00 PM,2175,951,1224,clear day,
2019,Summer,05:00:00 AM,68,40,28,partly cloudy night,
2019,Summer,06:00:00 AM,222,99,123,clear day,
2019,Fall,07:00:00 PM,92,87,5,rain,
2019,Winter,03:00:00 PM,4141,2575,1566,partly cloudy day,New Year's Day
2019,Summer,06:00:00 AM,56,19,37,rain,
2019,Fall,02:00:00 AM,0,0,0,cloudy,
2019,Summer,02:00:00 PM,2180,957,1223,clear day,
2019,Summer,03:00:00 AM,0,0,0,clear night,
2019,Spring,10:00:00 AM,1014,487,527,cloudy,
2019,Spring,05:00:00 AM,0,0,0,rain,
2019,Summer,09:00:00 AM,564,283,281,clear day,
2019,Fall,08:00:00 PM,49,46,3,partly cloudy night,
2019,Summer,10:00:00 PM,18,11,7,clear night,
2019,Fall,03:00:00 AM,0,0,0,clear night,
2019,Fall,08:00:00 AM,249,83,166,clear day,
2019,Summer,04:00:00 AM,0,0,0,partly cloudy night,
2019,Winter,04:00:00 AM,2,0,2,partly cloudy night,
2019,Fall,08:00:00 AM,442,209,233,clear day,
2019,Summer,01:00:00 PM,2959,1278,1681,partly cloudy day,
2019,Fall,02:00:00 PM,1267,540,727,clear day,
2019,Winter,03:00:00 AM,0,0,0,clear night,
2019,Summer,04:00:00 PM,2074,939,1135,partly cloudy day,
2019,Winter,04:00:00 PM,2379,1179,1200,clear day,Christmas Eve
2019,Fall,08:00:00 AM,365,127,238,partly cloudy day,
2019,Winter,07:00:00 PM,55,22,33,cloudy,
2019,Winter,08:00:00 AM,235,70,165,clear day,
2019,Summer,03:00:00 AM,1,0,1,partly cloudy night,
2019,Summer,11:00:00 AM,1632,819,813,partly cloudy day,
2019,Winter,04:00:00 AM,0,0,0,clear night,
2019,Summer,10:00:00 AM,1207,705,502,partly cloudy day,
2019,Summer,08:00:00 PM,549,277,272,partly cloudy night,
2019,Summer,03:00:00 AM,0,0,0,partly cloudy night,
2019,Spring,07:00:00 PM,1135,524,611,partly cloudy day,
2019,Fall,03:00:00 PM,1611,763,848,cloudy,
2019,Winter,10:00:00 AM,673,338,335,cloudy,
2019,Fall,01:00:00 PM,1465,586,879,clear day,
2019,Winter,03:00:00 PM,4108,1236,2872,clear day,
2019,Spring,09:00:00 AM,348,198,150,clear day,
2019,Fall,11:00:00 AM,1771,862,909,clear day,
2019,Winter,08:00:00 PM,22,15,7,partly cloudy night,
2019,Summer,02:00:00 AM,0,0,0,clear night,
2019,Winter,10:00:00 AM,1205,596,609,cloudy,
2019,Spring,01:00:00 PM,1377,587,790,clear day,
2019,Spring,11:00:00 PM,20,11,9,cloudy,
2019,Spring,08:00:00 AM,281,104,177,cloudy,
2019,Winter,10:00:00 PM,2,0,2,cloudy,
2019,Winter,02:00:00 PM,2171,949,1222,partly cloudy day,
2019,Summer,08:00:00 PM,664,261,403,partly cloudy day,
2019,Spring,08:00:00 AM,286,107,179,clear day,
2019,Spring,03:00:00 PM,1056,512,544,cloudy,
2019,Winter,08:00:00 PM,15,11,4,partly cloudy night,
2019,Fall,01:00:00 PM,1344,538,806,partly cloudy day,
2019,Summer,11:00:00 AM,1710,943,767,clear day,
2019,Summer,11:00:00 AM,1705,872,833,partly cloudy day,
2019,Fall,01:00:00 PM,1899,909,990,cloudy,
2019,Winter,10:00:00 AM,359,196,163,cloudy,
2019,Winter,03:00:00 AM,0,0,0,cloudy,
2019,Spring,04:00:00 AM,1,0,1,partly cloudy night,
2019,Summer,03:00:00 PM,1720,721,999,cloudy,
2019,Spring,05:00:00 PM,1846,872,974,partly cloudy day,
2019,Fall,11:00:00 PM,1,0,1,clear night,
2019,Winter,01:00:00 PM,0,0,0,partly cloudy day,
2019,Spring,06:00:00 AM,19,9,10,cloudy,
2019,Summer,12:00:00 AM,1,0,1,partly cloudy night,
2019,Spring,10:00:00 AM,1188,539,649,clear day,
2019,Winter,07:00:00 PM,16,0,16,rain,
2019,Fall,10:00:00 AM,1642,900,742,partly cloudy day,
2019,Fall,12:00:00 AM,20,19,1,cloudy,
2019,Spring,12:00:00 PM,2562,1190,1372,partly cloudy day,
2019,Spring,01:00:00 PM,1557,635,922,clear day,
2019,Fall,06:00:00 AM,183,96,87,clear night,
2019,Summer,11:00:00 AM,1641,866,775,partly cloudy day,
2019,Spring,11:00:00 AM,2662,1311,1351,clear day,
2019,Summer,08:00:00 PM,1729,700,1029,clear day,
2019,Spring,02:00:00 PM,2002,947,1055,clear day,
2019,Fall,08:00:00 PM,37,19,18,cloudy,
2019,Winter,01:00:00 AM,1,0,1,clear night,Christmas Eve
2019,Winter,10:00:00 AM,861,455,406,partly cloudy day,
2019,Summer,05:00:00 AM,17,14,3,partly cloudy night,
2019,Winter,02:00:00 AM,0,0,0,clear night,
2019,Summer,01:00:00 AM,4,3,1,clear night,
2019,Winter,07:00:00 AM,169,67,102,clear night,
2019,Winter,12:00:00 AM,3,2,1,clear night,
2019,Fall,04:00:00 AM,0,0,0,cloudy,
2019,Fall,06:00:00 AM,180,101,79,clear night,
2019,Summer,01:00:00 PM,2308,975,1333,partly cloudy day,
2019,Fall,03:00:00 AM,2,1,1,rain,
2019,Spring,05:00:00 PM,1561,829,732,snow,
2019,Winter,07:00:00 AM,116,62,54,partly cloudy day,
2019,Summer,11:00:00 PM,9,2,7,clear night,
2019,Fall,03:00:00 PM,2575,1154,1421,partly cloudy day,
2019,Summer,06:00:00 AM,88,42,46,cloudy,
2019,Spring,02:00:00 PM,697,324,373,cloudy,
2019,Spring,01:00:00 PM,2421,1164,1257,clear day,
2019,Fall,05:00:00 AM,0,0,0,clear night,
2019,Summer,08:00:00 AM,230,100,130,cloudy,
2019,Fall,10:00:00 PM,13,0,13,cloudy,
2019,Winter,04:00:00 PM,2604,1199,1405,clear day,
2019,Fall,02:00:00 AM,0,0,0,clear night,
2019,Summer,09:00:00 PM,123,51,72,partly cloudy night,
2019,Winter,09:00:00 PM,6,5,1,clear night,Martin Luther King Jr. Day
2019,Summer,07:00:00 PM,1944,1197,747,clear day,
2019,Summer,01:00:00 AM,5,2,3,cloudy,
2019,Fall,10:00:00 AM,1609,869,740,clear day,
2019,Spring,08:00:00 PM,10,0,10,cloudy,
2019,Fall,11:00:00 PM,1,0,1,clear night,
2019,Fall,01:00:00 PM,3250,1453,1797,partly cloudy day,
2019,Winter,09:00:00 AM,202,92,110,cloudy,
2019,Winter,07:00:00 AM,115,53,62,clear night,
2019,Summer,04:00:00 PM,2971,1269,1702,partly cloudy day,
2019,Winter,08:00:00 PM,3,0,3,clear night,
2019,Spring,02:00:00 AM,0,0,0,clear night,
2019,Spring,05:00:00 AM,46,35,11,partly cloudy night,
2019,Fall,04:00:00 PM,1456,717,739,clear day,
2019,Summer,06:00:00 PM,1850,846,1004,clear day,
2019,Summer,09:00:00 AM,667,261,406,partly cloudy day,
2019,Summer,09:00:00 PM,94,28,66,clear night,
2019,Summer,01:00:00 PM,2038,902,1136,partly cloudy day,
2019,Winter,06:00:00 PM,131,92,39,clear night,
2019,Winter,03:00:00 PM,670,314,356,rain,
2019,Spring,01:00:00 PM,2788,1172,1616,partly cloudy day,
2019,Spring,10:00:00 PM,24,8,16,clear night,
2019,Summer,12:00:00 AM,5,1,4,clear night,
2019,Winter,08:00:00 PM,50,49,1,clear night,
2019,Fall,07:00:00 PM,42,40,2,partly cloudy night,
2019,Fall,11:00:00 PM,14,13,1,clear night,
2019,Winter,11:00:00 AM,798,338,460,wind,
2019,Fall,03:00:00 AM,0,0,0,clear night,
2019,Winter,02:00:00 PM,1042,450,592,clear day,
2019,Winter,11:00:00 AM,561,256,305,partly cloudy day,
2019,Spring,10:00:00 PM,5,3,2,partly cloudy night,
2019,Spring,06:00:00 PM,2976,1296,1680,partly cloudy day,
2019,Fall,12:00:00 AM,4,2,2,cloudy,Columbus Day (regional holiday)
2019,Spring,12:00:00 AM,3,1,2,clear night,
2019,Spring,06:00:00 PM,1197,624,573,cloudy,
2019,Summer,03:00:00 PM,2415,1086,1329,partly cloudy day,
2019,Summer,12:00:00 PM,2604,1235,1369,partly cloudy day,
2019,Winter,10:00:00 AM,370,186,184,partly cloudy day,
2019,Summer,02:00:00 AM,2,1,1,clear night,
2019,Winter,11:00:00 PM,50,50,0,clear night,
2019,Fall,11:00:00 AM,1579,738,841,clear day,Veterans Day
2019,Fall,09:00:00 AM,666,298,368,clear day,
2019,Winter,06:00:00 AM,4,2,2,partly cloudy night,Martin Luther King Jr. Day
2019,Summer,11:00:00 PM,52,40,12,clear night,
2019,Spring,08:00:00 AM,459,185,274,partly cloudy day,Easter Monday
2019,Spring,11:00:00 PM,31,28,3,cloudy,
2019,Spring,12:00:00 AM,7,5,2,partly cloudy night,Easter Sunday
2019,Fall,03:00:00 PM,2170,957,1213,partly cloudy day,
2019,Winter,11:00:00 AM,1254,660,594,clear day,
2019,Spring,05:00:00 AM,55,34,21,clear night,
2019,Summer,07:00:00 PM,2482,1256,1226,partly cloudy day,
2019,Summer,02:00:00 PM,2616,1245,1371,partly cloudy day,
2019,Fall,04:00:00 PM,1907,945,962,clear day,Veterans Day
2019,Summer,03:00:00 AM,0,0,0,cloudy,
2019,Summer,01:00:00 PM,1332,615,717,partly cloudy day,
2019,Fall,10:00:00 PM,1,1,0,clear night,
2019,Spring,04:00:00 AM,1,0,1,cloudy,
2019,Spring,05:00:00 AM,59,39,20,clear night,
2019,Winter,12:00:00 AM,0,0,0,wind,
2019,Fall,09:00:00 PM,13,9,4,partly cloudy night,
2019,Winter,01:00:00 PM,3471,1756,1715,cloudy,
2019,Summer,11:00:00 PM,14,13,1,clear night,
2019,Fall,09:00:00 AM,544,294,250,partly cloudy day,
2019,Fall,05:00:00 AM,0,0,0,partly cloudy night,
2019,Summer,09:00:00 AM,599,324,275,partly cloudy day,
2019,Fall,01:00:00 AM,2,0,2,partly cloudy night,
2019,Fall,11:00:00 PM,1,0,1,partly cloudy night,
2019,Winter,01:00:00 AM,0,0,0,clear night,
2019,Winter,02:00:00 AM,5,3,2,clear night,
2019,Summer,08:00:00 AM,202,94,108,rain,
2019,Winter,12:00:00 PM,1494,621,873,partly cloudy day,
2019,Winter,04:00:00 AM,0,0,0,clear night,
2019,Summer,02:00:00 AM,0,0,0,clear night,
2019,Spring,05:00:00 PM,1982,756,1226,clear day,
2019,Summer,10:00:00 AM,1513,890,623,clear day,
2019,Spring,09:00:00 PM,7,0,7,fog,Daylight Saving Time starts
2019,Spring,11:00:00 AM,2104,863,1241,partly cloudy day,
2019,Fall,06:00:00 PM,64,61,3,partly cloudy night,
2019,Winter,01:00:00 PM,890,394,496,rain,
2019,Spring,12:00:00 AM,1,1,0,partly cloudy night,
2019,Summer,10:00:00 PM,35,21,14,clear night,
2019,Winter,11:00:00 PM,1,0,1,partly cloudy night,
2019,Summer,10:00:00 PM,21,9,12,clear night,
2019,Winter,04:00:00 AM,0,0,0,clear night,
2019,Summer,07:00:00 PM,1646,885,761,clear day,
2019,Winter,08:00:00 AM,322,151,171,clear day,
2019,Summer,12:00:00 AM,10,5,5,partly cloudy night,
2019,Spring,06:00:00 PM,1755,823,932,clear day,
2019,Fall,05:00:00 AM,0,0,0,cloudy,
2019,Spring,07:00:00 PM,1461,626,835,clear day,
2019,Summer,12:00:00 PM,224,136,88,rain,
2019,Summer,03:00:00 AM,0,0,0,clear night,
2019,Spring,01:00:00 AM,0,0,0,cloudy,
2019,Fall,10:00:00 AM,1792,1003,789,clear day,
2019,Summer,02:00:00 AM,1,1,0,clear night,
2019,Summer,08:00:00 AM,936,442,494,partly cloudy day,
2019,Summer,10:00:00 PM,33,23,10,partly cloudy night,
2019,Winter,06:00:00 AM,33,29,4,clear night,
2019,Winter,06:00:00 PM,192,159,33,clear night,
2019,Fall,03:00:00 PM,3093,1250,1843,clear day,
2019,Fall,02:00:00 PM,3185,1472,1713,cloudy,
2019,Summer,07:00:00 PM,1072,560,512,cloudy,
2019,Winter,12:00:00 PM,1161,453,708,cloudy,
2019,Summer,07:00:00 PM,1501,744,757,partly cloudy day,
2019,Winter,11:00:00 AM,1617,799,818,clear day,
2019,Winter,11:00:00 PM,25,0,25,clear night,
2019,Spring,01:00:00 AM,1,1,0,cloudy,
2019,Winter,10:00:00 AM,1358,760,598,clear day,
2019,Spring,08:00:00 PM,67,34,33,rain,
2019,Fall,11:00:00 PM,40,0,40,rain,
2019,Spring,11:00:00 AM,2632,1308,1324,clear day,
2019,Winter,01:00:00 AM,0,0,0,partly cloudy night,
2019,Summer,07:00:00 PM,1617,971,646,partly cloudy day,
2019,Fall,02:00:00 AM,0,0,0,clear night,
2019,Summer,09:00:00 AM,839,531,308,clear day,
2019,Summer,10:00:00 AM,1447,873,574,partly cloudy day,
2019,Summer,07:00:00 PM,1577,870,707,partly cloudy day,
2019,Winter,11:00:00 AM,549,292,257,cloudy,
2019,Spring,12:00:00 AM,24,22,2,cloudy,
2019,Summer,02:00:00 PM,183,90,93,rain,
2019,Spring,10:00:00 PM,13,11,2,cloudy,
2019,Summer,05:00:00 AM,17,15,2,clear night,
2019,Fall,06:00:00 PM,25,23,2,cloudy,
2019,Fall,01:00:00 PM,1758,760,998,cloudy,
2019,Summer,02:00:00 AM,2,0,2,rain,
2019,Summer,08:00:00 AM,407,170,237,cloudy,
2019,Fall,11:00:00 AM,1350,644,706,cloudy,
2019,Spring,09:00:00 AM,348,183,165,partly cloudy day,
2019,Fall,02:00:00 PM,2382,1040,1342,clear day,
2019,Spring,01:00:00 AM,0,0,0,partly cloudy night,
2019,Spring,07:00:00 AM,237,96,141,cloudy,
2019,Summer,05:00:00 AM,67,50,17,clear night,
2019,Summer,03:00:00 PM,1417,706,711,rain,
2019,Winter,08:00:00 AM,193,193,0,clear day,
2019,Spring,09:00:00 PM,0,0,0,clear night,
2019,Spring,10:00:00 AM,821,486,335,clear day,
2019,Fall,12:00:00 AM,3,1,2,clear night,
2019,Winter,09:00:00 PM,7,5,2,clear night,
2019,Spring,02:00:00 AM,1,0,1,cloudy,
2019,Spring,11:00:00 PM,34,31,3,cloudy,
2019,Winter,11:00:00 AM,728,355,373,clear day,
2019,Summer,11:00:00 PM,10,4,6,partly cloudy night,
2019,Fall,01:00:00 AM,3,0,3,partly cloudy night,
2019,Fall,12:00:00 AM,0,0,0,clear night,
2019,Spring,10:00:00 PM,11,10,1,rain,
2019,Spring,05:00:00 AM,3,0,3,partly cloudy night,
2019,Winter,04:00:00 AM,0,0,0,cloudy,New Year's Eve
2019,Fall,10:00:00 PM,6,5,1,rain,
2019,Winter,11:00:00 AM,1330,529,801,partly cloudy day,
2019,Winter,03:00:00 PM,745,371,374,cloudy,
2019,Spring,02:00:00 AM,0,0,0,partly cloudy night,
2019,Spring,10:00:00 AM,883,553,330,cloudy,
2019,Summer,09:00:00 AM,774,475,299,clear day,
2019,Spring,12:00:00 AM,0,0,0,clear night,
2019,Summer,04:00:00 AM,0,0,0,clear night,
2019,Fall,12:00:00 AM,4,3,1,clear night,
2019,Summer,05:00:00 AM,29,25,4,partly cloudy night,
2019,Winter,06:00:00 PM,5,5,0,clear night,
2019,Summer,12:00:00 PM,2088,941,1147,partly cloudy day,
2019,Summer,11:00:00 AM,1447,751,696,clear day,
2019,Spring,12:00:00 PM,1894,898,996,partly cloudy day,
2019,Fall,12:00:00 PM,360,188,172,rain,
2019,Fall,12:00:00 PM,608,264,344,rain,Halloween
2019,Winter,06:00:00 PM,7,6,1,clear night,Christmas Day
2019,Fall,05:00:00 PM,124,86,38,clear night,
2019,Spring,12:00:00 AM,0,0,0,clear night,
2019,Spring,07:00:00 PM,529,233,296,clear day,
2019,Fall,01:00:00 PM,2497,1185,1312,clear day,
2019,Summer,01:00:00 AM,0,0,0,clear night,
2019,Fall,05:00:00 PM,3291,1460,1831,partly cloudy day,
2019,Winter,11:00:00 PM,2,2,0,partly cloudy night,
2019,Spring,02:00:00 PM,2281,1061,1220,partly cloudy day,
2019,Spring,06:00:00 AM,106,67,39,clear night,
2019,Spring,02:00:00 AM,1,0,1,snow,
2019,Summer,12:00:00 AM,4,3,1,rain,
2019,Winter,05:00:00 AM,2,1,1,cloudy,
2019,Summer,02:00:00 PM,1431,629,802,partly cloudy day,
2019,Spring,05:00:00 PM,3152,1440,1712,partly cloudy day,
2019,Summer,05:00:00 PM,1900,748,1152,partly cloudy day,
2019,Winter,07:00:00 AM,0,0,0,clear night,
2019,Fall,02:00:00 PM,1756,784,972,partly cloudy day,
2019,Summer,11:00:00 PM,3,0,3,partly cloudy night,
2019,Fall,11:00:00 PM,4,2,2,cloudy,
2019,Winter,08:00:00 AM,46,14,32,rain,
2019,Winter,04:00:00 PM,1117,591,526,partly cloudy day,
2019,Spring,11:00:00 AM,2114,1131,983,partly cloudy day,
2019,Summer,09:00:00 PM,39,18,21,partly cloudy night,
2019,Fall,04:00:00 AM,0,0,0,clear night,
2019,Fall,06:00:00 PM,1189,587,602,cloudy,
2019,Fall,12:00:00 AM,2,0,2,partly cloudy night,
2019,Winter,02:00:00 PM,280,131,149,snow,
2019,Spring,12:00:00 AM,0,0,0,partly cloudy night,
2019,Fall,01:00:00 PM,1411,596,815,clear day,
2019,Winter,07:00:00 AM,53,31,22,snow,
2019,Fall,05:00:00 PM,849,449,400,cloudy,
2019,Winter,05:00:00 PM,63,62,1,cloudy,
2019,Winter,03:00:00 PM,1821,711,1110,cloudy,
2019,Spring,12:00:00 AM,24,23,1,partly cloudy night,
2019,Spring,11:00:00 PM,57,52,5,cloudy,
2019,Winter,03:00:00 AM,0,0,0,clear night,Christmas Day
2019,Fall,02:00:00 AM,5,3,2,rain,Halloween
2019,Spring,05:00:00 PM,1575,788,787,partly cloudy day,
2019,Fall,11:00:00 PM,1,0,1,clear night,
2019,Fall,07:00:00 PM,56,45,11,cloudy,
2019,Summer,09:00:00 AM,898,565,333,clear day,
2019,Summer,07:00:00 AM,188,93,95,clear day,Independence Day
2019,Summer,12:00:00 PM,1970,869,1101,partly cloudy day,
2019,Spring,09:00:00 PM,6,0,6,cloudy,
2019,Winter,11:00:00 AM,615,299,316,partly cloudy day,
2019,Winter,04:00:00 AM,0,0,0,clear night,
2019,Spring,05:00:00 AM,1,0,1,cloudy,
2019,Summer,12:00:00 AM,3,1,2,cloudy,
2019,Fall,02:00:00 PM,2682,1100,1582,cloudy,
2019,Spring,04:00:00 AM,0,0,0,cloudy,
2019,Fall,11:00:00 PM,29,27,2,cloudy,
2019,Summer,01:00:00 PM,2957,1381,1576,clear day,
2019,Fall,08:00:00 PM,43,35,8,partly cloudy night,
2019,Summer,03:00:00 PM,1598,678,920,partly cloudy day,
2019,Spring,04:00:00 AM,1,0,1,partly cloudy night,
2019,Spring,10:00:00 AM,1003,567,436,clear day,
2019,Spring,02:00:00 AM,1,0,1,clear night,
2019,Summer,12:00:00 AM,17,12,5,partly cloudy night,
2019,Fall,08:00:00 AM,467,207,260,clear day,
2019,Fall,11:00:00 PM,34,31,3,partly cloudy night,
2019,Spring,11:00:00 PM,0,0,0,clear night,
2019,Fall,09:00:00 PM,40,31,9,partly cloudy night,
2019,Summer,01:00:00 PM,2036,842,1194,partly cloudy day,
2019,Winter,03:00:00 AM,0,0,0,clear night,
2019,Winter,11:00:00 AM,305,160,145,partly cloudy day,Martin Luther King Jr. Day
2019,Summer,08:00:00 PM,132,53,79,partly cloudy night,
2019,Winter,08:00:00 AM,276,117,159,cloudy,
2019,Spring,05:00:00 PM,790,382,408,cloudy,Cinco de Mayo
2019,Fall,11:00:00 AM,1533,758,775,partly cloudy day,
2019,Spring,08:00:00 AM,276,109,167,cloudy,
2019,Spring,07:00:00 AM,201,88,113,clear day,
2019,Winter,04:00:00 AM,2,2,0,clear night,
2019,Fall,01:00:00 AM,0,0,0,clear night,
2019,Spring,09:00:00 AM,284,201,83,cloudy,
2019,Fall,08:00:00 PM,52,40,12,partly cloudy night,
2019,Spring,12:00:00 PM,1913,915,998,partly cloudy day,St. Patrick's Day
2019,Spring,06:00:00 PM,1368,689,679,partly cloudy day,
2019,Winter,06:00:00 AM,18,11,7,cloudy,
2019,Spring,11:00:00 PM,25,24,1,cloudy,
2019,Fall,08:00:00 PM,4,4,0,clear night,
2019,Fall,07:00:00 PM,22,16,6,partly cloudy night,
2019,Summer,09:00:00 PM,63,48,15,cloudy,
2019,Spring,01:00:00 AM,0,0,0,partly cloudy night,
2019,Fall,01:00:00 AM,0,0,0,clear night,
2019,Summer,01:00:00 PM,2310,1087,1223,partly cloudy day,
2019,Fall,11:00:00 PM,6,5,1,cloudy,
2019,Summer,07:00:00 PM,2523,1253,1270,partly cloudy day,
2019,Winter,04:00:00 PM,1317,669,648,partly cloudy day,
2019,Summer,10:00:00 AM,1199,702,497,partly cloudy day,
2019,Fall,07:00:00 AM,281,103,178,clear day,
2019,Spring,04:00:00 AM,1,0,1,partly cloudy night,
2019,Spring,11:00:00 PM,4,3,1,cloudy,
2019,Spring,10:00:00 PM,65,56,9,partly cloudy night,
2019,Winter,04:00:00 PM,276,144,132,clear day,Martin Luther King Jr. Day
2019,Summer,01:00:00 AM,4,1,3,clear night,
2019,Winter,10:00:00 PM,8,3,5,snow,
2019,Summer,10:00:00 PM,23,9,14,clear night,
2019,Fall,07:00:00 PM,71,61,10,clear night,
2019,Winter,04:00:00 AM,0,0,0,rain,
2019,Fall,12:00:00 PM,1814,751,1063,cloudy,
2019,Winter,01:00:00 PM,1282,546,736,clear day,Valentine's Day
2019,Fall,10:00:00 PM,3,0,3,clear night,
2019,Fall,02:00:00 AM,1,0,1,cloudy,
2019,Fall,01:00:00 AM,0,0,0,partly cloudy night,Black Friday
2019,Winter,05:00:00 PM,73,66,7,clear night,
2019,Winter,04:00:00 AM,0,0,0,partly cloudy night,
2019,Winter,11:00:00 PM,6,0,6,rain,
2019,Spring,08:00:00 AM,540,292,248,clear day,
2019,Fall,03:00:00 PM,2577,1152,1425,clear day,Columbus Day (regional holiday)
2019,Fall,10:00:00 PM,21,11,10,partly cloudy night,
2019,Winter,05:00:00 AM,0,0,0,clear night,
2019,Summer,08:00:00 PM,1336,602,734,clear day,
2019,Summer,06:00:00 AM,152,77,75,partly cloudy night,
2019,Winter,12:00:00 PM,561,238,323,clear day,
2019,Winter,04:00:00 PM,783,371,412,partly cloudy day,
2019,Fall,08:00:00 AM,439,160,279,clear day,
2019,Spring,04:00:00 PM,393,155,238,cloudy,
2019,Fall,07:00:00 AM,315,140,175,cloudy,
2019,Fall,10:00:00 PM,7,4,3,clear night,
2019,Winter,11:00:00 AM,1975,1023,952,partly cloudy day,
2019,Spring,04:00:00 AM,3,0,3,rain,Cinco de Mayo
2019,Spring,11:00:00 AM,1779,927,852,partly cloudy day,
2019,Spring,11:00:00 PM,12,6,6,cloudy,
2019,Winter,06:00:00 PM,180,160,20,cloudy,
2019,Summer,04:00:00 PM,1622,835,787,clear day,
2019,Spring,05:00:00 PM,1418,728,690,clear day,
2019,Winter,04:00:00 AM,0,0,0,rain,
2019,Winter,04:00:00 PM,971,450,521,clear day,
2019,Summer,02:00:00 AM,3,1,2,clear night,
2019,Fall,09:00:00 PM,21,0,21,rain,
2019,Spring,03:00:00 PM,3524,1532,1992,partly cloudy day,Easter Sunday
2019,Summer,06:00:00 PM,1441,515,926,cloudy,Father's Day
2019,Winter,06:00:00 AM,19,9,10,cloudy,
2019,Spring,01:00:00 AM,2,1,1,cloudy,
2019,Spring,10:00:00 PM,1,0,1,clear night,
2019,Winter,07:00:00 PM,23,22,1,cloudy,
2019,Summer,09:00:00 PM,48,11,37,partly cloudy night,
2019,Summer,06:00:00 AM,166,78,88,partly cloudy day,
2019,Winter,08:00:00 PM,21,0,21,cloudy,
2019,Winter,12:00:00 PM,1388,623,765,clear day,
2019,Fall,08:00:00 AM,305,168,137,partly cloudy day,
2019,Fall,01:00:00 AM,0,0,0,clear night,
2019,Spring,11:00:00 AM,1437,613,824,cloudy,
2019,Fall,07:00:00 PM,981,476,505,partly cloudy day,
2018,Winter,04:00:00 AM,0,0,0,clear night,
2017,Winter,03:00:00 AM,0,0,0,clear night,
2017,Fall,09:00:00 PM,225,99,126,clear night,
2017,Fall,04:00:00 AM,2,1,1,clear night,
2017,Fall,09:00:00 PM,196,102,94,clear night,
2017,Winter,03:00:00 PM,1724,915,809,partly cloudy day,New Year's Eve
2018,Winter,09:00:00 PM,74,50,24,clear night,
2017,Fall,02:00:00 AM,17,3,14,clear night,
2017,Winter,09:00:00 AM,480,266,214,partly cloudy day,
2017,Fall,04:00:00 AM,9,5,4,partly cloudy night,
2018,Winter,02:00:00 PM,966,455,511,clear day,
2018,Winter,02:00:00 PM,714,341,373,clear day,
2017,Winter,02:00:00 AM,4,0,4,partly cloudy night,
2017,Winter,01:00:00 PM,2649,1152,1497,clear day,
2018,Winter,04:00:00 AM,2,0,2,partly cloudy night,
2017,Fall,05:00:00 PM,2281,1232,1049,partly cloudy day,
2017,Winter,07:00:00 AM,129,63,66,partly cloudy night,
2017,Fall,05:00:00 PM,1779,667,1112,clear night,
2017,Winter,02:00:00 PM,1674,792,882,partly cloudy day,
2017,Winter,06:00:00 AM,61,35,26,cloudy,
2017,Fall,07:00:00 PM,361,237,124,clear night,
2017,Fall,05:00:00 AM,22,13,9,clear night,
2018,Winter,08:00:00 PM,59,38,21,clear night,
2017,Fall,04:00:00 PM,2085,786,1299,clear day,
2017,Winter,05:00:00 AM,23,15,8,clear night,
2017,Fall,05:00:00 AM,18,12,6,partly cloudy night,
2018,Winter,08:00:00 AM,103,30,73,rain,
2017,Fall,01:00:00 AM,17,9,8,clear night,
2017,Fall,06:00:00 PM,1470,834,636,clear day,
2018,Winter,09:00:00 AM,307,136,171,clear day,
2017,Winter,11:00:00 PM,38,29,9,clear night,
2017,Fall,02:00:00 PM,2069,895,1174,partly cloudy day,
2017,Fall,04:00:00 PM,986,422,564,partly cloudy day,
2018,Winter,03:00:00 PM,199,123,76,snow,
2018,Winter,02:00:00 AM,0,0,0,clear night,
2017,Fall,04:00:00 PM,1814,894,920,partly cloudy day,
2018,Winter,01:00:00 PM,652,341,311,clear day,
2017,Fall,05:00:00 AM,19,12,7,partly cloudy night,
2018,Winter,08:00:00 AM,39,16,23,clear day,
2018,Winter,08:00:00 AM,125,62,63,clear day,
2017,Winter,09:00:00 PM,69,28,41,clear night,
2017,Winter,07:00:00 PM,236,123,113,clear night,
2017,Fall,02:00:00 PM,1278,543,735,partly cloudy day,
2017,Winter,03:00:00 PM,2616,1445,1171,clear day,Christmas Eve
2017,Winter,01:00:00 AM,9,6,3,clear night,
2018,Winter,06:00:00 PM,404,271,133,clear night,
2017,Winter,08:00:00 AM,208,88,120,clear day,
2017,Winter,03:00:00 PM,966,439,527,clear day,
2017,Winter,03:00:00 AM,3,0,3,partly cloudy night,
2018,Winter,07:00:00 AM,111,56,55,clear night,
2017,Fall,11:00:00 PM,180,73,107,clear night,
2017,Winter,11:00:00 PM,40,14,26,partly cloudy night,
2017,Fall,01:00:00 AM,9,5,4,partly cloudy night,
2017,Fall,11:00:00 AM,1949,1130,819,partly cloudy day,
2017,Winter,01:00:00 AM,19,6,13,partly cloudy night,
2018,Winter,12:00:00 PM,841,437,404,clear day,
2018,Winter,08:00:00 PM,236,150,86,partly cloudy night,
2017,Fall,01:00:00 PM,1855,802,1053,clear day,
2017,Fall,06:00:00 AM,148,125,23,partly cloudy night,Daylight Saving Time ends
2017,Fall,09:00:00 PM,6,6,0,rain,
2018,Winter,05:00:00 PM,432,251,181,partly cloudy day,
2017,Fall,09:00:00 PM,393,162,231,cloudy,
2017,Fall,04:00:00 AM,4,3,1,clear night,
2017,Fall,11:00:00 PM,43,14,29,clear night,
2017,Fall,09:00:00 AM,535,244,291,clear day,
2018,Winter,03:00:00 PM,1219,595,624,partly cloudy day,
2017,Winter,03:00:00 AM,6,0,6,cloudy,
2017,Fall,05:00:00 AM,27,14,13,clear night,
2017,Winter,04:00:00 PM,1432,632,800,cloudy,
2017,Fall,07:00:00 PM,539,258,281,clear night,Black Friday
2018,Winter,03:00:00 AM,2,1,1,clear night,
2018,Winter,03:00:00 AM,0,0,0,partly cloudy night,
2017,Fall,02:00:00 PM,3093,1510,1583,clear day,
2017,Winter,02:00:00 AM,12,6,6,partly cloudy night,
2018,Winter,03:00:00 AM,8,5,3,cloudy,
2018,Winter,03:00:00 AM,3,2,1,clear night,
2018,Winter,08:00:00 AM,116,41,75,cloudy,
2017,Fall,03:00:00 AM,4,2,2,partly cloudy night,
2017,Fall,02:00:00 AM,5,4,1,clear night,Veterans Day observed
2017,Winter,02:00:00 PM,1772,824,948,partly cloudy day,
2017,Fall,12:00:00 PM,2098,1012,1086,clear day,
2018,Winter,03:00:00 PM,889,448,441,partly cloudy day,Martin Luther King Jr. Day
2017,Fall,06:00:00 PM,1535,933,602,clear day,
2018,Winter,12:00:00 AM,8,4,4,clear night,Martin Luther King Jr. Day
2017,Fall,05:00:00 AM,19,10,9,clear night,
2017,Fall,12:00:00 AM,44,30,14,clear night,
2017,Fall,03:00:00 AM,3,1,2,partly cloudy night,
2018,Winter,03:00:00 AM,1,0,1,clear night,
2017,Fall,09:00:00 AM,579,325,254,partly cloudy day,
2017,Fall,03:00:00 AM,5,2,3,partly cloudy night,
2017,Fall,06:00:00 PM,1534,589,945,clear night,
2017,Winter,06:00:00 PM,155,103,52,partly cloudy night,
2017,Fall,11:00:00 PM,45,29,16,clear night,Thanksgiving Day
2017,Winter,12:00:00 PM,1361,561,800,clear day,
2017,Winter,06:00:00 AM,51,28,23,clear night,
2017,Fall,04:00:00 PM,1733,964,769,clear day,
2017,Winter,01:00:00 PM,1781,766,1015,clear day,
2018,Winter,12:00:00 AM,41,38,3,partly cloudy night,
2017,Winter,06:00:00 PM,800,461,339,clear night,
2017,Fall,06:00:00 AM,32,17,15,partly cloudy night,
2017,Winter,06:00:00 AM,20,15,5,clear night,
2017,Fall,01:00:00 AM,29,16,13,clear night,
2017,Fall,04:00:00 PM,2824,1280,1544,partly cloudy day,
2018,Winter,06:00:00 PM,589,286,303,clear night,
2018,Winter,11:00:00 AM,432,250,182,clear day,
2017,Winter,07:00:00 AM,92,48,44,partly cloudy night,
2017,Fall,12:00:00 AM,28,6,22,partly cloudy night,
2017,Winter,01:00:00 PM,2031,936,1095,clear day,
2017,Winter,10:00:00 PM,84,65,19,partly cloudy night,
2017,Fall,12:00:00 AM,23,11,12,clear night,
2017,Fall,05:00:00 PM,638,263,375,clear night,Veterans Day observed
2017,Fall,02:00:00 AM,46,25,21,partly cloudy night,
2017,Fall,11:00:00 AM,1252,606,646,partly cloudy day,
2017,Fall,07:00:00 PM,739,249,490,clear night,
2017,Fall,06:00:00 AM,28,20,8,clear night,
2018,Winter,05:00:00 AM,4,2,2,clear night,
2018,Winter,04:00:00 PM,1674,763,911,clear day,
2017,Fall,06:00:00 AM,104,66,38,clear night,
2018,Winter,12:00:00 AM,6,4,2,partly cloudy night,
2017,Fall,06:00:00 PM,834,442,392,partly cloudy night,
2017,Winter,04:00:00 AM,4,3,1,partly cloudy night,
2017,Fall,09:00:00 PM,156,74,82,clear night,Veterans Day
2018,Winter,02:00:00 AM,16,7,9,clear night,New Year's Day
2017,Winter,05:00:00 AM,6,3,3,clear night,
2018,Winter,12:00:00 PM,694,351,343,clear day,
2017,Winter,12:00:00 PM,1166,444,722,clear day,
2017,Fall,02:00:00 PM,1167,451,716,clear day,
2017,Fall,07:00:00 PM,635,250,385,clear night,
2017,Winter,04:00:00 PM,2701,1375,1326,clear day,
2017,Fall,11:00:00 AM,640,302,338,partly cloudy day,
2017,Fall,10:00:00 AM,1667,945,722,clear day,Halloween
2017,Fall,06:00:00 PM,512,233,279,clear night,Thanksgiving Day
2017,Winter,10:00:00 AM,768,418,350,cloudy,
2017,Fall,01:00:00 AM,13,7,6,partly cloudy night,
2017,Fall,12:00:00 PM,1663,842,821,partly cloudy day,
2018,Winter,11:00:00 PM,56,18,38,clear night,New Year's Day
2018,Winter,06:00:00 AM,32,14,18,clear night,
2017,Fall,12:00:00 PM,1079,462,617,partly cloudy day,
2018,Winter,12:00:00 AM,39,28,11,partly cloudy night,
2017,Winter,10:00:00 AM,1238,603,635,partly cloudy day,
2018,Winter,04:00:00 AM,0,0,0,clear night,
2018,Winter,11:00:00 PM,45,32,13,rain,
2018,Winter,05:00:00 AM,4,2,2,partly cloudy night,
2018,Winter,07:00:00 PM,192,146,46,cloudy,
2018,Winter,04:00:00 AM,0,0,0,partly cloudy night,
2017,Winter,10:00:00 PM,75,27,48,clear night,Christmas Day
2017,Fall,03:00:00 AM,1,0,1,clear night,
2018,Winter,04:00:00 PM,845,422,423,partly cloudy day,
2017,Winter,08:00:00 AM,159,51,108,clear day,
2018,Winter,07:00:00 PM,176,105,71,clear night,
2017,Winter,10:00:00 AM,890,494,396,clear day,
2017,Fall,10:00:00 AM,953,494,459,clear day,Veterans Day
2018,Winter,07:00:00 AM,44,24,20,clear night,
2018,Winter,04:00:00 PM,475,217,258,partly cloudy day,
2018,Winter,01:00:00 AM,2,0,2,partly cloudy night,
2018,Winter,10:00:00 PM,35,18,17,clear night,
2017,Fall,09:00:00 AM,383,180,203,clear day,
2017,Fall,06:00:00 AM,78,46,32,clear night,
2017,Fall,08:00:00 PM,370,157,213,partly cloudy night,
2018,Winter,07:00:00 PM,297,216,81,clear night,
2017,Winter,09:00:00 AM,337,138,199,partly cloudy day,
2017,Winter,07:00:00 PM,256,154,102,clear night,
2018,Winter,04:00:00 PM,2294,1029,1265,clear day,
2017,Fall,09:00:00 PM,105,53,52,clear night,Halloween
2017,Fall,05:00:00 PM,840,449,391,partly cloudy night,
2018,Winter,07:00:00 AM,116,64,52,clear night,
2017,Winter,08:00:00 AM,389,146,243,partly cloudy day,
2018,Winter,12:00:00 PM,1586,806,780,clear day,
2017,Winter,10:00:00 PM,72,35,37,partly cloudy night,
2017,Fall,05:00:00 AM,16,12,4,partly cloudy night,
2017,Winter,12:00:00 AM,27,16,11,partly cloudy night,
2017,Fall,09:00:00 AM,503,261,242,cloudy,
2018,Winter,12:00:00 PM,1191,579,612,partly cloudy day,
2017,Fall,05:00:00 AM,15,9,6,partly cloudy night,
2017,Fall,05:00:00 PM,2101,1227,874,clear day,
2017,Fall,12:00:00 AM,50,21,29,partly cloudy night,
2017,Winter,11:00:00 AM,1793,945,848,clear day,
2018,Winter,02:00:00 AM,6,1,5,partly cloudy night,
2017,Fall,07:00:00 AM,277,142,135,clear night,
2017,Winter,07:00:00 AM,160,63,97,cloudy,
2017,Winter,02:00:00 AM,2,1,1,clear night,
2018,Winter,05:00:00 AM,2,2,0,clear night,
2017,Fall,02:00:00 PM,1583,686,897,clear day,
2017,Fall,07:00:00 PM,429,171,258,clear night,
2017,Fall,09:00:00 PM,95,46,49,clear night,
2017,Fall,02:00:00 PM,1587,714,873,partly cloudy day,
2017,Fall,08:00:00 AM,402,129,273,clear day,
2017,Fall,07:00:00 AM,272,148,124,clear night,
2017,Fall,07:00:00 AM,213,133,80,clear night,
2018,Winter,04:00:00 AM,14,7,7,cloudy,
2017,Winter,03:00:00 AM,2,0,2,clear night,
2017,Winter,05:00:00 PM,405,212,193,clear night,
2018,Winter,10:00:00 PM,141,76,65,partly cloudy night,
2017,Winter,09:00:00 PM,271,150,121,clear night,
2017,Fall,02:00:00 PM,1791,814,977,partly cloudy day,
2017,Winter,12:00:00 PM,2043,907,1136,clear day,
2017,Fall,05:00:00 AM,7,6,1,partly cloudy night,
2017,Fall,05:00:00 AM,1,0,1,partly cloudy night,
2017,Fall,09:00:00 AM,497,304,193,clear day,Black Friday
2017,Fall,10:00:00 AM,888,446,442,partly cloudy day,Columbus Day (regional holiday)
2017,Fall,09:00:00 PM,188,90,98,clear night,
2017,Fall,09:00:00 PM,168,131,37,clear night,
2017,Fall,09:00:00 AM,197,104,93,partly cloudy day,
2017,Fall,09:00:00 PM,111,57,54,partly cloudy night,Daylight Saving Time ends
2017,Fall,09:00:00 PM,143,99,44,partly cloudy night,
2017,Winter,10:00:00 PM,144,98,46,clear night,
2017,Winter,09:00:00 AM,754,418,336,clear day,
2017,Fall,10:00:00 AM,2478,1906,572,clear day,
2017,Winter,11:00:00 AM,1493,825,668,clear day,New Year's Eve
2017,Winter,01:00:00 AM,9,6,3,cloudy,
2018,Winter,05:00:00 PM,1176,504,672,clear day,
2017,Fall,10:00:00 PM,138,94,44,partly cloudy night,
2017,Winter,12:00:00 PM,815,359,456,partly cloudy day,
2017,Fall,10:00:00 AM,629,366,263,partly cloudy day,
2017,Winter,03:00:00 PM,652,364,288,fog,
2017,Winter,12:00:00 AM,26,15,11,partly cloudy night,
2017,Fall,01:00:00 AM,7,3,4,clear night,
2017,Fall,12:00:00 AM,31,16,15,clear night,
2017,Fall,08:00:00 AM,390,162,228,clear day,
2017,Winter,11:00:00 PM,77,54,23,partly cloudy night,
2017,Fall,09:00:00 AM,503,275,228,clear day,
2018,Winter,03:00:00 PM,376,201,175,partly cloudy day,
2018,Winter,10:00:00 PM,124,55,69,clear night,
2017,Winter,04:00:00 AM,1,0,1,clear night,
2017,Fall,02:00:00 PM,2344,1030,1314,clear day,Black Friday
2017,Fall,05:00:00 AM,24,14,10,partly cloudy night,
2018,Winter,04:00:00 AM,0,0,0,clear night,
2017,Winter,07:00:00 PM,421,167,254,partly cloudy night,Christmas Eve
2017,Fall,10:00:00 PM,127,58,69,clear night,
2017,Fall,10:00:00 PM,238,100,138,clear night,
2018,Winter,04:00:00 AM,5,2,3,fog,
2018,Winter,02:00:00 PM,510,252,258,rain,
2018,Winter,08:00:00 PM,11,10,1,rain,
2017,Winter,07:00:00 AM,140,59,81,partly cloudy night,
2017,Winter,07:00:00 PM,455,276,179,clear night,
2017,Fall,08:00:00 PM,514,245,269,clear night,
2017,Winter,12:00:00 AM,12,2,10,clear night,New Year's Eve
2017,Fall,12:00:00 PM,1910,871,1039,clear day,
2017,Winter,07:00:00 AM,39,13,26,cloudy,
2017,Fall,05:00:00 AM,21,17,4,partly cloudy night,
2018,Winter,12:00:00 PM,749,361,388,clear day,
2017,Fall,07:00:00 PM,409,178,231,clear night,
2018,Winter,12:00:00 AM,12,7,5,partly cloudy night,
2018,Winter,05:00:00 AM,11,4,7,clear night,
2017,Fall,03:00:00 AM,5,3,2,clear night,Thanksgiving Day
2017,Winter,05:00:00 AM,2,0,2,partly cloudy night,
2018,Winter,10:00:00 AM,412,245,167,clear day,
2017,Winter,12:00:00 AM,42,16,26,partly cloudy night,
2018,Winter,12:00:00 AM,9,4,5,cloudy,
2017,Fall,04:00:00 PM,2213,1207,1006,clear day,
2017,Fall,09:00:00 AM,535,280,255,clear day,
2017,Fall,10:00:00 PM,114,60,54,clear night,
2017,Fall,07:00:00 AM,147,69,78,clear day,
2018,Winter,04:00:00 AM,3,2,1,partly cloudy night,
2018,Winter,11:00:00 AM,541,277,264,clear day,
2017,Winter,08:00:00 AM,134,67,67,partly cloudy day,
2017,Fall,12:00:00 PM,1043,514,529,partly cloudy day,
2017,Fall,02:00:00 AM,10,2,8,partly cloudy night,
2017,Winter,11:00:00 PM,150,121,29,clear night,
2017,Winter,08:00:00 PM,233,107,126,partly cloudy night,
2018,Winter,11:00:00 AM,755,346,409,partly cloudy day,
2017,Winter,09:00:00 AM,250,97,153,partly cloudy day,
2017,Fall,10:00:00 PM,287,130,157,partly cloudy night,
2017,Fall,03:00:00 AM,0,0,0,clear night,
2017,Fall,01:00:00 AM,4,3,1,partly cloudy night,
2017,Winter,08:00:00 AM,295,98,197,clear day,
2018,Winter,12:00:00 PM,527,251,276,partly cloudy day,
2018,Winter,09:00:00 PM,89,50,39,partly cloudy night,
2017,Fall,09:00:00 AM,469,251,218,partly cloudy day,
2017,Fall,07:00:00 AM,169,74,95,clear day,
2017,Winter,10:00:00 AM,752,417,335,clear day,
2018,Winter,12:00:00 PM,1821,885,936,clear day,
2017,Fall,04:00:00 AM,9,6,3,partly cloudy night,
2017,Winter,02:00:00 AM,9,6,3,cloudy,Christmas Day
2017,Fall,10:00:00 AM,1224,684,540,partly cloudy day,
2017,Fall,10:00:00 AM,1080,591,489,partly cloudy day,
2017,Fall,09:00:00 AM,989,655,334,partly cloudy day,
2017,Winter,10:00:00 AM,1020,622,398,clear day,
2017,Winter,07:00:00 PM,547,256,291,clear night,
2017,Fall,10:00:00 PM,86,48,38,clear night,
2017,Fall,06:00:00 PM,384,204,180,partly cloudy night,
2018,Winter,08:00:00 AM,42,20,22,clear day,
2017,Fall,06:00:00 PM,480,305,175,clear night,
2017,Fall,10:00:00 PM,254,124,130,partly cloudy night,
2018,Winter,07:00:00 AM,81,39,42,cloudy,
2017,Fall,01:00:00 PM,3130,1525,1605,clear day,
2017,Fall,06:00:00 AM,41,24,17,partly cloudy night,
2017,Fall,03:00:00 PM,1193,553,640,partly cloudy day,
2017,Fall,08:00:00 PM,236,113,123,clear night,
2017,Fall,08:00:00 PM,255,107,148,partly cloudy night,
2017,Winter,06:00:00 PM,420,297,123,partly cloudy night,
2017,Fall,10:00:00 AM,1073,632,441,clear day,
2017,Fall,05:00:00 PM,2485,1241,1244,clear day,
2017,Winter,11:00:00 AM,1437,722,715,partly cloudy day,
2018,Winter,08:00:00 AM,58,28,30,clear day,New Year's Day
2018,Winter,08:00:00 PM,37,23,14,clear night,
2017,Fall,05:00:00 PM,1077,450,627,clear night,Veterans Day
2018,Winter,11:00:00 AM,563,299,264,partly cloudy day,
2018,Winter,08:00:00 PM,252,195,57,partly cloudy night,
2017,Winter,06:00:00 AM,5,2,3,partly cloudy night,Christmas Day
2018,Winter,08:00:00 AM,181,48,133,clear day,
2017,Winter,06:00:00 PM,590,358,232,clear night,
2018,Winter,07:00:00 PM,77,51,26,fog,
2017,Fall,07:00:00 PM,485,316,169,clear night,
2017,Fall,11:00:00 PM,63,46,17,partly cloudy night,
2018,Winter,03:00:00 AM,1,0,1,clear night,
2018,Winter,04:00:00 AM,4,1,3,partly cloudy night,Martin Luther King Jr. Day
2017,Winter,06:00:00 AM,29,15,14,partly cloudy night,
2017,Fall,06:00:00 PM,1659,1055,604,clear day,
2018,Winter,09:00:00 AM,205,98,107,clear day,
2018,Winter,07:00:00 PM,336,146,190,clear night,New Year's Day
2017,Fall,11:00:00 PM,30,16,14,clear night,
2017,Winter,04:00:00 PM,696,335,361,partly cloudy day,
2017,Fall,02:00:00 PM,2073,991,1082,partly cloudy day,
2017,Fall,01:00:00 AM,10,4,6,clear night,
2017,Fall,01:00:00 PM,1914,960,954,partly cloudy day,
2017,Winter,04:00:00 AM,0,0,0,clear night,Christmas Eve
2017,Fall,01:00:00 AM,29,19,10,partly cloudy night,Daylight Saving Time ends
2017,Fall,09:00:00 AM,523,270,253,clear day,
2017,Fall,12:00:00 AM,60,20,40,clear night,
2017,Fall,01:00:00 PM,1113,522,591,clear day,Veterans Day observed
2017,Fall,09:00:00 PM,100,51,49,partly cloudy night,
2017,Fall,02:00:00 PM,936,394,542,partly cloudy day,
2017,Fall,12:00:00 AM,47,29,18,clear night,
2017,Winter,05:00:00 AM,26,11,15,clear night,
2017,Winter,06:00:00 PM,184,60,124,partly cloudy night,
2017,Winter,03:00:00 PM,1607,842,765,clear day,
2017,Winter,06:00:00 PM,433,210,223,partly cloudy night,
2017,Winter,01:00:00 PM,1721,722,999,clear day,
2017,Winter,01:00:00 AM,19,15,4,clear night,
2018,Winter,06:00:00 AM,70,32,38,clear night,
2017,Fall,03:00:00 PM,1862,855,1007,clear day,
2017,Winter,05:00:00 PM,727,403,324,clear night,
2017,Fall,06:00:00 PM,580,364,216,clear night,
2017,Fall,01:00:00 PM,2016,983,1033,partly cloudy day,
2017,Winter,06:00:00 PM,619,307,312,clear night,
2017,Winter,08:00:00 PM,329,236,93,clear night,
2017,Winter,11:00:00 AM,1425,604,821,clear day,
2017,Fall,08:00:00 AM,555,372,183,partly cloudy day,
2017,Winter,01:00:00 PM,1577,822,755,partly cloudy day,
2017,Fall,01:00:00 PM,1413,419,994,partly cloudy day,
2017,Fall,10:00:00 PM,72,22,50,clear night,
2018,Winter,08:00:00 PM,97,36,61,clear night,
2018,Winter,12:00:00 AM,11,2,9,cloudy,
2017,Winter,03:00:00 AM,0,0,0,clear night,
2018,Winter,05:00:00 PM,811,368,443,clear day,
2017,Winter,05:00:00 PM,1022,433,589,partly cloudy night,
2017,Winter,11:00:00 PM,140,129,11,partly cloudy night,
2018,Winter,11:00:00 AM,662,351,311,clear day,
2017,Fall,04:00:00 AM,3,2,1,clear night,
2017,Winter,03:00:00 AM,1,0,1,clear night,
2017,Winter,12:00:00 AM,9,4,5,clear night,
2017,Fall,01:00:00 PM,1753,898,855,clear day,
2017,Winter,08:00:00 AM,276,110,166,partly cloudy day,
2017,Winter,06:00:00 AM,53,42,11,partly cloudy night,
2017,Fall,05:00:00 PM,837,400,437,partly cloudy night,
2017,Winter,11:00:00 PM,62,30,32,partly cloudy night,
2018,Winter,11:00:00 AM,726,385,341,clear day,
2018,Winter,05:00:00 AM,5,3,2,partly cloudy night,
2017,Fall,04:00:00 AM,5,3,2,clear night,
2017,Winter,03:00:00 PM,1599,759,840,clear day,
2017,Winter,06:00:00 PM,593,328,265,clear night,
2017,Fall,01:00:00 AM,27,15,12,clear night,
2017,Fall,06:00:00 AM,46,22,24,partly cloudy night,
2018,Winter,01:00:00 PM,657,319,338,partly cloudy day,
2017,Winter,03:00:00 PM,1843,851,992,partly cloudy day,
2017,Fall,03:00:00 AM,3,0,3,clear night,
2018,Winter,05:00:00 AM,10,7,3,clear night,
2017,Fall,05:00:00 PM,1713,820,893,partly cloudy day,
2018,Winter,02:00:00 PM,1004,478,526,clear day,
2017,Fall,05:00:00 AM,10,6,4,clear night,
2017,Winter,08:00:00 PM,266,182,84,clear night,
2017,Fall,04:00:00 AM,8,3,5,clear night,
2017,Fall,11:00:00 PM,53,28,25,clear night,
2017,Fall,05:00:00 PM,787,394,393,clear night,
2017,Fall,04:00:00 AM,2,1,1,clear night,Halloween
2017,Fall,03:00:00 PM,2298,1168,1130,clear day,Thanksgiving Day
2017,Fall,02:00:00 PM,2463,1339,1124,clear day,
2017,Winter,05:00:00 AM,14,8,6,partly cloudy night,
2018,Winter,11:00:00 AM,181,109,72,partly cloudy day,
2018,Winter,12:00:00 AM,5,2,3,clear night,
2018,Winter,12:00:00 PM,524,222,302,partly cloudy day,
2018,Winter,05:00:00 AM,1,0,1,partly cloudy night,
2017,Fall,06:00:00 PM,1396,820,576,partly cloudy night,
2017,Winter,04:00:00 PM,883,414,469,clear day,
2017,Fall,02:00:00 PM,1211,561,650,clear day,
2018,Winter,11:00:00 PM,24,19,5,fog,
2018,Winter,06:00:00 AM,55,33,22,clear night,
2017,Winter,05:00:00 PM,970,480,490,partly cloudy night,
2017,Winter,11:00:00 PM,22,9,13,cloudy,Christmas Eve
2017,Fall,04:00:00 PM,2531,1224,1307,partly cloudy day,
2018,Winter,10:00:00 AM,656,391,265,clear day,
2017,Winter,08:00:00 AM,146,45,101,clear day,
2017,Winter,04:00:00 AM,9,4,5,partly cloudy night,
2017,Fall,02:00:00 AM,8,7,1,clear night,Black Friday
2018,Winter,03:00:00 AM,6,3,3,clear night,
2017,Fall,11:00:00 PM,47,22,25,clear night,
2018,Winter,11:00:00 AM,609,348,261,clear day,
2017,Fall,05:00:00 PM,2334,1338,996,clear day,
2018,Winter,10:00:00 PM,6,4,2,rain,
2018,Winter,01:00:00 PM,1995,958,1037,clear day,
2018,Winter,07:00:00 PM,283,207,76,partly cloudy night,
2017,Fall,12:00:00 PM,1667,880,787,clear day,
2017,Fall,12:00:00 AM,147,85,62,clear night,
2017,Winter,11:00:00 PM,48,19,29,partly cloudy night,
2017,Fall,02:00:00 PM,1812,908,904,partly cloudy day,
2018,Winter,08:00:00 PM,277,178,99,partly cloudy night,
2017,Winter,11:00:00 AM,1257,603,654,partly cloudy day,
2018,Winter,05:00:00 AM,6,4,2,cloudy,
2017,Fall,10:00:00 AM,1516,886,630,clear day,
2018,Winter,08:00:00 PM,110,63,47,partly cloudy night,
2017,Winter,12:00:00 PM,1441,674,767,cloudy,
2017,Fall,04:00:00 PM,1516,692,824,partly cloudy day,
2018,Winter,09:00:00 AM,174,107,67,clear day,New Year's Day
2017,Fall,11:00:00 AM,1987,982,1005,partly cloudy day,
2017,Fall,03:00:00 AM,16,6,10,clear night,
2017,Fall,07:00:00 PM,357,179,178,clear night,
2017,Fall,10:00:00 PM,210,98,112,clear night,
2017,Winter,11:00:00 PM,199,142,57,clear night,
2018,Winter,06:00:00 PM,661,340,321,partly cloudy night,
2017,Fall,05:00:00 AM,28,17,11,partly cloudy night,
2017,Fall,06:00:00 AM,18,10,8,rain,
2017,Fall,07:00:00 AM,210,111,99,clear night,
2017,Fall,10:00:00 AM,1165,684,481,clear day,
2017,Fall,05:00:00 AM,16,11,5,partly cloudy night,
2017,Fall,08:00:00 AM,399,205,194,partly cloudy day,
2018,Winter,06:00:00 PM,608,307,301,clear night,
2017,Winter,02:00:00 AM,0,0,0,clear night,
2017,Fall,05:00:00 PM,1436,490,946,clear night,Black Friday
2017,Fall,07:00:00 AM,119,47,72,clear day,Thanksgiving Day
2017,Winter,01:00:00 AM,12,4,8,clear night,New Year's Eve
2017,Winter,05:00:00 PM,479,294,185,partly cloudy night,
2017,Fall,03:00:00 PM,1289,598,691,partly cloudy day,
2018,Winter,06:00:00 PM,261,121,140,clear night,Martin Luther King Jr. Day
2018,Winter,04:00:00 PM,353,228,125,rain,
2017,Winter,08:00:00 AM,126,60,66,clear day,
2018,Winter,05:00:00 PM,611,334,277,partly cloudy day,
2017,Fall,10:00:00 PM,86,56,30,clear night,
2017,Fall,09:00:00 PM,335,145,190,cloudy,
2017,Fall,03:00:00 PM,2100,914,1186,partly cloudy day,
2017,Winter,12:00:00 AM,32,24,8,partly cloudy night,
2018,Winter,06:00:00 PM,328,202,126,clear night,
2017,Winter,02:00:00 PM,2020,918,1102,clear day,
2017,Fall,04:00:00 AM,6,3,3,partly cloudy night,Columbus Day (regional holiday)
2017,Fall,10:00:00 PM,172,132,40,partly cloudy night,
2017,Fall,03:00:00 AM,7,3,4,clear night,
2017,Fall,04:00:00 AM,2,1,1,partly cloudy night,
2018,Winter,07:00:00 PM,32,27,5,rain,
2017,Fall,01:00:00 PM,1757,898,859,partly cloudy day,
2018,Winter,09:00:00 AM,97,29,68,rain,
2018,Winter,03:00:00 AM,10,6,4,partly cloudy night,
2018,Winter,04:00:00 AM,1,0,1,clear night,
2017,Fall,02:00:00 PM,2280,1199,1081,partly cloudy day,
2017,Fall,04:00:00 AM,6,2,4,clear night,
2017,Fall,01:00:00 PM,3191,1691,1500,clear day,
2018,Winter,03:00:00 PM,1881,859,1022,clear day,
2017,Winter,09:00:00 AM,640,375,265,partly cloudy day,
2018,Winter,08:00:00 PM,77,61,16,clear night,
2017,Winter,02:00:00 AM,10,9,1,clear night,
2017,Fall,01:00:00 AM,19,8,11,clear night,
2018,Winter,03:00:00 AM,7,2,5,clear night,
2017,Fall,02:00:00 PM,1580,760,820,partly cloudy day,
2017,Fall,07:00:00 AM,274,125,149,partly cloudy night,
2017,Winter,12:00:00 AM,103,97,6,clear night,
2018,Winter,01:00:00 AM,8,3,5,cloudy,
2017,Fall,02:00:00 PM,2743,1429,1314,clear day,
2017,Fall,01:00:00 PM,1034,500,534,cloudy,Daylight Saving Time ends
2017,Winter,08:00:00 PM,313,222,91,partly cloudy night,
2017,Fall,11:00:00 AM,1224,582,642,clear day,
2018,Winter,01:00:00 AM,15,9,6,partly cloudy night,
2017,Winter,09:00:00 AM,391,227,164,partly cloudy day,
2018,Winter,03:00:00 AM,0,0,0,clear night,
2017,Fall,07:00:00 AM,176,70,106,clear day,
2017,Winter,02:00:00 AM,12,4,8,clear night,
2017,Fall,09:00:00 PM,453,171,282,clear night,
2017,Fall,08:00:00 PM,481,143,338,clear night,
2017,Fall,07:00:00 PM,257,143,114,clear night,
2017,Fall,11:00:00 PM,61,27,34,clear night,
2017,Winter,09:00:00 AM,479,330,149,clear day,Christmas Day
2018,Winter,08:00:00 AM,65,29,36,clear day,Martin Luther King Jr. Day
2017,Fall,11:00:00 PM,96,46,50,clear night,Black Friday
2017,Winter,12:00:00 AM,19,7,12,partly cloudy night,
2017,Fall,01:00:00 PM,1580,816,764,clear day,
2017,Fall,06:00:00 AM,92,55,37,partly cloudy night,
2017,Winter,06:00:00 PM,606,372,234,cloudy,
2018,Winter,07:00:00 AM,175,68,107,cloudy,
2017,Winter,03:00:00 PM,1814,826,988,clear day,
2017,Fall,10:00:00 PM,155,79,76,clear night,
2017,Winter,01:00:00 AM,23,12,11,partly cloudy night,
2017,Fall,09:00:00 AM,403,227,176,clear day,Veterans Day observed
2017,Fall,09:00:00 PM,264,135,129,clear night,
2018,Winter,09:00:00 PM,36,11,25,partly cloudy night,
2017,Fall,06:00:00 AM,76,50,26,partly cloudy night,
2017,Fall,03:00:00 AM,5,2,3,partly cloudy night,
2017,Winter,12:00:00 PM,931,457,474,partly cloudy day,
2017,Fall,05:00:00 AM,11,6,5,clear night,
2017,Fall,08:00:00 PM,332,165,167,clear night,
2017,Fall,02:00:00 AM,6,2,4,cloudy,
2017,Winter,01:00:00 PM,904,432,472,partly cloudy day,
2017,Fall,06:00:00 AM,98,54,44,clear night,
2017,Fall,05:00:00 PM,713,371,342,clear night,
2017,Fall,08:00:00 AM,358,123,235,clear day,
2017,Fall,11:00:00 AM,800,384,416,partly cloudy day,
2018,Winter,07:00:00 PM,234,196,38,clear night,
2018,Winter,01:00:00 AM,5,0,5,clear night,
2017,Fall,01:00:00 PM,3059,1706,1353,partly cloudy day,
2017,Winter,11:00:00 AM,1143,566,577,partly cloudy day,
2017,Fall,08:00:00 AM,378,225,153,partly cloudy day,
2017,Winter,08:00:00 AM,241,96,145,partly cloudy day,
2018,Winter,02:00:00 PM,1331,671,660,clear day,
2018,Winter,12:00:00 AM,12,6,6,clear night,
2018,Winter,06:00:00 PM,489,351,138,partly cloudy night,
2017,Fall,12:00:00 PM,2088,1024,1064,clear day,
2017,Winter,10:00:00 PM,56,27,29,clear night,
2017,Winter,08:00:00 AM,183,84,99,clear day,Christmas Eve
2017,Winter,09:00:00 AM,471,241,230,clear day,
2017,Fall,01:00:00 AM,17,10,7,clear night,
2017,Winter,09:00:00 PM,156,138,18,partly cloudy night,
2017,Fall,04:00:00 PM,1923,953,970,clear day,
2018,Winter,09:00:00 PM,23,11,12,partly cloudy night,
2017,Winter,03:00:00 PM,796,332,464,partly cloudy day,
2017,Winter,06:00:00 AM,53,36,17,clear night,
2017,Fall,09:00:00 AM,616,341,275,clear day,
2018,Winter,01:00:00 PM,649,282,367,partly cloudy day,
2017,Fall,04:00:00 AM,5,4,1,partly cloudy night,
2017,Fall,06:00:00 PM,556,285,271,clear night,
2017,Winter,07:00:00 PM,368,264,104,partly cloudy night,
2017,Fall,06:00:00 AM,106,68,38,clear night,
2017,Winter,03:00:00 AM,2,1,1,partly cloudy night,
2017,Winter,02:00:00 AM,4,1,3,partly cloudy night,
2018,Winter,08:00:00 PM,323,154,169,clear night,
2018,Winter,12:00:00 PM,727,330,397,partly cloudy day,
2018,Winter,01:00:00 PM,1005,467,538,clear day,
2017,Fall,08:00:00 PM,284,199,85,partly cloudy night,
2017,Fall,09:00:00 PM,143,80,63,partly cloudy night,
2017,Fall,08:00:00 AM,355,129,226,clear day,
2017,Winter,11:00:00 PM,145,112,33,partly cloudy night,
2017,Fall,05:00:00 AM,19,13,6,clear night,
2018,Winter,09:00:00 PM,85,53,32,clear night,
2018,Winter,08:00:00 AM,187,61,126,partly cloudy day,
2017,Winter,03:00:00 PM,899,472,427,partly cloudy day,
2017,Winter,06:00:00 PM,358,203,155,clear night,
2018,Winter,02:00:00 PM,2066,1125,941,clear day,New Year's Day
2017,Fall,12:00:00 AM,29,12,17,partly cloudy night,
2017,Winter,01:00:00 AM,47,38,9,clear night,
2018,Winter,10:00:00 PM,61,48,13,clear night,
2018,Winter,05:00:00 AM,1,0,1,clear night,
2017,Fall,11:00:00 PM,43,21,22,clear night,
2017,Fall,07:00:00 PM,567,218,349,clear night,
2017,Fall,12:00:00 PM,1473,714,759,partly cloudy day,
2018,Winter,12:00:00 AM,4,1,3,partly cloudy night,
2017,Winter,02:00:00 AM,6,5,1,clear night,
2017,Fall,12:00:00 PM,3022,1533,1489,clear day,
2017,Fall,08:00:00 PM,665,213,452,clear night,
2017,Winter,01:00:00 AM,11,7,4,partly cloudy night,
2017,Fall,06:00:00 AM,44,24,20,clear night,Black Friday
2017,Fall,12:00:00 PM,1499,720,779,cloudy,
2017,Winter,08:00:00 AM,170,70,100,partly cloudy day,
2018,Winter,10:00:00 AM,370,200,170,clear day,
2018,Winter,08:00:00 PM,41,19,22,clear night,
2017,Winter,10:00:00 AM,757,414,343,clear day,
2017,Winter,11:00:00 AM,1802,906,896,clear day,Christmas Eve
2017,Fall,09:00:00 PM,240,139,101,clear night,
2017,Winter,05:00:00 PM,1296,553,743,clear night,
2017,Winter,11:00:00 AM,826,386,440,clear day,
2017,Fall,11:00:00 AM,882,335,547,partly cloudy day,
2017,Fall,10:00:00 AM,635,327,308,clear day,
2017,Winter,02:00:00 AM,1,0,1,clear night,
2017,Fall,03:00:00 PM,2217,1121,1096,partly cloudy day,
2017,Fall,05:00:00 AM,18,8,10,clear night,
2018,Winter,08:00:00 PM,47,35,12,clear night,
2017,Fall,11:00:00 AM,1738,931,807,clear day,
2017,Winter,03:00:00 PM,1818,864,954,clear day,
2018,Winter,10:00:00 PM,36,26,10,clear night,
2017,Fall,08:00:00 AM,120,51,69,partly cloudy day,
2017,Fall,05:00:00 AM,5,4,1,partly cloudy night,
2018,Winter,01:00:00 PM,871,404,467,partly cloudy day,
2017,Winter,12:00:00 AM,31,20,11,partly cloudy night,
2017,Fall,09:00:00 AM,1503,1300,203,partly cloudy day,
2018,Winter,09:00:00 PM,102,73,29,clear night,
2017,Fall,04:00:00 PM,1723,889,834,clear day,
2018,Winter,03:00:00 AM,8,4,4,clear night,
2018,Winter,10:00:00 AM,374,211,163,clear day,
2017,Fall,02:00:00 AM,7,5,2,clear night,
2018,Winter,03:00:00 AM,2,1,1,partly cloudy night,
2018,Winter,04:00:00 AM,1,0,1,clear night,
2017,Fall,11:00:00 PM,64,38,26,clear night,
2017,Fall,02:00:00 PM,3195,1380,1815,clear day,
2017,Fall,07:00:00 PM,368,175,193,partly cloudy night,Columbus Day (regional holiday)
2017,Fall,10:00:00 PM,193,89,104,clear night,
2017,Fall,01:00:00 PM,1572,770,802,clear day,
2018,Winter,12:00:00 AM,31,14,17,clear night,
2017,Winter,02:00:00 AM,8,6,2,partly cloudy night,
2017,Fall,05:00:00 AM,21,16,5,clear night,
2017,Fall,08:00:00 AM,306,128,178,clear day,
2017,Fall,06:00:00 PM,1187,488,699,clear night,
2017,Winter,10:00:00 AM,811,452,359,cloudy,
2017,Winter,04:00:00 PM,1735,728,1007,clear day,
2017,Winter,10:00:00 AM,1222,710,512,clear day,
2017,Fall,10:00:00 AM,1081,640,441,clear day,
2017,Fall,10:00:00 PM,141,65,76,clear night,
2017,Winter,04:00:00 AM,1,0,1,clear night,
2018,Winter,09:00:00 PM,55,33,22,partly cloudy night,
2017,Winter,10:00:00 AM,657,359,298,partly cloudy day,
2017,Fall,01:00:00 AM,22,11,11,partly cloudy night,
2017,Fall,10:00:00 AM,2355,1392,963,clear day,
2017,Fall,11:00:00 PM,139,81,58,clear night,
2017,Fall,01:00:00 AM,5,4,1,clear night,
2018,Winter,11:00:00 AM,71,36,35,snow,
2017,Fall,03:00:00 PM,1263,595,668,clear day,
2017,Fall,12:00:00 PM,1973,905,1068,partly cloudy day,
2017,Fall,12:00:00 PM,2420,1356,1064,partly cloudy day,
2017,Fall,10:00:00 PM,121,57,64,partly cloudy night,
2018,Winter,10:00:00 PM,56,30,26,clear night,
2017,Winter,09:00:00 PM,59,38,21,partly cloudy night,
2018,Winter,08:00:00 PM,120,86,34,clear night,
2017,Winter,06:00:00 PM,674,361,313,partly cloudy night,Christmas Eve
2017,Winter,04:00:00 PM,1739,791,948,clear day,
2018,Winter,11:00:00 AM,674,340,334,partly cloudy day,Martin Luther King Jr. Day
2017,Fall,02:00:00 PM,2369,1181,1188,partly cloudy day,
2017,Fall,12:00:00 PM,1709,899,810,clear day,
2017,Winter,09:00:00 PM,43,39,4,rain,
2017,Fall,05:00:00 PM,2298,1033,1265,cloudy,
2018,Winter,07:00:00 AM,34,21,13,clear night,
2017,Fall,06:00:00 AM,71,42,29,partly cloudy night,Veterans Day observed
2018,Winter,05:00:00 PM,626,322,304,partly cloudy night,
2017,Fall,07:00:00 AM,56,36,20,partly cloudy day,
2017,Fall,11:00:00 AM,1076,552,524,clear day,Thanksgiving Day
2017,Winter,09:00:00 AM,364,221,143,clear day,
2017,Fall,07:00:00 PM,322,220,102,clear night,
2017,Fall,05:00:00 AM,10,9,1,clear night,
2017,Winter,01:00:00 AM,17,9,8,clear night,Christmas Eve
2017,Fall,05:00:00 PM,23,13,10,rain,
2017,Fall,12:00:00 AM,84,48,36,clear night,
2017,Fall,02:00:00 AM,4,2,2,partly cloudy night,
2018,Winter,12:00:00 PM,1254,604,650,partly cloudy day,
2017,Fall,09:00:00 PM,116,70,46,clear night,Veterans Day observed
2017,Fall,10:00:00 PM,108,67,41,partly cloudy night,
2018,Winter,12:00:00 PM,642,304,338,partly cloudy day,
2017,Fall,03:00:00 AM,10,5,5,clear night,
2017,Winter,07:00:00 PM,296,175,121,cloudy,
2017,Winter,06:00:00 PM,547,234,313,clear night,Christmas Day
2017,Fall,05:00:00 PM,378,189,189,partly cloudy night,
2017,Fall,01:00:00 PM,1543,786,757,clear day,
2017,Fall,03:00:00 PM,82,37,45,rain,
2018,Winter,03:00:00 PM,943,458,485,clear day,
2018,Winter,01:00:00 PM,885,400,485,clear day,
2017,Winter,08:00:00 AM,254,89,165,clear day,
2017,Fall,09:00:00 AM,485,284,201,clear day,
2017,Fall,04:00:00 PM,1780,957,823,partly cloudy day,
2018,Winter,02:00:00 AM,2,1,1,clear night,
2018,Winter,01:00:00 AM,17,9,8,clear night,
2018,Winter,01:00:00 AM,53,51,2,partly cloudy night,
2018,Winter,05:00:00 AM,1,0,1,partly cloudy night,
2017,Fall,03:00:00 PM,1650,794,856,clear day,
2017,Fall,01:00:00 PM,1572,792,780,partly cloudy day,
2017,Fall,10:00:00 AM,1650,994,656,clear day,
2017,Winter,12:00:00 AM,40,25,15,partly cloudy night,
2017,Fall,01:00:00 PM,1424,659,765,partly cloudy day,
2017,Fall,08:00:00 PM,9,5,4,rain,
2017,Winter,06:00:00 AM,7,5,2,clear night,New Year's Eve
2017,Fall,02:00:00 PM,2398,1137,1261,clear day,Halloween
2017,Fall,05:00:00 AM,24,16,8,clear night,
2017,Fall,07:00:00 AM,172,74,98,clear night,
2018,Winter,11:00:00 AM,308,187,121,cloudy,
2017,Fall,05:00:00 AM,17,11,6,partly cloudy night,
2017,Fall,08:00:00 PM,344,0,0,partly cloudy night,
2017,Fall,02:00:00 AM,1,1,0,partly cloudy night,
2017,Winter,02:00:00 PM,1826,773,1053,partly cloudy day,
2018,Winter,03:00:00 AM,0,0,0,clear night,
2017,Winter,08:00:00 PM,115,82,33,clear night,
2017,Fall,04:00:00 PM,1116,518,598,cloudy,
2018,Winter,12:00:00 PM,934,421,513,partly cloudy day,
2018,Winter,10:00:00 AM,571,333,238,clear day,
2017,Fall,09:00:00 PM,264,134,130,clear night,
2017,Fall,03:00:00 PM,1035,479,556,partly cloudy day,
2017,Fall,12:00:00 PM,1941,1049,892,clear day,
2017,Winter,02:00:00 PM,1545,608,937,clear day,
2018,Winter,12:00:00 AM,8,1,7,clear night,
2017,Fall,06:00:00 AM,62,38,24,partly cloudy night,
2018,Winter,07:00:00 PM,119,60,59,clear night,
2018,Winter,03:00:00 AM,0,0,0,rain,
2017,Fall,02:00:00 AM,2,1,1,clear night,
2018,Winter,12:00:00 PM,818,357,461,partly cloudy day,
2017,Fall,12:00:00 PM,1668,863,805,clear day,
2017,Winter,02:00:00 PM,1869,746,1123,partly cloudy day,
2017,Winter,01:00:00 AM,8,6,2,clear night,
2017,Fall,05:00:00 PM,1907,1135,772,clear day,
2017,Fall,07:00:00 AM,170,84,86,clear night,
2017,Fall,01:00:00 PM,1862,906,956,clear day,
2017,Fall,12:00:00 PM,3486,1925,1561,clear day,
2017,Winter,10:00:00 AM,241,132,109,rain,
2017,Fall,02:00:00 PM,2209,987,1222,clear day,Veterans Day
2018,Winter,01:00:00 AM,7,6,1,partly cloudy night,
2018,Winter,10:00:00 AM,1004,626,378,clear day,
2017,Fall,03:00:00 AM,5,3,2,clear night,
2017,Fall,01:00:00 AM,21,11,10,partly cloudy night,
2017,Fall,04:00:00 AM,1,0,1,clear night,Veterans Day
2018,Winter,03:00:00 PM,712,324,388,clear day,
2018,Winter,06:00:00 AM,13,5,8,partly cloudy night,
2018,Winter,11:00:00 PM,30,18,12,clear night,
2017,Fall,05:00:00 PM,773,393,380,clear night,
2017,Fall,08:00:00 PM,393,180,213,partly cloudy night,
2017,Winter,03:00:00 PM,2588,1399,1189,clear day,
2018,Winter,02:00:00 PM,484,259,225,partly cloudy day,
2017,Fall,03:00:00 AM,8,6,2,clear night,
2017,Fall,01:00:00 PM,1193,478,715,clear day,
2017,Winter,11:00:00 PM,116,84,32,clear night,
2017,Fall,08:00:00 PM,353,184,169,clear night,
2017,Fall,01:00:00 AM,7,3,4,partly cloudy night,
2018,Winter,08:00:00 PM,83,50,33,clear night,
2018,Winter,01:00:00 PM,845,366,479,clear day,
2017,Fall,01:00:00 AM,30,17,13,partly cloudy night,
2017,Winter,04:00:00 PM,1186,579,607,clear day,
2017,Fall,12:00:00 AM,36,20,16,partly cloudy night,
2017,Winter,05:00:00 PM,539,221,318,partly cloudy night,
2017,Fall,06:00:00 PM,800,462,338,clear night,
2017,Fall,01:00:00 AM,15,7,8,partly cloudy night,
2017,Fall,09:00:00 AM,700,468,232,partly cloudy day,Daylight Saving Time ends
2018,Winter,04:00:00 PM,577,261,316,partly cloudy day,
2017,Winter,06:00:00 PM,564,247,317,clear night,
2017,Winter,09:00:00 AM,710,431,279,partly cloudy day,
2017,Fall,03:00:00 AM,25,16,9,clear night,
2017,Fall,11:00:00 PM,105,54,51,clear night,
2017,Fall,12:00:00 AM,65,24,41,partly cloudy night,
2017,Fall,02:00:00 AM,11,7,4,clear night,
2018,Winter,06:00:00 AM,45,20,25,partly cloudy night,
2017,Winter,09:00:00 PM,172,94,78,clear night,New Year's Eve
2017,Winter,04:00:00 PM,1775,832,943,partly cloudy day,
2017,Fall,02:00:00 PM,654,339,315,rain,Columbus Day (regional holiday)
2018,Winter,06:00:00 PM,325,244,81,partly cloudy night,
2018,Winter,06:00:00 AM,27,19,8,partly cloudy night,
2018,Winter,04:00:00 AM,2,0,2,clear night,
2017,Winter,07:00:00 AM,102,49,53,partly cloudy night,
2017,Winter,04:00:00 AM,5,4,1,partly cloudy night,
2018,Winter,02:00:00 AM,3,1,2,clear night,
2017,Winter,03:00:00 PM,1995,983,1012,clear day,
2018,Winter,02:00:00 AM,1,0,1,clear night,
2017,Fall,07:00:00 PM,700,311,389,partly cloudy night,
2017,Winter,07:00:00 PM,289,140,149,partly cloudy night,
2017,Fall,06:00:00 PM,540,345,195,partly cloudy night,
2017,Winter,08:00:00 PM,294,225,69,clear night,
2018,Winter,06:00:00 PM,332,255,77,partly cloudy night,
2017,Winter,07:00:00 PM,60,36,24,rain,
2017,Fall,04:00:00 AM,10,6,4,partly cloudy night,
2018,Winter,11:00:00 AM,828,439,389,clear day,
2017,Fall,06:00:00 AM,89,51,38,partly cloudy night,
2017,Fall,05:00:00 PM,1913,1162,751,clear day,
2017,Fall,08:00:00 PM,353,176,177,clear night,
2017,Fall,06:00:00 AM,113,88,25,partly cloudy night,
2017,Fall,08:00:00 AM,353,123,230,partly cloudy day,
2017,Fall,08:00:00 AM,437,149,288,clear day,
2017,Fall,12:00:00 PM,1666,852,814,clear day,
2017,Fall,08:00:00 PM,225,97,128,clear night,
2017,Fall,09:00:00 PM,287,125,162,clear night,
2017,Fall,08:00:00 AM,387,214,173,clear day,
2017,Fall,06:00:00 AM,113,82,31,clear night,
2017,Fall,07:00:00 AM,304,144,160,clear night,
2018,Winter,06:00:00 AM,11,8,3,partly cloudy night,
2017,Winter,08:00:00 PM,184,94,90,clear night,New Year's Eve
2017,Fall,06:00:00 AM,6,4,2,partly cloudy night,
2018,Winter,01:00:00 AM,5,3,2,partly cloudy night,
2017,Fall,06:00:00 AM,59,33,26,partly cloudy night,
2017,Fall,01:00:00 AM,16,9,7,clear night,
2017,Winter,11:00:00 AM,1767,866,901,clear day,
2018,Winter,06:00:00 AM,36,14,22,cloudy,
2017,Fall,10:00:00 PM,85,55,30,clear night,
2017,Fall,01:00:00 PM,4055,1560,2495,clear day,
2017,Fall,06:00:00 PM,1075,573,502,partly cloudy day,
2017,Fall,01:00:00 AM,18,10,8,clear night,
2018,Winter,06:00:00 AM,46,24,22,clear night,
2017,Fall,01:00:00 PM,1485,719,766,partly cloudy day,
2017,Fall,01:00:00 PM,1611,811,800,clear day,
2017,Fall,10:00:00 AM,1176,625,551,clear day,Black Friday
2017,Fall,09:00:00 AM,477,254,223,partly cloudy day,Columbus Day (regional holiday)
2017,Fall,11:00:00 PM,38,20,18,partly cloudy night,
2018,Winter,12:00:00 PM,601,331,270,clear day,
2017,Winter,04:00:00 AM,0,0,0,partly cloudy night,
2017,Fall,01:00:00 AM,37,26,11,clear night,
2017,Fall,05:00:00 PM,1474,780,694,partly cloudy day,
2017,Winter,06:00:00 AM,16,15,1,clear night,
2017,Fall,06:00:00 PM,878,372,506,partly cloudy night,
2017,Fall,06:00:00 PM,1014,363,651,partly cloudy night,
2017,Fall,09:00:00 PM,133,59,74,clear night,
2017,Winter,07:00:00 AM,50,29,21,rain,Christmas Day
2017,Winter,06:00:00 AM,100,64,36,clear night,
2017,Winter,07:00:00 PM,398,273,125,clear night,
2017,Winter,04:00:00 AM,6,4,2,partly cloudy night,
2017,Winter,05:00:00 AM,6,2,4,cloudy,
2017,Winter,07:00:00 AM,77,26,51,fog,
2018,Winter,01:00:00 AM,5,4,1,fog,
2017,Fall,04:00:00 AM,8,6,2,clear night,
2017,Fall,06:00:00 AM,58,34,24,partly cloudy night,
2017,Fall,03:00:00 PM,2913,1311,1602,clear day,Black Friday
2017,Fall,06:00:00 AM,83,44,39,partly cloudy night,
2018,Winter,12:00:00 AM,15,2,13,clear night,
2018,Winter,04:00:00 PM,258,155,103,snow,
2018,Winter,03:00:00 AM,0,0,0,clear night,
2018,Winter,01:00:00 AM,12,9,3,clear night,
2017,Fall,06:00:00 AM,101,54,47,partly cloudy night,
2017,Winter,07:00:00 PM,332,158,174,clear night,
2017,Fall,11:00:00 AM,1022,414,608,partly cloudy day,
2017,Winter,08:00:00 AM,256,77,179,partly cloudy day,
2018,Winter,12:00:00 AM,43,30,13,cloudy,
2018,Winter,05:00:00 AM,11,4,7,clear night,
2018,Winter,06:00:00 AM,40,18,22,clear night,
2018,Winter,08:00:00 PM,104,60,44,clear night,
2017,Winter,04:00:00 PM,744,340,404,clear day,
2018,Winter,01:00:00 AM,0,0,0,partly cloudy night,
2017,Fall,06:00:00 PM,1084,491,593,clear night,
2017,Winter,08:00:00 PM,325,223,102,partly cloudy night,
2018,Winter,06:00:00 AM,27,12,15,clear night,
2017,Winter,09:00:00 PM,90,47,43,clear night,Christmas Day
2018,Winter,01:00:00 PM,796,359,437,partly cloudy day,
2017,Winter,08:00:00 AM,62,32,30,rain,
2017,Winter,04:00:00 AM,2,0,2,clear night,
2017,Fall,03:00:00 PM,983,467,516,partly cloudy day,
2017,Winter,02:00:00 AM,18,8,10,partly cloudy night,
2017,Fall,06:00:00 AM,84,47,37,clear night,
2018,Winter,01:00:00 PM,722,367,355,partly cloudy day,
2017,Fall,01:00:00 AM,7,2,5,clear night,
2017,Fall,11:00:00 AM,1581,735,846,clear day,
2017,Fall,02:00:00 AM,3,1,2,clear night,Thanksgiving Day
2018,Winter,05:00:00 PM,456,207,249,partly cloudy night,
2018,Winter,09:00:00 AM,321,202,119,clear day,
2018,Winter,09:00:00 PM,61,32,29,partly cloudy night,
2017,Fall,10:00:00 PM,283,143,140,partly cloudy night,
2018,Winter,05:00:00 PM,1015,372,643,partly cloudy night,
2018,Winter,08:00:00 AM,194,91,103,clear day,
2018,Winter,09:00:00 AM,311,186,125,clear day,
2017,Fall,07:00:00 PM,329,234,95,clear night,
2017,Winter,04:00:00 AM,6,4,2,cloudy,
2017,Winter,07:00:00 PM,433,335,98,clear night,
2017,Fall,10:00:00 PM,6,4,2,rain,
2017,Fall,09:00:00 PM,300,187,113,partly cloudy night,
2017,Fall,11:00:00 PM,69,39,30,clear night,
2017,Fall,06:00:00 AM,143,80,63,clear night,
2017,Fall,02:00:00 AM,3,2,1,clear night,
2017,Fall,11:00:00 AM,1050,494,556,clear day,
2018,Winter,09:00:00 AM,82,31,51,snow,
2018,Winter,04:00:00 AM,2,0,2,clear night,
2018,Winter,09:00:00 PM,80,55,25,partly cloudy night,
2017,Fall,09:00:00 AM,734,453,281,clear day,
2017,Fall,11:00:00 PM,224,144,80,partly cloudy night,
2018,Winter,04:00:00 PM,955,407,548,clear day,Martin Luther King Jr. Day
2018,Winter,09:00:00 PM,102,83,19,clear night,
2018,Winter,05:00:00 PM,1207,473,734,clear night,
2017,Fall,01:00:00 PM,1926,809,1117,clear day,
2017,Fall,10:00:00 AM,1447,921,526,partly cloudy day,
2017,Fall,10:00:00 AM,280,145,135,partly cloudy day,
2017,Fall,04:00:00 PM,1532,774,758,partly cloudy day,
2018,Winter,09:00:00 PM,52,26,26,clear night,
2017,Winter,07:00:00 AM,175,97,78,partly cloudy night,
2018,Winter,04:00:00 AM,3,1,2,cloudy,
2017,Fall,11:00:00 AM,1444,722,722,partly cloudy day,
2017,Winter,08:00:00 PM,47,38,9,rain,
2018,Winter,09:00:00 PM,89,40,49,clear night,
2017,Fall,07:00:00 AM,84,38,46,partly cloudy day,
2017,Fall,02:00:00 PM,2340,1085,1255,partly cloudy day,
2017,Fall,08:00:00 PM,242,122,120,partly cloudy night,
2017,Fall,07:00:00 PM,364,232,132,clear night,
2017,Fall,10:00:00 PM,73,34,39,cloudy,Daylight Saving Time ends
2017,Fall,01:00:00 PM,2649,1426,1223,partly cloudy day,
2017,Winter,10:00:00 AM,540,274,266,partly cloudy day,
2017,Fall,10:00:00 PM,181,121,60,rain,
2017,Fall,04:00:00 AM,2,0,2,clear night,
2017,Winter,08:00:00 PM,59,40,19,partly cloudy night,
2017,Winter,09:00:00 PM,59,26,33,clear night,
2017,Fall,02:00:00 PM,1719,885,834,clear day,
2017,Fall,05:00:00 PM,952,437,515,clear night,
2017,Fall,10:00:00 PM,158,96,62,clear night,
2017,Winter,11:00:00 AM,1838,939,899,clear day,
2017,Fall,04:00:00 PM,3388,1644,1744,clear day,
2018,Winter,10:00:00 PM,42,27,15,partly cloudy night,
2017,Winter,02:00:00 PM,2733,1208,1525,clear day,
2017,Winter,11:00:00 PM,23,8,15,partly cloudy night,
2017,Fall,04:00:00 AM,7,5,2,clear night,
2017,Fall,09:00:00 AM,677,378,299,partly cloudy day,
2017,Winter,10:00:00 AM,821,396,425,partly cloudy day,
2017,Fall,08:00:00 AM,291,91,200,clear day,
2017,Winter,11:00:00 PM,141,113,28,clear night,
2017,Fall,09:00:00 AM,500,271,229,partly cloudy day,
2017,Fall,10:00:00 PM,134,65,69,clear night,
2018,Winter,05:00:00 PM,593,339,254,partly cloudy day,
2017,Fall,04:00:00 PM,1861,1062,799,clear day,
2017,Fall,12:00:00 AM,112,38,74,clear night,Columbus Day (regional holiday)
2017,Fall,11:00:00 PM,46,27,19,clear night,
2017,Fall,09:00:00 PM,2,1,1,rain,
2017,Fall,06:00:00 AM,91,54,37,clear night,
2018,Winter,09:00:00 AM,169,82,87,clear day,
2018,Winter,02:00:00 PM,326,176,150,snow,
2017,Fall,09:00:00 PM,223,112,111,clear night,
2017,Winter,12:00:00 AM,10,8,2,clear night,
2017,Fall,11:00:00 AM,1239,762,477,partly cloudy day,
2017,Fall,08:00:00 PM,316,141,175,partly cloudy night,
2017,Fall,09:00:00 PM,275,117,158,clear night,
2017,Winter,11:00:00 AM,1333,612,721,clear day,
2017,Winter,02:00:00 PM,2305,1254,1051,partly cloudy day,
2017,Fall,02:00:00 AM,3,0,3,clear night,
2017,Fall,05:00:00 PM,2124,1188,936,clear day,
2017,Winter,04:00:00 PM,2487,1282,1205,clear day,Christmas Eve
2017,Fall,09:00:00 PM,373,150,223,clear night,
2018,Winter,10:00:00 AM,321,183,138,clear day,
2017,Fall,11:00:00 PM,87,46,41,clear night,
2017,Winter,08:00:00 PM,143,64,79,clear night,
2018,Winter,10:00:00 AM,487,281,206,clear day,
2018,Winter,02:00:00 PM,1109,513,596,clear day,
2017,Fall,09:00:00 AM,796,411,385,clear day,Halloween
2018,Winter,08:00:00 AM,85,48,37,clear day,
2018,Winter,08:00:00 PM,83,32,51,cloudy,
2017,Fall,09:00:00 AM,536,293,243,clear day,
2017,Fall,02:00:00 PM,1966,808,1158,clear day,
2017,Winter,11:00:00 PM,115,89,26,partly cloudy night,
2017,Winter,11:00:00 AM,1210,643,567,cloudy,
2017,Winter,12:00:00 AM,13,8,5,partly cloudy night,
2018,Winter,06:00:00 AM,56,28,28,partly cloudy night,
2017,Fall,08:00:00 PM,395,150,245,clear night,
2017,Fall,07:00:00 AM,208,85,123,clear night,
2017,Fall,04:00:00 AM,5,3,2,partly cloudy night,
2017,Fall,11:00:00 AM,1994,1023,971,clear day,
2018,Winter,09:00:00 PM,60,37,23,partly cloudy night,
2018,Winter,04:00:00 PM,1080,511,569,partly cloudy day,
2017,Winter,06:00:00 PM,394,235,159,clear night,
2017,Fall,01:00:00 PM,2105,1007,1098,clear day,
2017,Fall,07:00:00 AM,173,104,69,cloudy,Daylight Saving Time ends
2018,Winter,10:00:00 PM,60,37,23,clear night,
2017,Fall,02:00:00 PM,1217,636,581,partly cloudy day,
2017,Fall,04:00:00 AM,14,9,5,clear night,
2018,Winter,05:00:00 PM,697,324,373,partly cloudy day,
2017,Fall,12:00:00 AM,29,15,14,clear night,
2017,Fall,12:00:00 PM,1576,758,818,clear day,
2017,Winter,01:00:00 PM,1932,815,1117,partly cloudy day,
2017,Winter,06:00:00 PM,561,394,167,clear night,
2017,Fall,05:00:00 AM,9,5,4,partly cloudy night,Columbus Day (regional holiday)
2017,Fall,01:00:00 AM,11,3,8,partly cloudy night,
2017,Fall,09:00:00 PM,146,66,80,clear night,
2018,Winter,12:00:00 PM,681,299,382,clear day,
2017,Fall,05:00:00 PM,1695,996,699,clear day,
2018,Winter,06:00:00 AM,20,10,10,clear night,
2017,Winter,12:00:00 AM,125,105,20,clear night,
2017,Fall,01:00:00 AM,17,11,6,clear night,
2018,Winter,09:00:00 AM,260,145,115,clear day,
2018,Winter,05:00:00 AM,8,6,2,fog,
2017,Winter,12:00:00 AM,187,176,11,partly cloudy night,
2018,Winter,09:00:00 PM,43,21,22,clear night,Martin Luther King Jr. Day
2017,Fall,03:00:00 PM,1345,713,632,rain,
2017,Fall,12:00:00 PM,1242,549,693,cloudy,Daylight Saving Time ends
2018,Winter,11:00:00 PM,102,66,36,clear night,
2017,Winter,07:00:00 PM,409,257,152,partly cloudy night,
2018,Winter,04:00:00 AM,0,0,0,clear night,
2018,Winter,06:00:00 PM,329,209,120,clear night,
2017,Fall,03:00:00 AM,7,4,3,clear night,
2018,Winter,12:00:00 PM,855,379,476,clear day,
2017,Fall,01:00:00 AM,21,10,11,clear night,
2017,Fall,05:00:00 PM,2585,1253,1332,partly cloudy day,
2017,Fall,02:00:00 AM,15,9,6,partly cloudy night,
2018,Winter,04:00:00 PM,1042,514,528,partly cloudy day,
2017,Winter,07:00:00 AM,145,71,74,clear night,
2017,Winter,04:00:00 PM,1604,702,902,partly cloudy day,
2017,Fall,12:00:00 AM,31,9,22,clear night,Black Friday
2017,Fall,05:00:00 PM,3451,1587,1864,clear day,
2017,Winter,07:00:00 AM,78,41,37,clear night,
2017,Fall,05:00:00 PM,844,411,433,clear night,
2017,Winter,04:00:00 AM,2,0,2,clear night,
2017,Winter,07:00:00 PM,77,44,33,partly cloudy night,
2017,Winter,04:00:00 PM,1579,736,843,clear day,
2017,Fall,07:00:00 AM,324,170,154,clear night,
2017,Winter,04:00:00 PM,1589,741,848,clear day,New Year's Eve
2018,Winter,05:00:00 PM,259,184,75,partly cloudy night,
2017,Fall,06:00:00 PM,1536,566,970,clear day,
2017,Fall,02:00:00 PM,2991,1529,1462,partly cloudy day,
2017,Fall,01:00:00 AM,4,2,2,clear night,
2017,Winter,07:00:00 PM,204,128,76,clear night,
2017,Fall,07:00:00 AM,89,34,55,clear day,
2017,Fall,05:00:00 AM,26,13,13,clear night,
2017,Winter,12:00:00 PM,1654,782,872,partly cloudy day,
2017,Winter,11:00:00 AM,687,322,365,partly cloudy day,
2017,Winter,09:00:00 PM,126,48,78,clear night,
2017,Fall,01:00:00 PM,3209,1666,1543,clear day,
2017,Fall,10:00:00 AM,1025,583,442,partly cloudy day,
2017,Winter,12:00:00 AM,105,84,21,partly cloudy night,
2017,Fall,11:00:00 PM,68,24,44,partly cloudy night,
2017,Fall,07:00:00 PM,380,203,177,clear night,
2018,Winter,11:00:00 PM,14,7,7,clear night,
2018,Winter,05:00:00 AM,2,1,1,clear night,New Year's Day
2017,Fall,01:00:00 PM,1621,744,877,partly cloudy day,
2018,Winter,04:00:00 AM,1,0,1,cloudy,
2018,Winter,05:00:00 PM,280,118,162,clear night,
2017,Fall,10:00:00 AM,598,340,258,rain,
2017,Fall,07:00:00 PM,369,206,163,partly cloudy night,
2018,Winter,03:00:00 AM,4,1,3,clear night,New Year's Day
2017,Fall,03:00:00 PM,1231,560,671,clear day,
2018,Winter,03:00:00 AM,2,0,2,clear night,Martin Luther King Jr. Day
2018,Winter,04:00:00 PM,651,342,309,clear day,
2018,Winter,09:00:00 AM,124,67,57,clear day,
2017,Fall,11:00:00 PM,78,45,33,partly cloudy night,
2017,Fall,12:00:00 AM,31,17,14,partly cloudy night,
2018,Winter,08:00:00 PM,69,51,18,partly cloudy night,
2017,Fall,09:00:00 AM,313,167,146,clear day,Thanksgiving Day
2018,Winter,05:00:00 AM,7,5,2,fog,
2017,Winter,02:00:00 AM,11,7,4,clear night,
2017,Fall,12:00:00 AM,35,15,20,clear night,
2018,Winter,08:00:00 PM,154,54,100,clear night,New Year's Day
2017,Winter,12:00:00 AM,16,5,11,clear night,
2017,Fall,07:00:00 PM,228,82,146,clear night,Thanksgiving Day
2017,Fall,02:00:00 PM,2234,1207,1027,partly cloudy day,
2017,Fall,12:00:00 AM,30,14,16,clear night,
2018,Winter,09:00:00 AM,315,197,118,partly cloudy day,
2017,Winter,12:00:00 PM,1001,431,570,partly cloudy day,
2017,Winter,02:00:00 PM,1694,780,914,clear day,
2017,Fall,02:00:00 AM,5,4,1,partly cloudy night,Daylight Saving Time ends
2017,Fall,12:00:00 PM,2721,1539,1182,partly cloudy day,
2017,Winter,01:00:00 PM,1073,444,629,partly cloudy day,
2017,Fall,02:00:00 PM,1269,587,682,clear day,Veterans Day observed
2018,Winter,09:00:00 AM,260,108,152,partly cloudy day,
2017,Fall,04:00:00 AM,7,4,3,clear night,
2018,Winter,01:00:00 PM,926,392,534,clear day,
2017,Fall,09:00:00 PM,211,112,99,partly cloudy night,
2017,Fall,08:00:00 AM,490,190,300,clear day,
2017,Fall,02:00:00 AM,4,3,1,partly cloudy night,
2017,Fall,10:00:00 AM,593,327,266,clear day,
2017,Fall,04:00:00 PM,1717,715,1002,clear day,
2018,Winter,01:00:00 PM,1969,947,1022,clear day,
2017,Fall,06:00:00 AM,48,38,10,clear night,
2017,Winter,04:00:00 PM,1481,699,782,clear day,
2017,Fall,03:00:00 PM,3046,1596,1450,clear day,
2017,Winter,08:00:00 AM,292,114,178,partly cloudy day,
2017,Fall,10:00:00 PM,60,36,24,clear night,Halloween
2018,Winter,08:00:00 PM,52,28,24,partly cloudy night,
2017,Fall,02:00:00 AM,10,5,5,partly cloudy night,
2017,Fall,01:00:00 AM,3,2,1,clear night,
2017,Fall,09:00:00 AM,396,191,205,clear day,
2018,Winter,02:00:00 AM,12,5,7,partly cloudy night,
2017,Fall,10:00:00 AM,1099,654,445,clear day,
2017,Winter,05:00:00 AM,19,13,6,partly cloudy night,
2017,Winter,03:00:00 PM,1825,914,911,partly cloudy day,
2017,Fall,10:00:00 AM,887,477,410,partly cloudy day,
2017,Winter,09:00:00 PM,119,58,61,clear night,
2018,Winter,08:00:00 AM,184,98,86,clear day,
2017,Fall,03:00:00 PM,1844,881,963,clear day,
2017,Winter,03:00:00 AM,2,1,1,clear night,
2017,Winter,10:00:00 AM,463,230,233,partly cloudy day,
2018,Winter,07:00:00 PM,238,145,93,clear night,
2017,Winter,12:00:00 PM,2115,1016,1099,clear day,
2017,Fall,10:00:00 PM,57,29,28,clear night,
2017,Winter,03:00:00 AM,7,3,4,partly cloudy night,
2017,Winter,08:00:00 PM,163,132,31,clear night,
2017,Fall,11:00:00 AM,928,529,399,rain,
2018,Winter,06:00:00 PM,420,312,108,clear night,
2018,Winter,02:00:00 PM,616,279,337,partly cloudy day,
2017,Fall,05:00:00 AM,15,12,3,partly cloudy night,
2018,Winter,01:00:00 AM,1,0,1,partly cloudy night,
2017,Fall,02:00:00 AM,14,8,6,clear night,
2017,Fall,12:00:00 PM,1721,801,920,partly cloudy day,
2018,Winter,05:00:00 PM,657,317,340,clear day,
2017,Winter,10:00:00 PM,128,63,65,clear night,
2017,Winter,06:00:00 PM,214,111,103,clear night,
2017,Fall,09:00:00 AM,521,320,201,clear day,
2017,Winter,09:00:00 AM,370,188,182,clear day,
2018,Winter,09:00:00 PM,143,75,68,clear night,
2017,Winter,04:00:00 AM,0,0,0,clear night,
2017,Fall,12:00:00 PM,2983,1591,1392,clear day,
2017,Fall,03:00:00 PM,1520,757,763,partly cloudy day,
2018,Winter,03:00:00 PM,823,412,411,partly cloudy day,
2018,Winter,09:00:00 AM,398,198,200,clear day,
2017,Fall,08:00:00 AM,302,159,143,clear day,
2018,Winter,07:00:00 AM,18,6,12,clear night,
2017,Fall,07:00:00 AM,165,75,90,clear night,
2018,Winter,09:00:00 PM,135,92,43,partly cloudy night,
2017,Fall,05:00:00 PM,848,469,379,clear night,
2018,Winter,09:00:00 AM,206,97,109,partly cloudy day,
2017,Fall,08:00:00 AM,283,90,193,partly cloudy day,
2017,Fall,07:00:00 AM,55,26,29,rain,
2018,Winter,09:00:00 PM,125,60,65,partly cloudy night,
2017,Winter,02:00:00 AM,7,6,1,clear night,
2017,Fall,03:00:00 AM,1,0,1,clear night,
2017,Winter,08:00:00 AM,147,66,81,partly cloudy day,
2017,Fall,05:00:00 AM,24,14,10,clear night,Halloween
2017,Fall,08:00:00 PM,101,78,23,clear night,Veterans Day observed
2017,Fall,07:00:00 PM,490,197,293,clear night,
2018,Winter,04:00:00 AM,2,0,2,clear night,
2017,Winter,10:00:00 AM,1305,698,607,clear day,
2017,Fall,09:00:00 AM,845,504,341,clear day,
2017,Winter,03:00:00 AM,0,0,0,partly cloudy night,
2018,Winter,06:00:00 AM,27,20,7,clear night,
2017,Fall,09:00:00 AM,399,179,220,partly cloudy day,
2017,Fall,04:00:00 PM,1083,495,588,partly cloudy day,
2017,Fall,08:00:00 PM,589,224,365,partly cloudy night,
2018,Winter,01:00:00 PM,1433,620,813,clear day,
2017,Winter,04:00:00 PM,505,295,210,fog,
2017,Winter,04:00:00 AM,8,3,5,partly cloudy night,
2017,Fall,10:00:00 PM,141,67,74,clear night,Veterans Day
2017,Fall,04:00:00 AM,2,0,2,clear night,
2017,Winter,06:00:00 AM,50,29,21,partly cloudy night,
2018,Winter,02:00:00 PM,725,333,392,partly cloudy day,
2018,Winter,03:00:00 PM,769,394,375,clear day,
2017,Fall,05:00:00 AM,22,14,8,clear night,
2017,Fall,10:00:00 AM,917,527,390,clear day,
2018,Winter,12:00:00 PM,719,374,345,clear day,
2017,Winter,03:00:00 PM,1728,840,888,clear day,
2017,Fall,08:00:00 PM,474,195,279,cloudy,
2018,Winter,02:00:00 AM,11,8,3,partly cloudy night,
2018,Winter,05:00:00 PM,681,253,428,clear night,
2017,Fall,01:00:00 AM,57,38,19,clear night,
2017,Fall,05:00:00 PM,2271,1355,916,partly cloudy day,
2017,Fall,09:00:00 PM,364,152,212,clear night,
2017,Fall,05:00:00 AM,19,10,9,partly cloudy night,
2017,Fall,10:00:00 AM,1258,716,542,partly cloudy day,
2017,Winter,03:00:00 AM,5,4,1,clear night,
2017,Fall,03:00:00 PM,1957,965,992,clear day,
2018,Winter,10:00:00 PM,45,27,18,clear night,
2017,Fall,12:00:00 PM,1652,936,716,clear day,
2017,Fall,02:00:00 PM,1066,505,561,clear day,
2018,Winter,12:00:00 PM,1734,798,936,clear day,
2017,Fall,07:00:00 PM,849,325,524,clear night,
2018,Winter,01:00:00 AM,1,0,1,clear night,
2017,Fall,05:00:00 AM,2,1,1,clear night,Veterans Day
2018,Winter,06:00:00 PM,514,309,205,clear night,
2017,Fall,05:00:00 PM,476,248,228,partly cloudy night,Daylight Saving Time ends
2017,Fall,05:00:00 AM,17,9,8,clear night,
2017,Fall,01:00:00 PM,1726,850,876,clear day,
2017,Fall,04:00:00 PM,2962,1445,1517,cloudy,
2017,Winter,07:00:00 AM,168,75,93,partly cloudy night,
2017,Fall,03:00:00 PM,2140,1102,1038,clear day,
2017,Fall,04:00:00 PM,1744,944,800,partly cloudy day,
2018,Winter,12:00:00 PM,869,454,415,partly cloudy day,
2017,Winter,05:00:00 AM,17,8,9,clear night,
2018,Winter,02:00:00 PM,710,355,355,clear day,
2017,Winter,03:00:00 AM,5,3,2,partly cloudy night,
2017,Fall,08:00:00 PM,206,128,78,clear night,
2017,Fall,09:00:00 AM,704,465,239,clear day,
2017,Fall,08:00:00 AM,190,106,84,clear day,
2018,Winter,09:00:00 PM,138,63,75,partly cloudy night,
2017,Fall,08:00:00 PM,243,144,99,clear night,
2017,Fall,02:00:00 AM,9,5,4,partly cloudy night,
2017,Winter,07:00:00 AM,95,54,41,clear night,Christmas Eve
2017,Fall,08:00:00 AM,382,189,193,clear day,
2017,Fall,05:00:00 PM,1051,403,648,clear night,
2017,Fall,04:00:00 AM,7,3,4,clear night,
2017,Winter,08:00:00 PM,307,235,72,clear night,
2017,Winter,10:00:00 PM,111,90,21,clear night,
2017,Fall,09:00:00 AM,683,401,282,clear day,
2017,Winter,03:00:00 AM,9,5,4,partly cloudy night,
2018,Winter,12:00:00 AM,4,2,2,clear night,
2018,Winter,07:00:00 PM,87,46,41,clear night,
2017,Fall,03:00:00 AM,23,11,12,partly cloudy night,
2017,Fall,08:00:00 PM,184,104,80,clear night,Thanksgiving Day
2017,Fall,09:00:00 PM,165,99,66,partly cloudy night,
2017,Fall,05:00:00 AM,16,9,7,clear night,
2017,Fall,02:00:00 AM,10,9,1,partly cloudy night,
2017,Fall,09:00:00 AM,522,254,268,cloudy,
2018,Winter,05:00:00 PM,510,204,306,clear night,Martin Luther King Jr. Day
2018,Winter,10:00:00 PM,38,25,13,clear night,
2017,Fall,06:00:00 AM,23,16,7,rain,
2017,Winter,11:00:00 AM,953,469,484,partly cloudy day,
2017,Fall,01:00:00 AM,41,15,26,partly cloudy night,Columbus Day (regional holiday)
2017,Fall,09:00:00 PM,241,171,70,partly cloudy night,
2017,Fall,09:00:00 AM,766,366,400,partly cloudy day,
2017,Fall,09:00:00 PM,393,187,206,partly cloudy night,
2018,Winter,12:00:00 PM,526,277,249,partly cloudy day,
2017,Fall,01:00:00 PM,1546,767,779,partly cloudy day,
2017,Fall,02:00:00 PM,186,67,119,rain,
2018,Winter,07:00:00 PM,151,105,46,clear night,
2017,Fall,07:00:00 PM,369,259,110,partly cloudy night,
2017,Fall,08:00:00 PM,361,160,201,clear night,
2017,Fall,08:00:00 AM,356,130,226,partly cloudy day,
2018,Winter,08:00:00 AM,56,19,37,clear day,
2018,Winter,10:00:00 AM,607,328,279,clear day,
2018,Winter,07:00:00 AM,137,60,77,partly cloudy night,
2017,Winter,04:00:00 PM,2623,1220,1403,clear day,
2017,Fall,06:00:00 PM,1457,621,836,clear night,
2017,Fall,10:00:00 PM,69,30,39,clear night,
2017,Winter,01:00:00 PM,2495,1452,1043,partly cloudy day,Christmas Day
2017,Winter,12:00:00 PM,1964,890,1074,clear day,New Year's Eve
2018,Winter,08:00:00 AM,162,82,80,clear day,
2017,Fall,10:00:00 PM,148,75,73,clear night,
2017,Winter,06:00:00 PM,361,186,175,cloudy,
2017,Fall,01:00:00 PM,2753,1372,1381,clear day,
2017,Winter,12:00:00 AM,12,10,2,rain,
2017,Winter,08:00:00 PM,220,135,85,clear night,
2017,Fall,09:00:00 AM,945,568,377,clear day,
2018,Winter,09:00:00 PM,38,21,17,partly cloudy night,
2018,Winter,08:00:00 AM,137,71,66,partly cloudy day,
2017,Winter,05:00:00 PM,877,436,441,clear night,
2017,Winter,10:00:00 AM,490,233,257,snow,
2017,Winter,03:00:00 PM,936,449,487,partly cloudy day,
2017,Winter,12:00:00 PM,1321,726,595,fog,
2017,Fall,02:00:00 PM,1490,697,793,clear day,
2018,Winter,09:00:00 PM,22,2,20,clear night,
2017,Winter,08:00:00 PM,132,58,74,clear night,
2017,Winter,10:00:00 PM,57,20,37,cloudy,Christmas Eve
2017,Fall,06:00:00 AM,83,47,36,clear night,
2018,Winter,07:00:00 AM,56,22,34,partly cloudy night,Martin Luther King Jr. Day
2017,Fall,08:00:00 AM,234,128,106,clear day,
2017,Fall,07:00:00 AM,162,75,87,partly cloudy day,
2017,Fall,02:00:00 PM,2277,1149,1128,partly cloudy day,
2017,Winter,09:00:00 PM,114,56,58,clear night,
2018,Winter,02:00:00 AM,6,2,4,clear night,
2017,Winter,05:00:00 PM,1019,513,506,partly cloudy night,
2017,Winter,12:00:00 PM,1679,753,926,clear day,
2017,Winter,04:00:00 AM,1,0,1,clear night,
2018,Winter,02:00:00 AM,1,0,1,rain,
2018,Winter,12:00:00 AM,21,10,11,partly cloudy night,
2018,Winter,09:00:00 AM,225,101,124,clear day,
2017,Fall,07:00:00 AM,75,52,23,partly cloudy night,
2017,Fall,07:00:00 AM,79,33,46,partly cloudy day,
2017,Fall,10:00:00 AM,823,417,406,clear day,Veterans Day observed
2018,Winter,01:00:00 PM,735,337,398,clear day,
2017,Fall,03:00:00 AM,21,6,15,clear night,
2017,Fall,07:00:00 PM,539,238,301,partly cloudy night,
2017,Winter,04:00:00 PM,731,388,343,partly cloudy day,
2017,Fall,08:00:00 PM,250,125,125,partly cloudy night,Columbus Day (regional holiday)
2017,Fall,10:00:00 AM,911,581,330,partly cloudy day,
2018,Winter,09:00:00 PM,66,43,23,clear night,
2017,Fall,12:00:00 AM,41,15,26,clear night,
2017,Fall,03:00:00 AM,3,1,2,clear night,
2017,Fall,10:00:00 PM,109,69,40,clear night,
2017,Fall,09:00:00 PM,251,123,128,clear night,
2017,Winter,01:00:00 AM,3,2,1,clear night,
2018,Winter,04:00:00 PM,641,285,356,partly cloudy day,
2017,Fall,04:00:00 AM,1,0,1,clear night,
2018,Winter,05:00:00 AM,8,3,5,partly cloudy night,
2018,Winter,08:00:00 AM,130,78,52,partly cloudy day,
2017,Fall,09:00:00 AM,480,252,228,clear day,
2017,Fall,10:00:00 AM,513,242,271,partly cloudy day,
2017,Fall,11:00:00 PM,139,76,63,clear night,
2017,Winter,12:00:00 AM,12,5,7,partly cloudy night,
2017,Fall,03:00:00 PM,1603,738,865,partly cloudy day,
2017,Fall,01:00:00 PM,2065,878,1187,clear day,Veterans Day
2018,Winter,02:00:00 AM,4,2,2,partly cloudy night,
2018,Winter,04:00:00 AM,5,4,1,clear night,
2017,Winter,01:00:00 PM,2005,937,1068,clear day,
2017,Winter,04:00:00 AM,2,0,2,partly cloudy night,
2017,Fall,07:00:00 PM,383,232,151,partly cloudy night,
2017,Fall,01:00:00 AM,13,7,6,clear night,Veterans Day
2017,Fall,05:00:00 AM,5,4,1,rain,
2017,Fall,11:00:00 AM,2679,1516,1163,clear day,
2017,Fall,10:00:00 PM,129,60,69,clear night,
2017,Winter,02:00:00 PM,1842,822,1020,clear day,
2017,Fall,01:00:00 AM,14,7,7,clear night,
2018,Winter,11:00:00 PM,46,39,7,clear night,
2018,Winter,04:00:00 PM,1214,606,608,clear day,
2017,Fall,01:00:00 AM,24,7,17,clear night,Black Friday
2018,Winter,05:00:00 PM,1287,516,771,clear night,
2017,Fall,11:00:00 AM,962,458,504,partly cloudy day,
2017,Fall,06:00:00 PM,818,356,462,clear night,Halloween
2018,Winter,12:00:00 AM,8,3,5,partly cloudy night,
2017,Winter,06:00:00 PM,671,303,368,partly cloudy night,
2017,Winter,03:00:00 AM,3,2,1,clear night,
2018,Winter,04:00:00 AM,2,1,1,clear night,
2017,Fall,04:00:00 PM,1179,561,618,partly cloudy day,
2017,Fall,02:00:00 PM,1333,575,758,clear day,
2018,Winter,03:00:00 PM,193,130,63,rain,
2018,Winter,01:00:00 PM,2127,998,1129,clear day,
2018,Winter,06:00:00 AM,12,7,5,cloudy,
2017,Fall,06:00:00 PM,463,275,188,partly cloudy night,
2017,Winter,05:00:00 PM,1215,482,733,clear night,
2018,Winter,08:00:00 PM,128,69,59,partly cloudy night,
2018,Winter,11:00:00 AM,502,268,234,clear day,
2017,Winter,07:00:00 AM,74,43,31,clear night,
2017,Fall,07:00:00 AM,189,84,105,clear day,
2017,Fall,03:00:00 AM,8,5,3,clear night,
2017,Fall,06:00:00 AM,49,37,12,clear night,
2017,Winter,12:00:00 PM,942,505,437,fog,
2017,Winter,06:00:00 AM,36,20,16,partly cloudy night,
2017,Winter,04:00:00 PM,1768,841,927,clear day,
2018,Winter,07:00:00 PM,466,260,206,partly cloudy night,
2018,Winter,11:00:00 AM,1593,783,810,clear day,
2018,Winter,03:00:00 AM,5,3,2,clear night,
2017,Fall,04:00:00 PM,1992,846,1146,partly cloudy day,
2017,Winter,12:00:00 PM,1374,612,762,partly cloudy day,
2018,Winter,01:00:00 PM,631,292,339,partly cloudy day,
2018,Winter,05:00:00 PM,701,303,398,partly cloudy night,
2017,Fall,04:00:00 AM,0,0,0,clear night,
2017,Fall,06:00:00 PM,463,299,164,partly cloudy night,
2017,Fall,01:00:00 AM,23,12,11,clear night,
2017,Fall,12:00:00 AM,35,25,10,clear night,Veterans Day
2017,Fall,05:00:00 AM,24,15,9,partly cloudy night,
2017,Fall,11:00:00 PM,1,1,0,rain,
2018,Winter,09:00:00 AM,249,149,100,partly cloudy day,
2017,Winter,02:00:00 PM,755,446,309,rain,
2018,Winter,01:00:00 AM,16,13,3,partly cloudy night,
2017,Fall,01:00:00 AM,3,2,1,clear night,Halloween
2018,Winter,10:00:00 PM,14,8,6,clear night,Martin Luther King Jr. Day
2017,Winter,11:00:00 PM,95,83,12,clear night,
2017,Fall,01:00:00 PM,2616,1447,1169,clear day,
2017,Winter,03:00:00 AM,7,4,3,clear night,
2017,Fall,09:00:00 AM,660,386,274,clear day,
2017,Winter,04:00:00 PM,1607,802,805,partly cloudy day,
2017,Fall,06:00:00 PM,659,329,330,clear night,Veterans Day
2017,Winter,04:00:00 AM,2,1,1,partly cloudy night,
2018,Winter,05:00:00 AM,10,6,4,clear night,
2017,Winter,02:00:00 AM,2,1,1,cloudy,
2017,Fall,05:00:00 PM,1237,816,421,partly cloudy day,
2017,Fall,01:00:00 PM,1125,492,633,clear day,
2018,Winter,06:00:00 AM,4,3,1,rain,
2018,Winter,06:00:00 AM,81,45,36,cloudy,
2017,Winter,12:00:00 PM,2248,1158,1090,partly cloudy day,Christmas Day
2018,Winter,10:00:00 AM,217,111,106,cloudy,
2017,Winter,03:00:00 PM,1340,611,729,clear day,
2018,Winter,09:00:00 AM,364,207,157,clear day,
2017,Fall,10:00:00 PM,200,147,53,clear night,
2017,Winter,11:00:00 AM,1264,644,620,clear day,
2017,Winter,04:00:00 PM,1376,626,750,clear day,
2017,Winter,11:00:00 AM,1224,666,558,partly cloudy day,
2017,Fall,05:00:00 PM,1952,1072,880,clear day,
2017,Fall,11:00:00 AM,1960,981,979,partly cloudy day,
2018,Winter,05:00:00 AM,3,1,2,clear night,
2018,Winter,04:00:00 PM,2160,982,1178,clear day,
2017,Winter,04:00:00 AM,2,0,2,partly cloudy night,
2017,Fall,11:00:00 AM,1489,808,681,clear day,
2018,Winter,08:00:00 PM,155,109,46,clear night,
2017,Fall,11:00:00 PM,201,115,86,clear night,
2017,Fall,05:00:00 AM,22,12,10,partly cloudy night,
2017,Winter,07:00:00 AM,94,48,46,clear night,
2017,Fall,01:00:00 AM,9,7,2,clear night,
2017,Winter,07:00:00 PM,335,221,114,clear night,
2018,Winter,06:00:00 PM,214,101,113,clear night,
2017,Winter,01:00:00 PM,1995,886,1109,partly cloudy day,
2017,Fall,02:00:00 PM,1989,941,1048,clear day,
2017,Fall,01:00:00 PM,2754,1256,1498,clear day,
2018,Winter,06:00:00 PM,340,221,119,clear night,
2018,Winter,01:00:00 PM,323,172,151,rain,
2017,Fall,06:00:00 PM,508,335,173,clear night,
2017,Fall,01:00:00 AM,16,11,5,clear night,
2017,Winter,09:00:00 AM,459,276,183,partly cloudy day,
2017,Fall,08:00:00 AM,493,242,251,clear day,
2017,Fall,07:00:00 AM,226,122,104,partly cloudy night,
2017,Fall,09:00:00 PM,308,141,167,clear night,
2017,Winter,11:00:00 PM,184,148,36,cloudy,
2018,Winter,04:00:00 AM,2,0,2,clear night,
2017,Fall,10:00:00 PM,161,69,92,clear night,Black Friday
2017,Fall,09:00:00 AM,687,392,295,clear day,
2017,Fall,04:00:00 AM,8,8,0,clear night,
2018,Winter,10:00:00 PM,29,14,15,clear night,
2017,Fall,02:00:00 AM,11,4,7,partly cloudy night,
2017,Fall,12:00:00 AM,35,12,23,clear night,
2017,Fall,02:00:00 AM,25,13,12,partly cloudy night,
2017,Winter,07:00:00 PM,241,116,125,clear night,New Year's Eve
2017,Winter,02:00:00 PM,1260,549,711,partly cloudy day,
2017,Fall,06:00:00 AM,93,51,42,partly cloudy night,
2017,Fall,02:00:00 AM,4,2,2,clear night,
2017,Fall,05:00:00 PM,1282,509,773,clear night,
2017,Fall,02:00:00 AM,6,3,3,partly cloudy night,
2018,Winter,02:00:00 PM,1663,721,942,clear day,
2018,Winter,02:00:00 AM,3,2,1,clear night,Martin Luther King Jr. Day
2018,Winter,01:00:00 AM,14,6,8,clear night,
2017,Fall,09:00:00 AM,670,380,290,clear day,
2017,Winter,03:00:00 AM,4,2,2,partly cloudy night,
2017,Fall,12:00:00 AM,60,25,35,partly cloudy night,
2018,Winter,12:00:00 AM,1328,163,1165,clear night,New Year's Day
2017,Fall,01:00:00 PM,2287,1137,1150,clear day,
2017,Fall,01:00:00 PM,422,192,230,rain,Columbus Day (regional holiday)
2017,Winter,03:00:00 AM,0,0,0,cloudy,Christmas Day
2017,Fall,04:00:00 AM,2,1,1,clear night,
2017,Fall,11:00:00 PM,144,57,87,partly cloudy night,
2017,Winter,03:00:00 PM,2210,1148,1062,partly cloudy day,
2018,Winter,03:00:00 AM,10,4,6,clear night,
2017,Fall,09:00:00 AM,545,266,279,partly cloudy day,
2017,Fall,01:00:00 PM,2137,1085,1052,clear day,
2017,Winter,03:00:00 AM,4,0,4,partly cloudy night,
2017,Fall,09:00:00 AM,951,575,376,clear day,
2017,Winter,05:00:00 PM,1183,565,618,partly cloudy night,Christmas Day
2017,Fall,09:00:00 PM,160,87,73,clear night,
2017,Winter,08:00:00 AM,248,86,162,partly cloudy day,
2017,Winter,10:00:00 PM,161,115,46,partly cloudy night,
2017,Fall,10:00:00 PM,59,32,27,clear night,
2017,Winter,12:00:00 PM,1856,840,1016,clear day,
2018,Winter,12:00:00 PM,221,125,96,partly cloudy day,
2017,Fall,06:00:00 PM,197,120,77,rain,
2018,Winter,11:00:00 AM,535,310,225,clear day,
2017,Fall,02:00:00 PM,2142,1113,1029,clear day,Thanksgiving Day
2017,Fall,02:00:00 PM,1388,709,679,clear day,
2017,Fall,03:00:00 AM,7,1,6,partly cloudy night,
2018,Winter,04:00:00 PM,916,431,485,clear day,
2017,Winter,02:00:00 AM,6,2,4,partly cloudy night,
2017,Fall,06:00:00 AM,115,62,53,partly cloudy night,
2017,Fall,03:00:00 PM,1255,627,628,partly cloudy day,
2018,Winter,02:00:00 AM,3,0,3,partly cloudy night,
2017,Fall,11:00:00 AM,1476,753,723,partly cloudy day,
2017,Fall,02:00:00 AM,25,11,14,partly cloudy night,
2018,Winter,11:00:00 AM,376,200,176,partly cloudy day,
2018,Winter,04:00:00 PM,971,444,527,rain,
2018,Winter,08:00:00 AM,174,47,127,clear day,
2018,Winter,09:00:00 AM,193,94,99,clear day,
2017,Winter,07:00:00 AM,89,46,43,partly cloudy night,
2017,Winter,01:00:00 AM,14,8,6,clear night,
2017,Winter,03:00:00 AM,11,9,2,clear night,
2018,Winter,01:00:00 PM,1900,1033,867,clear day,New Year's Day
2017,Fall,06:00:00 PM,586,263,323,clear night,
2017,Winter,11:00:00 PM,63,37,26,partly cloudy night,
2017,Fall,03:00:00 PM,1463,703,760,partly cloudy day,
2018,Winter,05:00:00 AM,8,3,5,clear night,
2017,Winter,05:00:00 AM,2,1,1,clear night,New Year's Eve
2017,Winter,08:00:00 AM,308,111,197,clear day,
2018,Winter,07:00:00 PM,113,77,36,partly cloudy night,
2017,Fall,02:00:00 AM,19,10,9,clear night,
2018,Winter,01:00:00 AM,6,3,3,clear night,
2017,Fall,05:00:00 PM,734,340,394,partly cloudy night,
2018,Winter,10:00:00 PM,73,39,34,clear night,
2017,Fall,09:00:00 AM,519,311,208,partly cloudy day,
2017,Fall,05:00:00 AM,19,10,9,partly cloudy night,
2017,Fall,02:00:00 AM,13,5,8,partly cloudy night,
2017,Fall,10:00:00 AM,1437,782,655,clear day,
2018,Winter,10:00:00 AM,271,170,101,clear day,
2017,Winter,04:00:00 AM,1,0,1,cloudy,
2018,Winter,11:00:00 PM,14,2,12,clear night,
2018,Winter,09:00:00 AM,286,172,114,clear day,
2017,Fall,02:00:00 PM,3816,1865,1951,clear day,
2017,Fall,10:00:00 PM,102,51,51,clear night,
2017,Fall,12:00:00 AM,16,9,7,clear night,
2017,Winter,04:00:00 AM,5,2,3,partly cloudy night,
2017,Fall,02:00:00 PM,1415,677,738,partly cloudy day,
2018,Winter,05:00:00 AM,0,0,0,partly cloudy night,
2017,Winter,09:00:00 AM,422,247,175,clear day,
2018,Winter,03:00:00 AM,0,0,0,clear night,
2017,Winter,08:00:00 AM,142,68,74,partly cloudy day,
2017,Fall,06:00:00 PM,26,20,6,rain,
2017,Fall,06:00:00 AM,78,55,23,clear night,Thanksgiving Day
2017,Winter,10:00:00 AM,773,426,347,partly cloudy day,
2017,Fall,10:00:00 AM,1145,697,448,partly cloudy day,
2018,Winter,08:00:00 AM,143,43,100,clear day,
2017,Fall,07:00:00 AM,179,70,109,clear day,
2018,Winter,05:00:00 PM,662,420,242,partly cloudy night,
2017,Winter,04:00:00 PM,1415,573,842,clear day,
2017,Fall,04:00:00 AM,5,4,1,clear night,
2017,Winter,09:00:00 AM,121,60,61,cloudy,
2017,Fall,05:00:00 AM,19,12,7,clear night,Veterans Day observed
2017,Fall,06:00:00 AM,60,36,24,clear night,
2017,Winter,11:00:00 PM,131,30,101,cloudy,
2017,Winter,10:00:00 PM,208,128,80,clear night,
2017,Fall,03:00:00 AM,10,8,2,clear night,
2017,Fall,06:00:00 PM,756,379,377,partly cloudy night,
2017,Winter,12:00:00 PM,701,310,391,partly cloudy day,
2018,Winter,01:00:00 PM,909,388,521,clear day,
2017,Fall,05:00:00 PM,1789,1005,784,clear day,
2018,Winter,01:00:00 PM,1794,842,952,clear day,
2017,Winter,04:00:00 PM,2164,1203,961,partly cloudy day,
2017,Fall,09:00:00 AM,999,630,369,clear day,
2017,Fall,06:00:00 PM,518,298,220,clear night,
2017,Winter,02:00:00 AM,5,3,2,partly cloudy night,
2018,Winter,12:00:00 PM,126,63,63,snow,
2017,Fall,10:00:00 PM,153,83,70,clear night,
2018,Winter,03:00:00 PM,679,338,341,partly cloudy day,
2018,Winter,12:00:00 AM,13,8,5,partly cloudy night,
2017,Winter,12:00:00 AM,17,11,6,partly cloudy night,
2017,Winter,06:00:00 PM,319,176,143,partly cloudy night,
2017,Winter,03:00:00 PM,1805,880,925,clear day,
2018,Winter,12:00:00 PM,756,368,388,partly cloudy day,Martin Luther King Jr. Day
2017,Fall,11:00:00 PM,97,74,23,partly cloudy night,
2018,Winter,09:00:00 PM,120,56,64,clear night,
2018,Winter,07:00:00 PM,390,233,157,clear night,
2017,Winter,05:00:00 PM,1236,574,662,clear night,Christmas Eve
2017,Winter,01:00:00 PM,2428,1100,1328,clear day,
2018,Winter,06:00:00 PM,96,83,13,rain,
2018,Winter,05:00:00 PM,497,304,193,partly cloudy night,
2018,Winter,05:00:00 AM,17,8,9,partly cloudy night,
2017,Fall,07:00:00 PM,401,255,146,rain,
2017,Fall,08:00:00 AM,358,191,167,partly cloudy day,
2017,Fall,10:00:00 PM,356,145,211,clear night,
2017,Winter,07:00:00 PM,326,191,135,clear night,
2017,Fall,08:00:00 AM,362,138,224,clear day,
2017,Fall,10:00:00 AM,1071,645,426,clear day,
2017,Fall,01:00:00 AM,16,4,12,clear night,Thanksgiving Day
2017,Fall,04:00:00 AM,9,6,3,partly cloudy night,
2018,Winter,02:00:00 AM,3,1,2,partly cloudy night,
2017,Winter,07:00:00 PM,326,234,92,partly cloudy night,
2018,Winter,01:00:00 PM,735,354,381,clear day,
2017,Fall,12:00:00 AM,27,10,17,partly cloudy night,
2017,Winter,12:00:00 PM,1693,701,992,clear day,
2017,Winter,07:00:00 AM,136,58,78,clear night,
2017,Fall,09:00:00 PM,301,142,159,clear night,
2017,Fall,04:00:00 PM,1022,559,463,cloudy,Daylight Saving Time ends
2017,Fall,05:00:00 PM,3373,1796,1577,clear day,
2017,Fall,01:00:00 AM,12,6,6,clear night,
2017,Fall,03:00:00 PM,1530,786,744,partly cloudy day,
2017,Fall,04:00:00 PM,1572,824,748,clear day,
2018,Winter,10:00:00 AM,134,77,57,snow,
2017,Winter,12:00:00 PM,2371,1112,1259,clear day,Christmas Eve
2017,Fall,05:00:00 AM,5,3,2,clear night,Black Friday
2017,Winter,11:00:00 AM,1109,485,624,clear day,
2018,Winter,10:00:00 PM,34,25,9,cloudy,
2017,Fall,09:00:00 PM,153,85,68,partly cloudy night,
2017,Fall,12:00:00 PM,1504,762,742,partly cloudy day,
2017,Fall,05:00:00 PM,76,39,37,rain,
2017,Fall,08:00:00 AM,391,142,249,partly cloudy day,
2017,Fall,05:00:00 PM,2247,1140,1107,clear day,
2017,Fall,12:00:00 PM,1747,857,890,clear day,
2018,Winter,02:00:00 PM,873,415,458,partly cloudy day,
2017,Fall,06:00:00 AM,96,53,43,clear night,
2018,Winter,04:00:00 AM,1,0,1,clear night,
2017,Fall,05:00:00 AM,21,13,8,partly cloudy night,
2018,Winter,12:00:00 AM,1,0,1,partly cloudy night,
2017,Winter,11:00:00 PM,119,100,19,clear night,
2017,Fall,03:00:00 PM,2096,1046,1050,clear day,
2017,Fall,01:00:00 PM,2465,1197,1268,clear day,Halloween
2018,Winter,04:00:00 AM,3,1,2,clear night,
2017,Fall,01:00:00 AM,14,10,4,partly cloudy night,
2017,Fall,08:00:00 AM,513,181,332,clear day,
2017,Fall,02:00:00 AM,20,15,5,clear night,
2017,Fall,03:00:00 AM,4,4,0,clear night,
2017,Fall,10:00:00 AM,1265,674,591,partly cloudy day,
2017,Fall,04:00:00 PM,233,75,158,partly cloudy day,
2017,Fall,03:00:00 PM,1190,553,637,clear day,Veterans Day observed
2017,Fall,08:00:00 AM,216,86,130,partly cloudy day,
2017,Winter,09:00:00 AM,431,236,195,clear day,
2018,Winter,03:00:00 PM,775,379,396,partly cloudy day,
2017,Fall,03:00:00 PM,1477,764,713,clear day,
2018,Winter,06:00:00 PM,401,268,133,partly cloudy night,
2017,Fall,11:00:00 PM,162,133,29,clear night,Veterans Day
2017,Fall,10:00:00 PM,2,1,1,rain,
2017,Fall,11:00:00 PM,213,93,120,clear night,
2017,Winter,08:00:00 PM,345,230,115,clear night,
2017,Fall,06:00:00 PM,1189,679,510,clear day,
2017,Winter,08:00:00 AM,149,68,81,partly cloudy day,Christmas Day
2018,Winter,03:00:00 AM,2,1,1,partly cloudy night,
2018,Winter,10:00:00 AM,315,180,135,clear day,
2018,Winter,05:00:00 PM,1428,661,767,clear night,New Year's Day
2017,Fall,12:00:00 PM,2464,1184,1280,clear day,Halloween
2017,Winter,12:00:00 PM,1518,657,861,partly cloudy day,
2017,Fall,10:00:00 PM,133,53,80,clear night,
2017,Winter,07:00:00 AM,152,59,93,clear night,
2017,Winter,08:00:00 AM,127,40,87,fog,
2017,Fall,09:00:00 PM,101,49,52,clear night,
2017,Fall,08:00:00 PM,376,171,205,clear night,
2018,Winter,07:00:00 AM,90,43,47,clear night,
2018,Winter,05:00:00 AM,8,4,4,clear night,
2017,Fall,03:00:00 AM,6,6,0,partly cloudy night,Daylight Saving Time ends
2017,Fall,09:00:00 PM,202,145,57,clear night,
2018,Winter,05:00:00 AM,2,1,1,clear night,
2018,Winter,05:00:00 PM,824,414,410,clear night,
2018,Winter,05:00:00 PM,1505,634,871,clear day,
2017,Winter,04:00:00 AM,0,0,0,clear night,New Year's Eve
2017,Fall,04:00:00 AM,6,3,3,partly cloudy night,
2018,Winter,05:00:00 AM,3,0,3,partly cloudy night,
2017,Winter,12:00:00 PM,1396,539,857,clear day,
2018,Winter,05:00:00 PM,223,137,86,partly cloudy night,
2018,Winter,05:00:00 PM,437,288,149,partly cloudy night,
2017,Fall,10:00:00 PM,144,85,59,clear night,
2017,Winter,12:00:00 AM,20,10,10,partly cloudy night,
2017,Winter,08:00:00 PM,195,88,107,partly cloudy night,
2017,Winter,09:00:00 AM,335,161,174,clear day,
2018,Winter,10:00:00 AM,729,421,308,clear day,
2017,Winter,12:00:00 AM,56,34,22,clear night,Christmas Eve
2018,Winter,06:00:00 PM,398,255,143,clear night,
2018,Winter,12:00:00 AM,10,7,3,partly cloudy night,
2017,Fall,08:00:00 PM,245,171,74,clear night,
2017,Fall,11:00:00 PM,50,33,17,clear night,Halloween
2017,Fall,11:00:00 AM,1428,771,657,partly cloudy day,
2017,Fall,10:00:00 AM,1349,735,614,clear day,
2017,Fall,01:00:00 AM,16,9,7,partly cloudy night,
2017,Fall,03:00:00 PM,2274,1222,1052,partly cloudy day,
2017,Fall,03:00:00 AM,10,5,5,clear night,
2017,Fall,03:00:00 AM,13,7,6,clear night,
2017,Winter,11:00:00 PM,79,37,42,clear night,
2018,Winter,10:00:00 PM,40,30,10,partly cloudy night,
2018,Winter,03:00:00 PM,729,369,360,partly cloudy day,
2017,Fall,10:00:00 PM,217,146,71,partly cloudy night,
2017,Fall,11:00:00 AM,848,390,458,clear day,
2017,Fall,11:00:00 AM,1517,799,718,clear day,
2017,Fall,10:00:00 PM,115,54,61,partly cloudy night,
2017,Winter,07:00:00 PM,165,82,83,clear night,
2017,Winter,09:00:00 PM,122,76,46,clear night,
2018,Winter,10:00:00 PM,33,11,22,partly cloudy night,
2018,Winter,04:00:00 AM,4,1,3,partly cloudy night,
2017,Winter,09:00:00 PM,225,171,54,clear night,
2017,Winter,08:00:00 AM,297,143,154,partly cloudy day,
2018,Winter,09:00:00 AM,283,146,137,clear day,
2017,Fall,08:00:00 PM,242,192,50,clear night,
2017,Fall,05:00:00 PM,1825,1089,736,clear day,
2017,Fall,12:00:00 PM,732,300,432,partly cloudy day,Columbus Day (regional holiday)
2018,Winter,07:00:00 AM,101,56,45,clear night,
2017,Fall,08:00:00 AM,112,44,68,rain,
2017,Fall,02:00:00 AM,10,5,5,clear night,
2017,Fall,05:00:00 PM,2191,1203,988,partly cloudy day,
2017,Winter,12:00:00 AM,111,87,24,clear night,
2018,Winter,07:00:00 PM,232,165,67,clear night,
2017,Fall,07:00:00 PM,288,113,175,partly cloudy night,
2017,Winter,10:00:00 PM,25,11,14,clear night,
2017,Fall,03:00:00 AM,8,5,3,clear night,
2018,Winter,07:00:00 AM,106,42,64,partly cloudy night,
2017,Fall,05:00:00 AM,24,17,7,clear night,
2017,Fall,05:00:00 PM,2672,1468,1204,clear day,
2017,Fall,12:00:00 PM,994,414,580,clear day,
2017,Winter,01:00:00 AM,6,2,4,clear night,
2017,Fall,11:00:00 PM,70,34,36,clear night,
2017,Fall,07:00:00 AM,233,91,142,clear night,
2017,Fall,11:00:00 AM,1248,598,650,clear day,
2017,Winter,03:00:00 PM,2806,1234,1572,clear day,
2017,Fall,12:00:00 PM,2263,1233,1030,clear day,
2017,Winter,09:00:00 AM,401,288,113,clear day,New Year's Eve
2017,Winter,10:00:00 AM,435,257,178,partly cloudy day,
2018,Winter,11:00:00 PM,84,67,17,cloudy,
2017,Winter,01:00:00 PM,840,423,417,fog,
2017,Fall,01:00:00 PM,2062,981,1081,clear day,
2017,Fall,12:00:00 AM,29,20,9,clear night,
2017,Fall,10:00:00 PM,84,40,44,clear night,
2017,Fall,06:00:00 AM,122,76,46,clear night,
2018,Winter,12:00:00 PM,1504,880,624,clear day,New Year's Day
2017,Fall,08:00:00 PM,708,424,284,partly cloudy night,
2017,Winter,01:00:00 PM,2348,1130,1218,clear day,Christmas Eve
2018,Winter,10:00:00 PM,14,7,7,clear night,
2017,Winter,03:00:00 AM,5,2,3,partly cloudy night,
2017,Fall,01:00:00 AM,36,17,19,partly cloudy night,
2018,Winter,01:00:00 PM,116,59,57,snow,
2018,Winter,11:00:00 AM,758,363,395,clear day,
2017,Fall,11:00:00 PM,68,46,22,clear night,
2018,Winter,04:00:00 AM,3,1,2,clear night,
2017,Fall,03:00:00 AM,6,3,3,clear night,
2017,Fall,04:00:00 PM,2877,1307,1570,clear day,Black Friday
2017,Fall,11:00:00 AM,1795,937,858,partly cloudy day,
2017,Fall,07:00:00 PM,488,220,268,clear night,
2017,Fall,12:00:00 AM,88,52,36,clear night,
2018,Winter,02:00:00 AM,5,3,2,cloudy,
2017,Fall,05:00:00 PM,2066,1112,954,clear day,
2017,Winter,05:00:00 PM,964,483,481,clear night,
2017,Fall,06:00:00 PM,1828,793,1035,clear day,
2017,Winter,03:00:00 AM,2,0,2,clear night,
2018,Winter,07:00:00 AM,107,45,62,clear night,
2018,Winter,02:00:00 AM,3,0,3,clear night,
2017,Winter,05:00:00 AM,23,14,9,partly cloudy night,
2017,Fall,02:00:00 AM,1,0,1,clear night,
2017,Fall,03:00:00 AM,5,4,1,partly cloudy night,
2017,Fall,03:00:00 PM,2241,1035,1206,clear day,
2017,Winter,05:00:00 AM,2,1,1,partly cloudy night,
2017,Fall,12:00:00 PM,2733,1235,1498,clear day,
2017,Fall,01:00:00 AM,17,12,5,clear night,
2018,Winter,06:00:00 PM,217,117,100,partly cloudy night,
2018,Winter,11:00:00 PM,39,24,15,clear night,
2018,Winter,05:00:00 PM,345,209,136,partly cloudy night,
2017,Fall,10:00:00 AM,1412,892,520,clear day,
2017,Winter,03:00:00 PM,2691,1573,1118,partly cloudy day,Christmas Day
2017,Fall,12:00:00 PM,1085,472,613,clear day,
2017,Fall,11:00:00 PM,218,92,126,partly cloudy night,
2018,Winter,06:00:00 PM,539,271,268,partly cloudy night,
2017,Winter,06:00:00 AM,11,8,3,partly cloudy night,
2017,Winter,01:00:00 PM,647,288,359,partly cloudy day,
2017,Fall,10:00:00 AM,693,383,310,clear day,
2017,Fall,08:00:00 PM,448,189,259,clear night,
2018,Winter,09:00:00 AM,239,109,130,partly cloudy day,
2017,Winter,01:00:00 AM,22,12,10,cloudy,
2017,Fall,07:00:00 AM,238,113,125,partly cloudy day,
2018,Winter,01:00:00 PM,939,447,492,partly cloudy day,Martin Luther King Jr. Day
2017,Fall,12:00:00 PM,2268,1100,1168,clear day,
2017,Fall,01:00:00 PM,1923,1027,896,partly cloudy day,
2018,Winter,01:00:00 AM,4,2,2,clear night,
2017,Fall,10:00:00 AM,482,284,198,partly cloudy day,
2017,Fall,08:00:00 AM,126,47,79,rain,
2017,Winter,12:00:00 AM,27,21,6,partly cloudy night,
2018,Winter,02:00:00 AM,7,5,2,partly cloudy night,
2017,Fall,11:00:00 AM,1626,826,800,partly cloudy day,
2017,Winter,06:00:00 AM,63,36,27,clear night,
2017,Fall,12:00:00 AM,105,92,13,clear night,
2018,Winter,05:00:00 AM,9,3,6,cloudy,
2017,Winter,12:00:00 PM,2144,1171,973,clear day,
2018,Winter,06:00:00 AM,7,3,4,clear night,
2018,Winter,03:00:00 PM,684,341,343,clear day,
2017,Fall,12:00:00 PM,1657,808,849,clear day,
2017,Fall,02:00:00 PM,3049,1427,1622,partly cloudy day,
2017,Winter,07:00:00 PM,71,37,34,partly cloudy night,
2017,Fall,12:00:00 PM,2357,1128,1229,partly cloudy day,
2017,Fall,02:00:00 PM,1608,794,814,clear day,
2017,Fall,03:00:00 PM,3633,1834,1799,clear day,
2017,Fall,12:00:00 AM,92,57,35,partly cloudy night,
2018,Winter,02:00:00 PM,1455,739,716,clear day,
2017,Fall,08:00:00 PM,234,123,111,partly cloudy night,
2017,Fall,07:00:00 PM,109,62,47,clear night,Veterans Day observed
2017,Fall,04:00:00 AM,0,0,0,partly cloudy night,
2017,Fall,06:00:00 PM,541,242,299,partly cloudy night,
2018,Winter,06:00:00 PM,139,60,79,clear night,
2017,Winter,03:00:00 PM,2575,1209,1366,clear day,
2018,Winter,09:00:00 AM,92,54,38,clear day,
2018,Winter,07:00:00 AM,26,10,16,clear night,
2018,Winter,01:00:00 AM,4,2,2,clear night,
2017,Fall,07:00:00 PM,783,233,550,clear night,
2017,Fall,09:00:00 AM,517,286,231,partly cloudy day,
2018,Winter,09:00:00 AM,278,136,142,partly cloudy day,
2017,Winter,07:00:00 AM,73,31,42,clear night,
2017,Fall,12:00:00 PM,1499,680,819,partly cloudy day,
2017,Fall,10:00:00 PM,88,52,36,clear night,
2018,Winter,03:00:00 PM,2307,1044,1263,clear day,
2017,Fall,04:00:00 AM,26,19,7,partly cloudy night,
2017,Fall,03:00:00 PM,3297,1496,1801,clear day,
2017,Fall,05:00:00 PM,1956,1129,827,clear day,
2017,Fall,09:00:00 AM,283,148,135,partly cloudy day,
2018,Winter,06:00:00 PM,284,182,102,clear night,
2017,Winter,05:00:00 AM,7,4,3,partly cloudy night,
2017,Fall,04:00:00 PM,1223,561,662,partly cloudy day,
2017,Fall,10:00:00 AM,589,329,260,clear day,Thanksgiving Day
2018,Winter,06:00:00 AM,30,15,15,partly cloudy night,
2017,Fall,03:00:00 AM,16,6,10,clear night,
2017,Winter,03:00:00 PM,2424,1331,1093,clear day,
2018,Winter,02:00:00 AM,2,1,1,clear night,
2018,Winter,09:00:00 PM,118,47,71,clear night,New Year's Day
2017,Winter,08:00:00 PM,199,73,126,clear night,
2017,Fall,10:00:00 AM,687,436,251,partly cloudy day,
2018,Winter,06:00:00 AM,14,13,1,clear night,New Year's Day
2018,Winter,07:00:00 AM,52,17,35,clear night,
2018,Winter,08:00:00 AM,142,44,98,clear day,
2018,Winter,03:00:00 PM,1175,555,620,clear day,
2017,Winter,10:00:00 PM,120,64,56,partly cloudy night,
2018,Winter,09:00:00 PM,77,52,25,cloudy,
2018,Winter,11:00:00 AM,493,272,221,clear day,
2017,Fall,04:00:00 PM,2329,1199,1130,clear day,
2018,Winter,02:00:00 PM,795,410,385,partly cloudy day,
2018,Winter,09:00:00 PM,116,78,38,clear night,
2018,Winter,10:00:00 PM,29,17,12,clear night,
2017,Fall,01:00:00 PM,1035,449,586,partly cloudy day,
2017,Winter,02:00:00 PM,1046,418,628,partly cloudy day,
2017,Winter,06:00:00 AM,35,16,19,clear night,
2017,Fall,03:00:00 AM,8,4,4,clear night,
2017,Fall,11:00:00 AM,1522,916,606,clear day,
2018,Winter,02:00:00 PM,848,425,423,partly cloudy day,
2017,Fall,09:00:00 AM,571,299,272,clear day,
2017,Winter,12:00:00 PM,1853,819,1034,partly cloudy day,
2018,Winter,02:00:00 AM,1,0,1,partly cloudy night,
2017,Fall,04:00:00 PM,976,472,504,partly cloudy day,
2017,Fall,04:00:00 PM,2079,954,1125,clear day,Halloween
2017,Fall,05:00:00 AM,13,8,5,clear night,
2017,Winter,09:00:00 AM,517,297,220,partly cloudy day,
2017,Fall,05:00:00 PM,1712,998,714,clear day,
2018,Winter,01:00:00 AM,10,5,5,clear night,
2017,Winter,05:00:00 AM,17,10,7,partly cloudy night,
2017,Fall,06:00:00 AM,27,14,13,clear night,Veterans Day
2017,Fall,12:00:00 PM,1716,771,945,clear day,Veterans Day
2018,Winter,04:00:00 AM,2,0,2,partly cloudy night,
2017,Winter,01:00:00 PM,1313,571,742,clear day,
2018,Winter,03:00:00 AM,5,3,2,clear night,
2018,Winter,02:00:00 PM,2250,1076,1174,clear day,
2017,Winter,04:00:00 AM,8,4,4,clear night,
2017,Winter,07:00:00 PM,381,261,120,clear night,
2018,Winter,07:00:00 PM,34,20,14,partly cloudy night,
2017,Fall,02:00:00 PM,2323,1146,1177,clear day,
2017,Winter,06:00:00 AM,80,46,34,partly cloudy night,
2017,Fall,02:00:00 AM,10,6,4,partly cloudy night,
2017,Fall,07:00:00 PM,582,245,337,clear night,
2017,Fall,04:00:00 AM,11,6,5,clear night,
2017,Fall,03:00:00 PM,1659,762,897,partly cloudy day,
2017,Fall,07:00:00 AM,199,72,127,clear day,
2017,Winter,06:00:00 PM,576,366,210,clear night,
2018,Winter,05:00:00 AM,5,5,0,clear night,
2017,Fall,04:00:00 PM,1803,843,960,clear day,
2017,Fall,05:00:00 AM,37,24,13,clear night,
2017,Winter,04:00:00 AM,2,1,1,clear night,
2018,Winter,07:00:00 AM,113,49,64,clear night,
2017,Winter,07:00:00 PM,183,128,55,clear night,
2018,Winter,03:00:00 PM,711,338,373,clear day,
2017,Fall,05:00:00 PM,1731,868,863,clear day,Halloween
2017,Fall,06:00:00 AM,37,25,12,partly cloudy night,
2018,Winter,05:00:00 PM,571,294,277,partly cloudy day,
2017,Fall,05:00:00 AM,13,8,5,clear night,
2017,Fall,04:00:00 PM,1410,730,680,partly cloudy day,
2017,Fall,03:00:00 PM,1637,867,770,clear day,
2017,Fall,01:00:00 AM,23,14,9,clear night,
2017,Fall,11:00:00 AM,489,262,227,partly cloudy day,
2017,Winter,01:00:00 AM,81,79,2,clear night,
2017,Fall,02:00:00 AM,5,2,3,clear night,
2018,Winter,12:00:00 AM,151,135,16,clear night,
2018,Winter,06:00:00 PM,338,216,122,clear night,
2017,Fall,02:00:00 AM,3,3,0,partly cloudy night,
2017,Fall,04:00:00 PM,1483,764,719,partly cloudy day,
2017,Fall,03:00:00 PM,2276,1159,1117,partly cloudy day,
2017,Fall,06:00:00 PM,576,346,230,clear night,
2018,Winter,02:00:00 AM,6,3,3,partly cloudy night,
2017,Fall,07:00:00 AM,152,85,67,partly cloudy night,
2017,Winter,10:00:00 AM,1060,581,479,clear day,
2018,Winter,04:00:00 PM,757,341,416,partly cloudy day,
2017,Fall,04:00:00 PM,881,480,401,partly cloudy day,Columbus Day (regional holiday)
2017,Winter,11:00:00 AM,849,386,463,partly cloudy day,
2017,Fall,11:00:00 PM,103,46,57,partly cloudy night,
2018,Winter,03:00:00 PM,1046,505,541,partly cloudy day,
2017,Fall,08:00:00 AM,273,111,162,clear day,
2017,Fall,11:00:00 PM,103,85,18,clear night,
2017,Winter,01:00:00 PM,1924,911,1013,clear day,New Year's Eve
2017,Winter,01:00:00 AM,14,8,6,clear night,
2017,Fall,11:00:00 AM,1754,775,979,clear day,Black Friday
2017,Fall,11:00:00 PM,41,21,20,cloudy,Daylight Saving Time ends
2017,Winter,01:00:00 AM,1,0,1,clear night,
2017,Fall,11:00:00 PM,116,90,26,partly cloudy night,
2017,Fall,02:00:00 AM,1,0,1,clear night,
2017,Winter,11:00:00 AM,970,527,443,fog,
2017,Winter,08:00:00 PM,173,90,83,clear night,
2017,Fall,09:00:00 PM,279,145,134,clear night,
2018,Winter,04:00:00 PM,1015,470,545,clear day,
2017,Fall,07:00:00 PM,488,206,282,partly cloudy night,
2017,Winter,10:00:00 PM,43,20,23,partly cloudy night,
2017,Fall,03:00:00 AM,3,2,1,clear night,
2017,Winter,05:00:00 AM,15,10,5,partly cloudy night,
2017,Winter,07:00:00 AM,212,86,126,clear night,
2017,Fall,02:00:00 PM,3587,1899,1688,clear day,
2017,Winter,09:00:00 AM,526,327,199,clear day,Christmas Eve
2018,Winter,04:00:00 AM,2,1,1,clear night,
2017,Fall,12:00:00 AM,27,13,14,partly cloudy night,
2018,Winter,04:00:00 PM,799,353,446,clear day,
2017,Fall,07:00:00 AM,260,122,138,clear night,
2018,Winter,06:00:00 AM,15,9,6,rain,
2017,Fall,02:00:00 PM,1566,767,799,partly cloudy day,
2017,Fall,07:00:00 PM,622,268,354,partly cloudy night,
2018,Winter,01:00:00 PM,289,131,158,partly cloudy day,
2018,Winter,06:00:00 PM,191,146,45,partly cloudy night,
2018,Winter,03:00:00 AM,4,3,1,cloudy,
2017,Fall,09:00:00 AM,758,512,246,partly cloudy day,
2017,Fall,06:00:00 PM,297,158,139,cloudy,Daylight Saving Time ends
2017,Fall,07:00:00 AM,221,99,122,partly cloudy night,
2017,Winter,09:00:00 PM,179,85,94,partly cloudy night,
2017,Fall,12:00:00 AM,47,24,23,partly cloudy night,
2018,Winter,10:00:00 AM,312,174,138,clear day,
2017,Winter,05:00:00 PM,1123,540,583,clear night,
2017,Fall,07:00:00 AM,340,153,187,partly cloudy night,
2018,Winter,03:00:00 PM,649,314,335,clear day,
2018,Winter,09:00:00 AM,192,96,96,clear day,
2017,Fall,12:00:00 AM,46,25,21,clear night,
2017,Fall,07:00:00 AM,307,133,174,partly cloudy night,
2017,Fall,09:00:00 AM,661,338,323,partly cloudy day,
2017,Winter,11:00:00 PM,41,16,25,clear night,
2017,Fall,11:00:00 AM,2331,1550,781,partly cloudy day,
2017,Winter,10:00:00 PM,178,131,47,partly cloudy night,
2017,Winter,01:00:00 AM,30,17,13,partly cloudy night,
2018,Winter,08:00:00 PM,194,157,37,clear night,
2018,Winter,11:00:00 AM,1354,695,659,clear day,
2018,Winter,05:00:00 AM,2,1,1,clear night,
2017,Winter,09:00:00 PM,42,27,15,partly cloudy night,
2017,Winter,03:00:00 AM,10,6,4,partly cloudy night,
2017,Fall,06:00:00 PM,1136,557,579,partly cloudy night,
2017,Fall,08:00:00 PM,471,184,287,clear night,
2017,Fall,07:00:00 AM,285,146,139,clear night,
2017,Winter,01:00:00 PM,1649,709,940,partly cloudy day,
2017,Fall,09:00:00 PM,184,91,93,partly cloudy night,Columbus Day (regional holiday)
2017,Fall,10:00:00 AM,1021,546,475,clear day,
2017,Fall,06:00:00 AM,76,42,34,clear night,Halloween
2018,Winter,10:00:00 PM,83,51,32,cloudy,
2017,Fall,09:00:00 PM,159,88,71,clear night,
2018,Winter,09:00:00 PM,75,47,28,clear night,
2017,Fall,07:00:00 PM,737,278,459,clear night,
2017,Winter,02:00:00 PM,1828,910,918,clear day,
2017,Fall,03:00:00 AM,16,8,8,clear night,
2017,Fall,08:00:00 AM,302,162,140,partly cloudy day,Daylight Saving Time ends
2017,Fall,04:00:00 AM,0,0,0,partly cloudy night,
2017,Fall,04:00:00 PM,3066,1457,1609,clear day,
2017,Fall,06:00:00 PM,1478,893,585,clear day,
2018,Winter,10:00:00 AM,602,347,255,partly cloudy day,
2017,Fall,12:00:00 AM,40,17,23,clear night,
2017,Fall,11:00:00 AM,1602,843,759,clear day,
2018,Winter,10:00:00 AM,391,209,182,clear day,
2018,Winter,07:00:00 PM,135,102,33,partly cloudy night,
2017,Winter,02:00:00 PM,1857,881,976,partly cloudy day,
2017,Fall,05:00:00 AM,9,4,5,clear night,
2018,Winter,01:00:00 AM,4,3,1,clear night,
2018,Winter,01:00:00 AM,9,5,4,partly cloudy night,
2017,Fall,09:00:00 PM,119,52,67,clear night,
2017,Fall,07:00:00 AM,250,106,144,clear day,
2018,Winter,06:00:00 AM,15,12,3,clear night,
2017,Fall,09:00:00 PM,160,93,67,clear night,
2017,Fall,04:00:00 AM,2,1,1,clear night,Veterans Day observed
2018,Winter,06:00:00 PM,483,275,208,partly cloudy night,
2017,Fall,02:00:00 AM,5,5,0,clear night,
2017,Fall,03:00:00 AM,3,2,1,partly cloudy night,
2017,Fall,12:00:00 AM,58,27,31,partly cloudy night,
2017,Winter,08:00:00 PM,278,160,118,partly cloudy night,
2017,Fall,01:00:00 AM,10,4,6,partly cloudy night,
2018,Winter,10:00:00 PM,28,9,19,clear night,
2017,Fall,08:00:00 PM,283,183,100,partly cloudy night,
2018,Winter,09:00:00 AM,48,20,28,snow,
2018,Winter,07:00:00 AM,101,39,62,clear night,
2017,Fall,07:00:00 AM,227,124,103,partly cloudy day,
2017,Fall,02:00:00 PM,2022,802,1220,clear day,
2018,Winter,08:00:00 PM,148,66,82,clear night,
2018,Winter,12:00:00 AM,44,39,5,clear night,
2017,Fall,09:00:00 PM,105,52,53,clear night,Thanksgiving Day
2018,Winter,10:00:00 PM,116,63,53,partly cloudy night,
2018,Winter,09:00:00 AM,192,104,88,clear day,Martin Luther King Jr. Day
2017,Fall,08:00:00 PM,518,236,282,partly cloudy night,
2017,Fall,11:00:00 AM,2602,1510,1092,clear day,
2018,Winter,12:00:00 AM,9,8,1,clear night,
2017,Fall,06:00:00 AM,58,45,13,partly cloudy night,Columbus Day (regional holiday)
2017,Fall,01:00:00 AM,31,13,18,clear night,
2017,Fall,01:00:00 PM,1374,561,813,clear day,
2018,Winter,01:00:00 PM,1030,455,575,cloudy,
2018,Winter,10:00:00 PM,72,46,26,cloudy,
2017,Fall,12:00:00 PM,1705,817,888,rain,
2017,Fall,06:00:00 PM,1860,880,980,partly cloudy day,
2018,Winter,01:00:00 AM,0,0,0,clear night,
2018,Winter,10:00:00 AM,810,461,349,clear day,
2017,Fall,06:00:00 AM,135,79,56,clear night,
2017,Fall,08:00:00 PM,182,121,61,partly cloudy night,
2017,Fall,05:00:00 AM,21,13,8,clear night,
2017,Winter,08:00:00 AM,189,81,108,clear day,
2018,Winter,10:00:00 PM,74,38,36,cloudy,
2018,Winter,07:00:00 AM,65,30,35,partly cloudy night,
2017,Winter,08:00:00 PM,73,48,25,partly cloudy night,
2017,Fall,08:00:00 AM,180,68,112,rain,
2018,Winter,10:00:00 AM,275,139,136,partly cloudy day,
2017,Winter,08:00:00 AM,133,64,69,clear day,
2017,Fall,12:00:00 AM,1,0,1,partly cloudy night,
2017,Fall,01:00:00 PM,292,126,166,rain,
2017,Fall,05:00:00 PM,2763,1378,1385,clear day,
2017,Fall,07:00:00 PM,170,121,49,rain,
2018,Winter,10:00:00 AM,436,256,180,partly cloudy day,
2017,Fall,11:00:00 PM,57,44,13,clear night,Veterans Day observed
2017,Winter,11:00:00 AM,1689,807,882,clear day,
2018,Winter,06:00:00 PM,229,139,90,clear night,
2017,Fall,10:00:00 PM,84,26,58,partly cloudy night,
2017,Fall,10:00:00 AM,1244,686,558,clear day,
2017,Winter,05:00:00 PM,607,322,285,cloudy,
2017,Fall,04:00:00 AM,6,4,2,clear night,
2018,Winter,03:00:00 PM,1005,470,535,clear day,
2017,Winter,06:00:00 AM,45,24,21,clear night,
2017,Fall,03:00:00 PM,1309,721,588,clear day,
2018,Winter,10:00:00 AM,343,184,159,partly cloudy day,
2018,Winter,01:00:00 PM,695,328,367,clear day,
2017,Winter,10:00:00 AM,1053,565,488,clear day,
2018,Winter,10:00:00 PM,13,1,12,clear night,
2018,Winter,01:00:00 PM,718,324,394,clear day,
2018,Winter,01:00:00 AM,3,1,2,cloudy,
2017,Winter,10:00:00 AM,767,364,403,clear day,
2017,Winter,07:00:00 PM,270,156,114,clear night,
2018,Winter,04:00:00 AM,5,0,5,clear night,New Year's Day
2017,Fall,11:00:00 PM,161,140,21,partly cloudy night,
2017,Winter,11:00:00 AM,1185,634,551,partly cloudy day,
2017,Fall,01:00:00 PM,1512,626,886,partly cloudy day,
2017,Fall,12:00:00 AM,33,11,22,partly cloudy night,
2017,Fall,11:00:00 AM,2295,1235,1060,clear day,
2018,Winter,03:00:00 AM,1,0,1,clear night,
2017,Winter,11:00:00 AM,1768,951,817,partly cloudy day,Christmas Day
2018,Winter,05:00:00 AM,19,12,7,cloudy,
2017,Fall,12:00:00 PM,2603,1268,1335,clear day,
2017,Fall,12:00:00 PM,696,367,329,partly cloudy day,
2018,Winter,06:00:00 AM,10,8,2,partly cloudy night,Martin Luther King Jr. Day
2017,Fall,11:00:00 PM,4,3,1,rain,
2017,Fall,09:00:00 PM,258,182,76,clear night,
2018,Winter,09:00:00 AM,130,43,87,cloudy,
2017,Fall,10:00:00 AM,667,385,282,partly cloudy day,
2017,Fall,02:00:00 PM,1776,900,876,partly cloudy day,
2017,Fall,05:00:00 AM,32,16,16,clear night,
2017,Winter,04:00:00 PM,1587,634,953,partly cloudy day,
2018,Winter,04:00:00 AM,3,2,1,clear night,
2017,Fall,04:00:00 AM,5,4,1,partly cloudy night,
2017,Winter,10:00:00 PM,103,52,51,clear night,
2017,Fall,12:00:00 PM,1972,955,1017,clear day,
2017,Winter,11:00:00 AM,1363,592,771,partly cloudy day,
2017,Winter,03:00:00 AM,0,0,0,clear night,
2017,Fall,11:00:00 PM,103,58,45,clear night,
2017,Fall,07:00:00 PM,312,181,131,clear night,
2017,Winter,12:00:00 AM,11,4,7,clear night,
2018,Winter,05:00:00 PM,508,213,295,clear night,
2017,Fall,07:00:00 AM,103,47,56,clear day,
2017,Fall,12:00:00 AM,94,88,6,clear night,
2017,Fall,07:00:00 AM,296,141,155,clear night,
2017,Fall,08:00:00 AM,508,208,300,partly cloudy day,
2018,Winter,03:00:00 AM,4,2,2,clear night,
2017,Fall,10:00:00 AM,1119,720,399,clear day,
2017,Fall,02:00:00 AM,8,3,5,clear night,Veterans Day
2017,Fall,06:00:00 PM,1574,860,714,partly cloudy day,
2018,Winter,08:00:00 AM,51,15,36,snow,
2017,Fall,03:00:00 PM,2140,1136,1004,clear day,
2017,Fall,09:00:00 AM,247,118,129,partly cloudy day,
2018,Winter,01:00:00 PM,681,282,399,clear day,
2018,Winter,04:00:00 PM,1546,700,846,clear day,
2017,Fall,11:00:00 AM,1978,994,984,partly cloudy day,
2017,Winter,11:00:00 PM,85,80,5,partly cloudy night,
2018,Winter,12:00:00 AM,16,7,9,partly cloudy night,
2018,Winter,12:00:00 PM,1750,836,914,clear day,
2017,Fall,04:00:00 PM,2233,1036,1197,clear day,Veterans Day
2018,Winter,04:00:00 PM,530,235,295,partly cloudy day,
2017,Fall,07:00:00 PM,386,284,102,clear night,
2018,Winter,05:00:00 PM,619,295,324,clear night,
2017,Winter,06:00:00 AM,23,13,10,clear night,Christmas Eve
2017,Fall,11:00:00 AM,1931,1102,829,partly cloudy day,
2017,Winter,01:00:00 PM,1632,678,954,clear day,
2018,Winter,03:00:00 PM,1162,557,605,clear day,
2017,Winter,01:00:00 PM,2320,1079,1241,clear day,
2017,Fall,10:00:00 AM,1499,896,603,clear day,
2017,Fall,03:00:00 AM,20,11,9,partly cloudy night,
2017,Winter,10:00:00 PM,127,39,88,partly cloudy night,
2017,Fall,08:00:00 PM,225,117,108,clear night,
2018,Winter,03:00:00 PM,849,329,520,clear day,
2018,Winter,02:00:00 PM,793,421,372,partly cloudy day,
2017,Fall,02:00:00 AM,16,12,4,clear night,
2017,Winter,08:00:00 AM,243,130,113,clear day,
2018,Winter,11:00:00 PM,8,5,3,wind,
2017,Fall,03:00:00 AM,0,0,0,partly cloudy night,
2017,Fall,11:00:00 AM,1203,670,533,partly cloudy day,Daylight Saving Time ends
2017,Fall,10:00:00 PM,142,101,41,partly cloudy night,
2017,Fall,01:00:00 AM,74,29,45,clear night,
2018,Winter,11:00:00 PM,32,21,11,clear night,
2017,Winter,08:00:00 PM,200,95,105,clear night,
2017,Fall,06:00:00 AM,111,63,48,clear night,
2017,Winter,11:00:00 PM,1402,1375,27,clear night,New Year's Eve
2017,Fall,11:00:00 PM,83,44,39,clear night,
2017,Fall,01:00:00 AM,24,11,13,clear night,
2017,Fall,08:00:00 AM,412,159,253,clear day,
2017,Fall,05:00:00 AM,12,7,5,clear night,
2017,Winter,02:00:00 PM,2239,1012,1227,rain,
2017,Fall,10:00:00 AM,1046,649,397,partly cloudy day,
2017,Fall,11:00:00 PM,268,119,149,partly cloudy night,
2018,Winter,05:00:00 AM,5,2,3,clear night,
2018,Winter,08:00:00 AM,123,43,80,partly cloudy day,
2017,Winter,05:00:00 AM,13,5,8,partly cloudy night,
2017,Fall,11:00:00 AM,1617,860,757,clear day,
2017,Winter,05:00:00 AM,6,1,5,clear night,
2017,Winter,05:00:00 AM,9,4,5,clear night,
2018,Winter,11:00:00 AM,514,261,253,partly cloudy day,
2017,Fall,10:00:00 AM,2962,2267,695,clear day,
2018,Winter,10:00:00 AM,687,406,281,partly cloudy day,
2017,Winter,02:00:00 AM,6,0,6,partly cloudy night,
2017,Winter,01:00:00 PM,417,200,217,rain,
2017,Fall,09:00:00 PM,147,96,51,clear night,
2017,Fall,05:00:00 PM,2290,1374,916,clear day,
2017,Fall,08:00:00 PM,316,233,83,partly cloudy night,
2017,Winter,06:00:00 PM,624,391,233,clear night,
2018,Winter,09:00:00 AM,270,179,91,clear day,
2017,Winter,02:00:00 PM,2715,1610,1105,partly cloudy day,Christmas Day
2017,Fall,02:00:00 AM,6,5,1,clear night,Halloween
2017,Winter,04:00:00 AM,2,1,1,clear night,
2017,Fall,02:00:00 AM,1,1,0,clear night,
2018,Winter,07:00:00 AM,86,42,44,clear night,
2017,Fall,10:00:00 AM,1639,1008,631,clear day,
2017,Fall,03:00:00 AM,2,1,1,partly cloudy night,
2018,Winter,10:00:00 AM,264,151,113,partly cloudy day,
2018,Winter,07:00:00 AM,56,27,29,partly cloudy night,
2018,Winter,08:00:00 AM,159,52,107,clear day,
2017,Winter,11:00:00 PM,28,25,3,rain,
2017,Winter,09:00:00 AM,232,105,127,clear day,
2018,Winter,12:00:00 AM,12,2,10,partly cloudy night,
2017,Winter,06:00:00 AM,24,9,15,partly cloudy night,
2018,Winter,10:00:00 PM,37,26,11,partly cloudy night,
2017,Winter,08:00:00 AM,224,98,126,partly cloudy day,
2017,Fall,08:00:00 AM,184,94,90,clear day,Black Friday
2017,Winter,01:00:00 AM,7,3,4,cloudy,
2017,Fall,06:00:00 PM,1141,586,555,clear day,
2017,Winter,06:00:00 AM,85,43,42,clear night,
2017,Fall,02:00:00 PM,1740,726,1014,partly cloudy day,
2017,Winter,07:00:00 PM,305,143,162,clear night,
2017,Fall,03:00:00 AM,1,0,1,partly cloudy night,
2017,Fall,08:00:00 AM,272,105,167,partly cloudy day,
2017,Fall,01:00:00 PM,1971,994,977,partly cloudy day,
2017,Fall,06:00:00 PM,2742,1325,1417,clear day,
2017,Fall,03:00:00 AM,7,5,2,partly cloudy night,
2017,Fall,08:00:00 AM,351,120,231,partly cloudy day,
2018,Winter,01:00:00 AM,20,16,4,clear night,
2017,Winter,03:00:00 AM,3,2,1,partly cloudy night,
2018,Winter,06:00:00 PM,312,246,66,partly cloudy night,
2017,Fall,03:00:00 AM,1,1,0,clear night,
2018,Winter,02:00:00 PM,679,350,329,clear day,
2018,Winter,12:00:00 AM,14,6,8,clear night,
2018,Winter,03:00:00 PM,2333,1136,1197,clear day,
2017,Fall,08:00:00 AM,162,67,95,partly cloudy day,
2017,Fall,03:00:00 PM,3852,1927,1925,clear day,
2018,Winter,12:00:00 PM,755,343,412,clear day,
2018,Winter,11:00:00 PM,56,37,19,partly cloudy night,
2017,Fall,08:00:00 PM,321,181,140,partly cloudy night,
2017,Winter,09:00:00 AM,483,231,252,partly cloudy day,
2017,Fall,04:00:00 AM,1,0,1,clear night,
2017,Fall,03:00:00 PM,1363,690,673,partly cloudy day,
2017,Winter,09:00:00 PM,131,66,65,cloudy,Christmas Eve
2017,Fall,02:00:00 PM,1836,947,889,clear day,
2017,Fall,03:00:00 PM,1657,855,802,partly cloudy day,
2018,Winter,10:00:00 PM,91,52,39,partly cloudy night,
2018,Winter,07:00:00 AM,42,14,28,partly cloudy night,
2017,Winter,04:00:00 AM,3,0,3,clear night,
2017,Fall,05:00:00 AM,12,7,5,clear night,Thanksgiving Day
2017,Winter,12:00:00 PM,1763,918,845,clear day,
2018,Winter,02:00:00 AM,9,3,6,clear night,
2017,Fall,06:00:00 AM,107,60,47,partly cloudy night,
2017,Fall,12:00:00 AM,78,36,42,clear night,
2017,Fall,05:00:00 PM,878,490,388,partly cloudy day,Columbus Day (regional holiday)
2017,Fall,07:00:00 AM,287,147,140,clear night,
2018,Winter,01:00:00 AM,7,4,3,partly cloudy night,
2017,Fall,04:00:00 PM,1835,910,925,clear day,
2017,Fall,08:00:00 PM,308,153,155,partly cloudy night,
2017,Winter,09:00:00 PM,272,113,159,clear night,
2017,Fall,01:00:00 AM,7,2,5,partly cloudy night,
2017,Fall,05:00:00 AM,15,10,5,clear night,
2018,Winter,11:00:00 PM,8,4,4,clear night,
2018,Winter,01:00:00 PM,757,332,425,clear day,
2017,Winter,10:00:00 PM,164,92,72,partly cloudy night,
2018,Winter,12:00:00 AM,0,0,0,partly cloudy night,
2017,Fall,05:00:00 PM,1447,777,670,partly cloudy day,
2017,Fall,12:00:00 PM,2907,1560,1347,clear day,
2018,Winter,08:00:00 PM,202,87,115,clear night,
2017,Winter,06:00:00 PM,334,169,165,clear night,New Year's Eve
2017,Fall,03:00:00 AM,2,1,1,clear night,
2017,Fall,08:00:00 PM,527,268,259,clear night,
2017,Fall,06:00:00 AM,43,26,17,partly cloudy night,
2017,Fall,03:00:00 AM,15,8,7,clear night,
2017,Winter,08:00:00 AM,316,126,190,clear day,
2018,Winter,05:00:00 AM,4,1,3,clear night,
2017,Fall,05:00:00 PM,1011,477,534,clear night,
2018,Winter,02:00:00 PM,2314,1111,1203,clear day,
2017,Fall,10:00:00 AM,1160,649,511,clear day,
2018,Winter,12:00:00 AM,15,7,8,clear night,
2018,Winter,08:00:00 PM,90,43,47,clear night,Martin Luther King Jr. Day
2018,Winter,05:00:00 AM,6,4,2,cloudy,
2017,Winter,02:00:00 PM,1567,669,898,clear day,
2017,Fall,07:00:00 PM,636,249,387,cloudy,
2017,Fall,10:00:00 AM,1069,657,412,cloudy,
2017,Fall,01:00:00 AM,16,6,10,partly cloudy night,
2018,Winter,07:00:00 PM,275,181,94,cloudy,
2017,Fall,08:00:00 AM,224,93,131,clear day,Veterans Day observed
2017,Fall,02:00:00 AM,10,8,2,clear night,
2017,Fall,05:00:00 AM,3,2,1,rain,
2017,Fall,07:00:00 AM,310,149,161,clear night,
2017,Fall,08:00:00 PM,359,172,187,partly cloudy night,
2017,Winter,03:00:00 PM,1922,929,993,clear day,
2018,Winter,02:00:00 PM,662,344,318,partly cloudy day,
2017,Fall,02:00:00 AM,22,17,5,partly cloudy night,Columbus Day (regional holiday)
2017,Fall,01:00:00 AM,64,32,32,clear night,
2017,Fall,05:00:00 PM,753,371,382,partly cloudy night,
2018,Winter,02:00:00 PM,752,351,401,clear day,
2018,Winter,05:00:00 PM,870,348,522,clear night,
2018,Winter,11:00:00 PM,14,10,4,clear night,Martin Luther King Jr. Day
2017,Winter,09:00:00 PM,203,141,62,partly cloudy night,
2017,Winter,11:00:00 AM,1586,668,918,clear day,
2017,Fall,08:00:00 AM,477,191,286,partly cloudy day,
2017,Winter,08:00:00 PM,277,223,54,partly cloudy night,
2017,Winter,10:00:00 PM,82,72,10,clear night,
2018,Winter,06:00:00 PM,88,39,49,partly cloudy night,
2017,Fall,12:00:00 AM,45,26,19,clear night,
2017,Fall,09:00:00 PM,278,106,172,clear night,
2017,Fall,04:00:00 PM,2068,1064,1004,partly cloudy day,
2017,Fall,05:00:00 AM,32,24,8,partly cloudy night,
2017,Fall,07:00:00 PM,413,245,168,clear night,Veterans Day
2017,Winter,06:00:00 PM,387,285,102,clear night,
2017,Fall,04:00:00 AM,4,2,2,clear night,
2017,Fall,03:00:00 PM,861,417,444,cloudy,Daylight Saving Time ends
2018,Winter,03:00:00 AM,1,0,1,partly cloudy night,
2017,Fall,06:00:00 PM,37,24,13,rain,
2017,Winter,04:00:00 AM,10,6,4,partly cloudy night,
2017,Fall,03:00:00 PM,1686,901,785,clear day,
2018,Winter,07:00:00 AM,38,17,21,rain,
2017,Winter,02:00:00 PM,1355,612,743,clear day,
2017,Fall,04:00:00 PM,2571,1285,1286,clear day,
2017,Winter,05:00:00 PM,1052,505,547,clear night,
2018,Winter,09:00:00 PM,39,18,21,partly cloudy night,
2017,Fall,05:00:00 PM,1145,452,693,clear night,
2017,Fall,07:00:00 AM,251,117,134,partly cloudy night,
2017,Fall,06:00:00 PM,2142,1091,1051,clear day,
2017,Fall,02:00:00 PM,1127,523,604,partly cloudy day,
2017,Fall,08:00:00 AM,341,137,204,cloudy,
2018,Winter,09:00:00 PM,94,55,39,clear night,
2017,Fall,09:00:00 AM,324,187,137,partly cloudy day,
2017,Fall,06:00:00 PM,1437,739,698,clear day,
2018,Winter,01:00:00 AM,1,0,1,partly cloudy night,
2017,Winter,03:00:00 AM,1,0,1,clear night,
2018,Winter,11:00:00 PM,9,5,4,partly cloudy night,
2017,Fall,04:00:00 AM,11,3,8,clear night,
2017,Fall,01:00:00 AM,11,6,5,clear night,
2017,Fall,06:00:00 AM,84,55,29,partly cloudy night,
2017,Winter,08:00:00 PM,180,89,91,clear night,Christmas Day
2017,Winter,03:00:00 PM,915,431,484,partly cloudy day,
2017,Fall,08:00:00 AM,311,99,212,clear day,
2017,Fall,11:00:00 AM,1730,921,809,partly cloudy day,
2017,Winter,08:00:00 AM,103,67,36,clear day,New Year's Eve
2017,Fall,11:00:00 PM,42,18,24,clear night,
2017,Fall,06:00:00 AM,91,51,40,clear night,
2017,Fall,11:00:00 AM,1103,544,559,clear day,Veterans Day observed
2017,Fall,11:00:00 PM,104,57,47,partly cloudy night,
2017,Winter,06:00:00 AM,101,41,60,partly cloudy night,
2017,Winter,07:00:00 AM,111,56,55,partly cloudy night,
2017,Winter,08:00:00 PM,89,42,47,rain,
2017,Winter,09:00:00 PM,219,173,46,clear night,
2018,Winter,08:00:00 PM,99,56,43,partly cloudy night,
2017,Fall,03:00:00 PM,3187,1584,1603,cloudy,
2017,Winter,03:00:00 PM,1813,869,944,clear day,
2018,Winter,08:00:00 PM,82,57,25,partly cloudy night,
2017,Winter,09:00:00 PM,211,146,65,clear night,
2017,Fall,06:00:00 PM,455,248,207,partly cloudy night,
2017,Fall,04:00:00 AM,5,4,1,clear night,
2017,Fall,07:00:00 PM,275,141,134,clear night,Halloween
2018,Winter,02:00:00 PM,1916,923,993,clear day,
2018,Winter,10:00:00 PM,69,40,29,clear night,
2017,Fall,12:00:00 AM,31,7,24,clear night,
2017,Winter,03:00:00 PM,2021,1126,895,partly cloudy day,
2017,Winter,04:00:00 AM,1,0,1,partly cloudy night,
2018,Winter,01:00:00 PM,963,445,518,clear day,
2017,Winter,01:00:00 AM,13,8,5,partly cloudy night,
2018,Winter,07:00:00 AM,77,34,43,clear night,
2017,Fall,07:00:00 PM,210,103,107,partly cloudy night,
2018,Winter,10:00:00 AM,276,163,113,clear day,
2018,Winter,08:00:00 AM,233,73,160,partly cloudy day,
2017,Winter,07:00:00 PM,464,250,214,partly cloudy night,
2017,Fall,01:00:00 AM,14,11,3,clear night,
2017,Fall,06:00:00 AM,79,39,40,clear night,
2018,Winter,06:00:00 PM,702,315,387,clear night,
2017,Winter,08:00:00 PM,189,94,95,clear night,
2017,Winter,12:00:00 AM,16,6,10,clear night,
2017,Fall,11:00:00 PM,65,34,31,partly cloudy night,
2017,Fall,06:00:00 PM,575,363,212,cloudy,
2017,Fall,10:00:00 PM,181,92,89,partly cloudy night,
2018,Winter,08:00:00 AM,234,79,155,clear day,
2018,Winter,02:00:00 AM,14,10,4,clear night,
2018,Winter,11:00:00 PM,42,18,24,clear night,
2017,Fall,09:00:00 AM,551,322,229,clear day,Veterans Day
2018,Winter,01:00:00 AM,22,11,11,clear night,
2018,Winter,04:00:00 PM,1050,599,451,clear day,
2017,Winter,07:00:00 AM,103,37,66,partly cloudy night,
2018,Winter,07:00:00 PM,368,233,135,clear night,
2018,Winter,11:00:00 AM,166,81,85,rain,
2017,Fall,02:00:00 AM,7,2,5,clear night,
2017,Fall,09:00:00 PM,115,59,56,clear night,
2017,Winter,11:00:00 AM,2331,1154,1177,clear day,
2018,Winter,01:00:00 AM,7,4,3,partly cloudy night,
2017,Fall,07:00:00 PM,613,240,373,clear night,
2017,Fall,07:00:00 AM,169,81,88,partly cloudy night,Columbus Day (regional holiday)
2017,Fall,01:00:00 AM,56,28,28,partly cloudy night,
2017,Winter,04:00:00 AM,1,0,1,partly cloudy night,
2017,Winter,02:00:00 PM,1090,495,595,partly cloudy day,
2017,Winter,07:00:00 PM,345,183,162,partly cloudy night,
2017,Winter,12:00:00 PM,1414,599,815,clear day,
2018,Winter,04:00:00 PM,2629,1527,1102,clear day,New Year's Day
2018,Winter,06:00:00 AM,57,28,29,partly cloudy night,
2017,Fall,04:00:00 PM,1261,536,725,clear day,
2017,Winter,05:00:00 AM,2,1,1,partly cloudy night,
2017,Winter,01:00:00 PM,1115,491,624,partly cloudy day,
2017,Fall,04:00:00 AM,3,1,2,clear night,Black Friday
2017,Fall,12:00:00 PM,1181,520,661,partly cloudy day,
2017,Winter,05:00:00 AM,13,7,6,clear night,
2018,Winter,12:00:00 AM,101,85,16,clear night,
2017,Fall,09:00:00 AM,164,91,73,partly cloudy day,
2018,Winter,04:00:00 PM,553,275,278,partly cloudy day,
2017,Fall,11:00:00 PM,106,60,46,partly cloudy night,
2017,Fall,02:00:00 PM,2599,1280,1319,partly cloudy day,
2017,Fall,07:00:00 PM,818,309,509,partly cloudy night,
2017,Fall,12:00:00 PM,1732,857,875,partly cloudy day,
2018,Winter,12:00:00 PM,1344,670,674,clear day,
2017,Fall,10:00:00 AM,1072,599,473,partly cloudy day,
2017,Fall,09:00:00 AM,584,303,281,clear day,
2017,Fall,04:00:00 PM,2764,1040,1724,clear day,
2017,Fall,06:00:00 AM,53,21,32,partly cloudy night,
2017,Fall,09:00:00 AM,797,367,430,clear day,
2017,Fall,10:00:00 AM,1002,573,429,clear day,
2017,Fall,09:00:00 PM,166,75,91,clear night,
2017,Fall,10:00:00 PM,244,111,133,clear night,
2017,Winter,09:00:00 PM,263,149,114,partly cloudy night,
2017,Fall,12:00:00 AM,91,49,42,partly cloudy night,Daylight Saving Time ends
2017,Winter,09:00:00 AM,184,80,104,partly cloudy day,
2018,Winter,02:00:00 AM,6,3,3,cloudy,
2018,Winter,05:00:00 AM,9,4,5,clear night,
2017,Fall,02:00:00 PM,1519,720,799,clear day,
2017,Fall,11:00:00 AM,1735,862,873,clear day,
2017,Fall,07:00:00 AM,277,140,137,clear night,
2018,Winter,09:00:00 AM,141,97,44,clear day,
2018,Winter,08:00:00 PM,292,193,99,clear night,
2017,Fall,07:00:00 AM,279,120,159,partly cloudy night,
2018,Winter,11:00:00 AM,1046,618,428,clear day,New Year's Day
2017,Winter,12:00:00 PM,1608,751,857,partly cloudy day,
2017,Winter,04:00:00 PM,2106,994,1112,clear day,
2017,Fall,09:00:00 PM,292,120,172,clear night,Black Friday
2017,Winter,06:00:00 AM,12,8,4,clear night,
2017,Winter,11:00:00 AM,666,323,343,partly cloudy day,
2017,Fall,02:00:00 AM,42,18,24,partly cloudy night,
2017,Winter,05:00:00 AM,30,19,11,cloudy,
2017,Fall,05:00:00 AM,30,16,14,partly cloudy night,
2017,Fall,02:00:00 PM,2102,1066,1036,clear day,
2017,Fall,12:00:00 AM,23,11,12,partly cloudy night,
2017,Winter,02:00:00 AM,7,4,3,partly cloudy night,
2018,Winter,06:00:00 PM,168,75,93,clear night,
2017,Winter,02:00:00 AM,5,3,2,clear night,
2018,Winter,01:00:00 PM,1466,659,807,clear day,
2018,Winter,02:00:00 PM,280,116,164,rain,
2017,Fall,03:00:00 PM,1914,929,985,partly cloudy day,
2018,Winter,01:00:00 AM,1,0,1,clear night,Martin Luther King Jr. Day
2018,Winter,07:00:00 AM,53,20,33,cloudy,
2018,Winter,11:00:00 PM,28,11,17,partly cloudy night,
2017,Fall,04:00:00 PM,2454,1263,1191,clear day,
2017,Winter,11:00:00 PM,13,8,5,partly cloudy night,
2017,Winter,04:00:00 AM,1,0,1,cloudy,Christmas Day
2017,Fall,11:00:00 PM,107,53,54,partly cloudy night,
2017,Fall,02:00:00 AM,5,1,4,clear night,
2017,Winter,07:00:00 PM,136,55,81,partly cloudy night,
2017,Fall,01:00:00 PM,1746,793,953,clear day,Thanksgiving Day
2017,Winter,10:00:00 AM,588,308,280,partly cloudy day,
2017,Fall,06:00:00 PM,612,410,202,rain,
2018,Winter,05:00:00 PM,194,91,103,partly cloudy day,
2017,Fall,04:00:00 PM,3191,1527,1664,clear day,
2017,Fall,07:00:00 PM,570,198,372,clear night,
2018,Winter,08:00:00 PM,148,92,56,clear night,
2017,Fall,08:00:00 PM,274,190,84,clear night,
2018,Winter,02:00:00 AM,0,0,0,clear night,
2017,Fall,04:00:00 PM,2530,1314,1216,clear day,
2017,Fall,07:00:00 PM,14,12,2,rain,
2017,Fall,07:00:00 AM,182,81,101,clear day,
2018,Winter,11:00:00 AM,1344,687,657,clear day,
2017,Winter,04:00:00 PM,2640,1435,1205,partly cloudy day,Christmas Day
2017,Fall,12:00:00 PM,1118,515,603,clear day,
2017,Fall,02:00:00 PM,1906,756,1150,clear day,
2018,Winter,03:00:00 PM,2211,1050,1161,clear day,
2017,Winter,02:00:00 PM,1371,619,752,clear day,
2018,Winter,08:00:00 PM,213,169,44,clear night,
2018,Winter,11:00:00 AM,708,368,340,clear day,
2018,Winter,04:00:00 AM,2,1,1,rain,
2017,Fall,12:00:00 AM,16,6,10,clear night,
2017,Winter,07:00:00 AM,196,86,110,partly cloudy night,
2017,Winter,02:00:00 PM,809,373,436,clear day,
2017,Fall,12:00:00 AM,168,82,86,partly cloudy night,
2017,Winter,02:00:00 AM,6,2,4,cloudy,
2017,Winter,01:00:00 AM,103,95,8,partly cloudy night,
2017,Fall,09:00:00 AM,113,73,40,rain,
2018,Winter,06:00:00 AM,21,17,4,clear night,
2018,Winter,02:00:00 PM,831,403,428,partly cloudy day,Martin Luther King Jr. Day
2017,Winter,01:00:00 AM,3,2,1,clear night,
2017,Fall,07:00:00 AM,47,21,26,rain,
2017,Fall,01:00:00 PM,1456,646,810,clear day,
2018,Winter,02:00:00 AM,7,4,3,clear night,
2018,Winter,04:00:00 PM,593,309,284,partly cloudy day,
2017,Winter,12:00:00 AM,36,14,22,clear night,
2017,Winter,01:00:00 PM,1668,800,868,partly cloudy day,
2017,Fall,08:00:00 AM,371,192,179,clear day,
2017,Winter,02:00:00 AM,8,7,1,clear night,
2017,Fall,03:00:00 PM,2375,1058,1317,clear day,
2017,Winter,10:00:00 PM,61,27,34,partly cloudy night,
2018,Winter,03:00:00 AM,3,1,2,partly cloudy night,
2017,Fall,01:00:00 PM,1661,699,962,partly cloudy day,
2018,Winter,11:00:00 PM,17,12,5,clear night,
2017,Fall,09:00:00 PM,157,99,58,clear night,
2017,Fall,10:00:00 AM,1737,1037,700,clear day,
2017,Fall,12:00:00 PM,1567,755,812,clear day,Thanksgiving Day
2018,Winter,11:00:00 PM,16,9,7,partly cloudy night,
2017,Fall,09:00:00 AM,574,343,231,partly cloudy day,
2018,Winter,11:00:00 PM,105,63,42,partly cloudy night,
2018,Winter,05:00:00 AM,4,2,2,clear night,
2017,Fall,12:00:00 AM,42,18,24,partly cloudy night,
2017,Winter,11:00:00 AM,1174,539,635,clear day,
2018,Winter,11:00:00 AM,1310,659,651,clear day,
2017,Winter,09:00:00 AM,442,260,182,partly cloudy day,
2017,Winter,09:00:00 PM,144,65,79,clear night,
2017,Winter,04:00:00 AM,1,0,1,partly cloudy night,
2018,Winter,04:00:00 PM,754,352,402,clear day,
2017,Fall,08:00:00 PM,219,153,66,clear night,
2018,Winter,11:00:00 PM,33,21,12,cloudy,
2017,Winter,06:00:00 PM,911,374,537,clear night,
2018,Winter,11:00:00 AM,491,247,244,partly cloudy day,
2017,Fall,12:00:00 AM,33,17,16,partly cloudy night,
2017,Winter,09:00:00 PM,146,106,40,partly cloudy night,
2017,Fall,11:00:00 AM,3006,1277,1729,clear day,
2017,Fall,11:00:00 AM,998,475,523,clear day,
2017,Winter,04:00:00 PM,2484,1115,1369,clear day,
2017,Fall,07:00:00 AM,247,116,131,clear night,Halloween
2017,Fall,12:00:00 AM,28,14,14,clear night,
2017,Winter,01:00:00 AM,14,10,4,partly cloudy night,
2017,Fall,07:00:00 AM,160,90,70,partly cloudy night,
2017,Fall,02:00:00 PM,1106,526,580,partly cloudy day,
2017,Fall,06:00:00 PM,282,134,148,clear night,Veterans Day observed
2017,Fall,12:00:00 PM,1410,630,780,clear day,
2017,Fall,02:00:00 AM,5,3,2,clear night,
2018,Winter,03:00:00 PM,1582,701,881,clear day,
2017,Winter,02:00:00 PM,715,464,251,fog,
2017,Winter,09:00:00 PM,73,53,20,clear night,
2018,Winter,12:00:00 AM,70,55,15,cloudy,
2018,Winter,04:00:00 AM,0,0,0,partly cloudy night,
2018,Winter,09:00:00 PM,96,74,22,clear night,
2018,Winter,10:00:00 AM,362,143,219,partly cloudy day,
2017,Fall,12:00:00 AM,96,73,23,clear night,
2018,Winter,04:00:00 PM,607,329,278,partly cloudy day,
2017,Winter,01:00:00 PM,1572,651,921,clear day,
2017,Winter,02:00:00 PM,2612,1361,1251,clear day,Christmas Eve
2018,Winter,11:00:00 AM,514,244,270,clear day,
2017,Fall,02:00:00 AM,8,5,3,partly cloudy night,
2017,Fall,02:00:00 PM,2021,1010,1011,clear day,
2017,Fall,07:00:00 PM,931,499,432,partly cloudy night,
2017,Fall,04:00:00 AM,3,2,1,clear night,
2017,Fall,07:00:00 PM,455,245,210,partly cloudy night,
2018,Winter,12:00:00 PM,840,397,443,clear day,
2017,Winter,09:00:00 AM,403,212,191,partly cloudy day,
2018,Winter,11:00:00 PM,93,89,4,clear night,
2017,Fall,12:00:00 AM,28,17,11,clear night,Thanksgiving Day
2017,Fall,12:00:00 PM,1871,911,960,partly cloudy day,
2018,Winter,04:00:00 PM,2308,1030,1278,clear day,
2017,Fall,11:00:00 PM,135,69,66,clear night,
2017,Fall,05:00:00 PM,3609,1805,1804,clear day,
2018,Winter,07:00:00 AM,57,33,24,clear night,
2017,Fall,07:00:00 PM,773,319,454,clear night,
2018,Winter,10:00:00 AM,793,451,342,clear day,
2017,Fall,12:00:00 PM,1506,705,801,partly cloudy day,
2018,Winter,04:00:00 PM,609,322,287,partly cloudy day,
2017,Fall,07:00:00 PM,213,116,97,partly cloudy night,Daylight Saving Time ends
2017,Fall,04:00:00 PM,1867,805,1062,clear day,
2017,Fall,07:00:00 AM,71,37,34,clear day,Veterans Day
2017,Winter,09:00:00 AM,412,191,221,clear day,
2018,Winter,09:00:00 AM,134,84,50,partly cloudy day,
2018,Winter,07:00:00 PM,316,203,113,partly cloudy night,
2017,Winter,08:00:00 PM,260,193,67,clear night,
2018,Winter,11:00:00 AM,745,399,346,clear day,
2017,Fall,05:00:00 AM,15,12,3,partly cloudy night,Daylight Saving Time ends
2018,Winter,12:00:00 AM,15,8,7,clear night,
2017,Fall,05:00:00 AM,22,12,10,clear night,
2017,Winter,09:00:00 PM,79,45,34,partly cloudy night,
2018,Winter,08:00:00 PM,132,105,27,partly cloudy night,
2017,Fall,10:00:00 AM,1116,694,422,clear day,
2017,Fall,09:00:00 AM,665,351,314,clear day,
2017,Fall,03:00:00 PM,1907,1016,891,clear day,
2017,Winter,03:00:00 PM,1741,868,873,partly cloudy day,
2018,Winter,10:00:00 AM,446,256,190,partly cloudy day,
2017,Fall,03:00:00 AM,13,8,5,clear night,
2018,Winter,10:00:00 AM,363,201,162,clear day,
2017,Winter,10:00:00 PM,217,152,65,clear night,
2017,Fall,08:00:00 PM,355,173,182,clear night,Black Friday
2017,Winter,05:00:00 PM,895,423,472,clear night,
2017,Fall,06:00:00 PM,1324,601,723,clear day,
2018,Winter,12:00:00 AM,5,3,2,clear night,
2017,Fall,04:00:00 AM,4,2,2,partly cloudy night,
2018,Winter,07:00:00 AM,76,27,49,partly cloudy night,
2017,Winter,12:00:00 AM,12,7,5,clear night,
2017,Fall,07:00:00 PM,396,260,136,clear night,
2017,Winter,05:00:00 AM,2,0,2,partly cloudy night,Christmas Day
2017,Fall,03:00:00 AM,3,0,3,partly cloudy night,
2018,Winter,10:00:00 AM,499,282,217,clear day,
2017,Fall,04:00:00 AM,4,3,1,partly cloudy night,
2017,Winter,10:00:00 PM,168,126,42,clear night,
2017,Fall,03:00:00 AM,1,1,0,partly cloudy night,
2017,Fall,04:00:00 AM,4,1,3,partly cloudy night,
2017,Fall,07:00:00 PM,228,142,86,partly cloudy night,
2017,Winter,05:00:00 AM,5,4,1,clear night,
2017,Fall,11:00:00 AM,2125,1104,1021,partly cloudy day,
2018,Winter,05:00:00 AM,18,11,7,clear night,
2018,Winter,08:00:00 AM,197,103,94,clear day,
2017,Winter,05:00:00 PM,1080,485,595,clear night,
2017,Fall,03:00:00 PM,1524,874,650,clear day,
2017,Winter,05:00:00 AM,12,5,7,clear night,
2017,Fall,02:00:00 AM,19,9,10,clear night,
2017,Fall,11:00:00 AM,825,375,450,partly cloudy day,Columbus Day (regional holiday)
2018,Winter,02:00:00 PM,788,413,375,partly cloudy day,
2018,Winter,08:00:00 PM,93,56,37,clear night,
2017,Fall,11:00:00 PM,152,78,74,partly cloudy night,
2017,Winter,05:00:00 PM,255,150,105,fog,
2018,Winter,08:00:00 AM,220,61,159,partly cloudy day,
2017,Fall,05:00:00 AM,7,6,1,clear night,
2017,Winter,02:00:00 PM,2070,1040,1030,clear day,
2017,Fall,01:00:00 AM,34,24,10,clear night,
2017,Winter,10:00:00 AM,892,528,364,partly cloudy day,
2017,Winter,05:00:00 PM,963,487,476,clear night,
2018,Winter,06:00:00 AM,8,6,2,clear night,
2017,Fall,04:00:00 PM,1046,486,560,clear day,Veterans Day observed
2017,Winter,08:00:00 PM,247,157,90,partly cloudy night,
2017,Fall,04:00:00 PM,110,70,40,rain,
2017,Fall,03:00:00 PM,966,375,591,partly cloudy day,
2017,Fall,08:00:00 PM,402,183,219,clear night,
2017,Winter,10:00:00 AM,988,536,452,clear day,New Year's Eve
2017,Fall,05:00:00 AM,23,15,8,partly cloudy night,
2018,Winter,07:00:00 PM,95,28,67,clear night,
2017,Fall,03:00:00 PM,3600,1858,1742,clear day,
2017,Winter,10:00:00 PM,90,35,55,partly cloudy night,
2017,Fall,08:00:00 PM,270,200,70,clear night,
2018,Winter,07:00:00 AM,87,35,52,clear night,New Year's Day
2017,Winter,05:00:00 AM,19,12,7,partly cloudy night,
2018,Winter,07:00:00 PM,134,92,42,partly cloudy night,
2018,Winter,09:00:00 PM,31,15,16,clear night,
2017,Fall,03:00:00 PM,1870,931,939,partly cloudy day,
2017,Winter,05:00:00 AM,6,4,2,partly cloudy night,
2017,Fall,04:00:00 PM,1669,736,933,clear day,
2017,Fall,03:00:00 AM,0,0,0,clear night,
2018,Winter,01:00:00 AM,29,9,20,clear night,New Year's Day
2017,Fall,02:00:00 AM,14,9,5,partly cloudy night,
2017,Fall,10:00:00 PM,132,108,24,clear night,
2018,Winter,07:00:00 AM,38,18,20,rain,
2018,Winter,09:00:00 PM,31,15,16,clear night,
2017,Fall,08:00:00 AM,291,103,188,clear day,
2018,Winter,06:00:00 PM,133,91,42,cloudy,
2017,Fall,08:00:00 AM,338,126,212,partly cloudy day,
2017,Winter,03:00:00 AM,0,0,0,clear night,New Year's Eve
2017,Fall,01:00:00 PM,2043,918,1125,partly cloudy day,
2017,Winter,10:00:00 PM,54,34,20,clear night,
2017,Fall,02:00:00 AM,8,5,3,clear night,
2017,Fall,10:00:00 PM,66,43,23,clear night,
2018,Winter,01:00:00 AM,2,0,2,partly cloudy night,
2018,Winter,03:00:00 PM,481,251,230,partly cloudy day,
2018,Winter,02:00:00 PM,617,302,315,clear day,
2017,Winter,03:00:00 PM,957,365,592,partly cloudy day,
2017,Fall,05:00:00 PM,1146,457,689,clear night,Thanksgiving Day
2017,Fall,08:00:00 AM,425,156,269,clear day,
2017,Fall,04:00:00 AM,9,5,4,partly cloudy night,Daylight Saving Time ends
2018,Winter,06:00:00 PM,585,230,355,clear night,New Year's Day
2017,Fall,01:00:00 PM,1201,513,688,partly cloudy day,
2018,Winter,03:00:00 AM,3,2,1,clear night,
2017,Winter,06:00:00 PM,609,300,309,clear night,
2017,Winter,07:00:00 AM,106,54,52,clear night,
2018,Winter,06:00:00 PM,385,261,124,clear night,
2018,Winter,03:00:00 PM,817,394,423,partly cloudy day,
2017,Winter,06:00:00 AM,62,34,28,partly cloudy night,
2018,Winter,08:00:00 AM,162,49,113,clear day,
2017,Winter,07:00:00 AM,90,34,56,clear night,
2017,Fall,03:00:00 AM,2,2,0,cloudy,
2018,Winter,03:00:00 AM,1,0,1,partly cloudy night,
2017,Fall,04:00:00 AM,6,4,2,partly cloudy night,
2018,Winter,03:00:00 PM,725,281,444,partly cloudy day,
2017,Winter,06:00:00 AM,5,3,2,partly cloudy night,
2017,Fall,04:00:00 AM,0,0,0,clear night,Thanksgiving Day
2018,Winter,11:00:00 PM,18,11,7,partly cloudy night,
2017,Winter,06:00:00 AM,71,36,35,partly cloudy night,
2017,Winter,02:00:00 PM,1701,730,971,clear day,
2018,Winter,07:00:00 PM,139,82,57,partly cloudy night,
2017,Fall,06:00:00 AM,56,35,21,clear night,
2017,Fall,12:00:00 PM,2131,1025,1106,partly cloudy day,
2017,Fall,05:00:00 AM,20,10,10,partly cloudy night,
2017,Fall,03:00:00 AM,6,3,3,partly cloudy night,
2018,Winter,07:00:00 PM,257,115,142,partly cloudy night,
2017,Fall,01:00:00 AM,16,9,7,partly cloudy night,Veterans Day observed
2017,Fall,09:00:00 PM,193,99,94,wind,
2018,Winter,12:00:00 PM,635,307,328,partly cloudy day,
2017,Fall,05:00:00 PM,956,476,480,clear night,
2018,Winter,02:00:00 AM,4,3,1,partly cloudy night,
2017,Winter,05:00:00 PM,965,484,481,clear night,
2017,Fall,03:00:00 AM,4,2,2,clear night,Veterans Day observed
2017,Fall,01:00:00 PM,3229,1724,1505,clear day,
2017,Winter,07:00:00 AM,78,38,40,cloudy,
2018,Winter,05:00:00 PM,1338,551,787,clear night,
2017,Winter,02:00:00 PM,1816,1026,790,partly cloudy day,
2018,Winter,03:00:00 AM,1,0,1,partly cloudy night,
2018,Winter,01:00:00 PM,656,312,344,partly cloudy day,
2017,Fall,07:00:00 AM,204,109,95,partly cloudy night,
2017,Winter,12:00:00 PM,1644,669,975,clear day,
2017,Fall,09:00:00 PM,427,250,177,clear night,
2017,Fall,08:00:00 AM,400,164,236,clear day,
2017,Winter,10:00:00 AM,1207,676,531,partly cloudy day,
2017,Fall,04:00:00 AM,3,1,2,clear night,
2017,Winter,06:00:00 PM,96,64,32,fog,
2018,Winter,11:00:00 PM,198,142,56,clear night,
2017,Winter,07:00:00 AM,155,71,84,clear night,
2018,Winter,09:00:00 PM,250,111,139,clear night,
2018,Winter,10:00:00 AM,79,42,37,snow,
2017,Fall,04:00:00 PM,1883,1044,839,clear day,
2018,Winter,07:00:00 PM,270,143,127,clear night,
2017,Winter,07:00:00 AM,147,53,94,cloudy,
2017,Winter,11:00:00 PM,32,15,17,clear night,
2018,Winter,06:00:00 AM,18,8,10,clear night,
2018,Winter,10:00:00 AM,447,248,199,clear day,Martin Luther King Jr. Day
2017,Fall,04:00:00 PM,2386,1237,1149,partly cloudy day,
2017,Fall,06:00:00 AM,91,42,49,partly cloudy night,
2018,Winter,12:00:00 PM,1052,553,499,clear day,
2017,Fall,02:00:00 AM,6,3,3,clear night,
2017,Winter,08:00:00 PM,345,150,195,clear night,
2017,Winter,05:00:00 PM,1069,546,523,clear night,
2017,Fall,10:00:00 AM,1257,828,429,partly cloudy day,
2017,Fall,09:00:00 PM,200,154,46,partly cloudy night,
2017,Fall,06:00:00 PM,615,371,244,partly cloudy day,
2017,Fall,02:00:00 PM,3251,1765,1486,clear day,
2017,Fall,04:00:00 AM,6,4,2,clear night,
2017,Fall,03:00:00 PM,2904,1390,1514,partly cloudy day,
2018,Winter,03:00:00 PM,1005,458,547,clear day,
2017,Fall,06:00:00 AM,81,45,36,clear night,
2018,Winter,03:00:00 AM,0,0,0,clear night,
2017,Winter,09:00:00 PM,229,164,65,partly cloudy night,
2017,Fall,06:00:00 PM,1745,858,887,partly cloudy day,
2017,Winter,12:00:00 PM,255,145,110,rain,
2017,Winter,05:00:00 PM,619,424,195,partly cloudy night,
2017,Fall,07:00:00 AM,230,96,134,clear day,
2017,Winter,10:00:00 AM,1072,593,479,clear day,Christmas Eve
2017,Fall,06:00:00 PM,1382,787,595,partly cloudy day,
2017,Fall,08:00:00 AM,347,145,202,clear day,
2018,Winter,07:00:00 PM,237,174,63,cloudy,
2017,Winter,06:00:00 AM,32,22,10,partly cloudy night,
2017,Fall,05:00:00 PM,1641,983,658,clear day,
2018,Winter,04:00:00 PM,375,216,159,partly cloudy day,
2017,Fall,03:00:00 AM,11,6,5,partly cloudy night,
2018,Winter,07:00:00 AM,115,58,57,clear night,
2017,Fall,07:00:00 PM,759,275,484,clear night,
2018,Winter,03:00:00 AM,5,2,3,clear night,
2017,Fall,08:00:00 PM,316,225,91,clear night,
2018,Winter,04:00:00 AM,7,1,6,partly cloudy night,
2017,Winter,10:00:00 PM,25,13,12,partly cloudy night,
2017,Winter,11:00:00 AM,1737,907,830,partly cloudy day,
2017,Winter,06:00:00 PM,561,300,261,clear night,
2017,Fall,11:00:00 AM,2304,1135,1169,partly cloudy day,Halloween
2017,Fall,10:00:00 AM,1050,681,369,clear day,
2017,Fall,06:00:00 PM,1254,552,702,clear night,
2017,Fall,01:00:00 PM,2254,1090,1164,clear day,
2018,Winter,06:00:00 AM,20,14,6,clear night,
2018,Winter,04:00:00 PM,1218,573,645,clear day,
2017,Fall,11:00:00 PM,104,68,36,clear night,
2017,Fall,11:00:00 AM,1459,771,688,clear day,Veterans Day
2017,Winter,10:00:00 PM,172,128,44,partly cloudy night,
2018,Winter,06:00:00 AM,57,32,25,clear night,
2017,Winter,04:00:00 PM,2366,1166,1200,clear day,
2018,Winter,06:00:00 AM,18,12,6,partly cloudy night,
2018,Winter,06:00:00 PM,290,218,72,partly cloudy night,
2018,Winter,11:00:00 PM,48,32,16,partly cloudy night,
2018,Winter,04:00:00 PM,747,352,395,partly cloudy day,
2017,Winter,05:00:00 PM,421,195,226,partly cloudy night,
2017,Fall,08:00:00 AM,261,133,128,clear day,
2017,Winter,01:00:00 PM,1860,876,984,partly cloudy day,
2017,Fall,03:00:00 AM,12,5,7,clear night,
2017,Fall,10:00:00 PM,108,50,58,clear night,
2018,Winter,04:00:00 AM,2,1,1,partly cloudy night,
2017,Winter,03:00:00 AM,1,0,1,clear night,
2017,Winter,09:00:00 AM,555,360,195,clear day,
2017,Winter,05:00:00 PM,1249,539,710,clear night,
2018,Winter,08:00:00 AM,117,39,78,clear day,
2018,Winter,03:00:00 AM,6,2,4,partly cloudy night,
2018,Winter,02:00:00 AM,1,0,1,clear night,
2017,Fall,04:00:00 PM,1773,1016,757,partly cloudy day,
2018,Winter,12:00:00 PM,608,288,320,clear day,
2017,Fall,02:00:00 AM,16,9,7,clear night,
2017,Fall,11:00:00 PM,58,16,42,partly cloudy night,
2017,Fall,10:00:00 AM,936,555,381,clear day,
2017,Fall,02:00:00 AM,3,2,1,partly cloudy night,
2017,Fall,06:00:00 PM,1095,583,512,clear day,
2017,Fall,07:00:00 PM,776,248,528,clear night,
2017,Fall,06:00:00 AM,100,60,40,clear night,
2018,Winter,08:00:00 AM,128,28,100,partly cloudy day,
2018,Winter,11:00:00 PM,18,7,11,cloudy,
2017,Winter,01:00:00 AM,5,4,1,cloudy,Christmas Day
2017,Fall,01:00:00 AM,18,9,9,clear night,
2017,Fall,06:00:00 AM,57,40,17,clear night,
2018,Winter,08:00:00 AM,151,46,105,clear day,
2017,Winter,01:00:00 AM,12,7,5,partly cloudy night,
2017,Fall,03:00:00 PM,787,414,373,partly cloudy day,Columbus Day (regional holiday)
2017,Fall,07:00:00 PM,645,278,367,clear night,
2017,Fall,10:00:00 PM,70,35,35,clear night,Thanksgiving Day
2018,Winter,02:00:00 PM,1040,516,524,cloudy,
2017,Fall,12:00:00 AM,32,15,17,clear night,
2017,Fall,05:00:00 PM,653,264,389,partly cloudy night,
2018,Winter,02:00:00 AM,5,1,4,clear night,
2017,Fall,12:00:00 PM,2044,935,1109,clear day,Black Friday
2017,Winter,02:00:00 PM,1826,900,926,clear day,New Year's Eve
2018,Winter,08:00:00 AM,152,45,107,partly cloudy day,
2017,Winter,02:00:00 AM,3,1,2,clear night,
2017,Winter,02:00:00 AM,3,2,1,cloudy,
2017,Fall,05:00:00 PM,1067,396,671,clear night,
2017,Fall,09:00:00 PM,204,142,62,partly cloudy night,
2017,Fall,10:00:00 PM,201,96,105,clear night,
2018,Winter,10:00:00 AM,263,173,90,clear day,
2017,Winter,02:00:00 AM,4,0,4,clear night,
2018,Winter,04:00:00 PM,2224,1023,1201,clear day,
2017,Winter,11:00:00 PM,57,30,27,partly cloudy night,
2017,Fall,12:00:00 PM,1509,675,834,partly cloudy day,
2017,Winter,11:00:00 PM,121,106,15,clear night,
2017,Fall,07:00:00 PM,413,168,245,partly cloudy night,
2017,Fall,08:00:00 AM,278,106,172,partly cloudy day,
2017,Fall,11:00:00 PM,46,22,24,clear night,
2017,Winter,01:00:00 AM,68,46,22,partly cloudy night,
2017,Fall,11:00:00 AM,1373,660,713,partly cloudy day,
2017,Winter,05:00:00 AM,8,2,6,partly cloudy night,
2018,Winter,10:00:00 PM,49,27,22,cloudy,
2017,Winter,08:00:00 AM,154,73,81,clear day,
2017,Winter,07:00:00 AM,129,72,57,cloudy,
2017,Fall,04:00:00 PM,3235,1540,1695,clear day,
2017,Fall,12:00:00 PM,520,240,280,rain,
2018,Winter,10:00:00 PM,97,36,61,clear night,New Year's Day
2017,Fall,10:00:00 AM,1509,904,605,partly cloudy day,
2017,Winter,09:00:00 PM,205,129,76,partly cloudy night,
2018,Winter,02:00:00 PM,141,80,61,snow,
2017,Winter,08:00:00 PM,192,73,119,cloudy,Christmas Eve
2017,Fall,01:00:00 PM,2347,1024,1323,clear day,Black Friday
2018,Winter,11:00:00 AM,664,304,360,clear day,
2018,Winter,03:00:00 AM,1,0,1,cloudy,
2017,Fall,09:00:00 PM,216,105,111,partly cloudy night,
2018,Winter,10:00:00 PM,80,57,23,rain,
2017,Fall,04:00:00 AM,3,2,1,clear night,
2017,Fall,02:00:00 AM,3,1,2,clear night,
2018,Winter,01:00:00 PM,519,250,269,partly cloudy day,
2018,Winter,07:00:00 AM,94,41,53,clear night,
2017,Winter,02:00:00 AM,13,9,4,partly cloudy night,
2018,Winter,07:00:00 PM,181,110,71,clear night,
2017,Fall,08:00:00 AM,542,201,341,partly cloudy day,
2017,Winter,03:00:00 AM,2,0,2,clear night,Christmas Eve
2017,Fall,10:00:00 AM,1017,621,396,clear day,
2017,Fall,01:00:00 PM,827,408,419,partly cloudy day,
2017,Fall,08:00:00 PM,279,130,149,clear night,
2017,Fall,10:00:00 PM,117,42,75,partly cloudy night,Columbus Day (regional holiday)
2017,Fall,09:00:00 AM,442,257,185,clear day,
2017,Winter,06:00:00 AM,77,45,32,clear night,
2018,Winter,09:00:00 PM,44,19,25,clear night,
2017,Fall,08:00:00 AM,405,168,237,partly cloudy day,
2017,Fall,11:00:00 PM,61,33,28,clear night,
2017,Fall,12:00:00 PM,928,515,413,partly cloudy day,
2017,Winter,12:00:00 PM,1534,722,812,partly cloudy day,
2017,Winter,11:00:00 AM,263,150,113,rain,
2017,Winter,06:00:00 AM,16,10,6,partly cloudy night,
2018,Winter,02:00:00 AM,3,2,1,clear night,
2017,Winter,11:00:00 AM,1784,896,888,clear day,
2018,Winter,10:00:00 AM,484,317,167,clear day,New Year's Day
2018,Winter,02:00:00 AM,4,1,3,clear night,
2017,Fall,05:00:00 AM,25,11,14,partly cloudy night,
2017,Fall,07:00:00 AM,244,109,135,partly cloudy night,
2018,Winter,10:00:00 PM,17,9,8,partly cloudy night,
2017,Fall,12:00:00 PM,2159,1114,1045,partly cloudy day,
2017,Fall,04:00:00 AM,3,1,2,partly cloudy night,
2017,Fall,03:00:00 PM,2265,1027,1238,clear day,Veterans Day
2018,Winter,07:00:00 AM,34,12,22,fog,
2017,Fall,08:00:00 PM,212,102,110,clear night,
2017,Winter,10:00:00 AM,1003,543,460,clear day,
2017,Winter,02:00:00 PM,2185,1063,1122,clear day,
2017,Fall,08:00:00 AM,365,122,243,cloudy,
2017,Winter,12:00:00 AM,157,131,26,partly cloudy night,
2017,Winter,10:00:00 PM,149,124,25,partly cloudy night,
2018,Winter,10:00:00 PM,8,2,6,partly cloudy night,
2018,Winter,09:00:00 PM,50,23,27,clear night,
2018,Winter,07:00:00 PM,357,179,178,clear night,
2017,Fall,03:00:00 PM,1976,1025,951,clear day,
2017,Fall,03:00:00 AM,7,5,2,partly cloudy night,
2017,Winter,09:00:00 PM,113,63,50,partly cloudy night,
2017,Fall,08:00:00 AM,185,94,91,clear day,Thanksgiving Day
2017,Winter,06:00:00 PM,341,245,96,partly cloudy night,
2017,Winter,01:00:00 PM,1480,596,884,clear day,
2018,Winter,09:00:00 AM,154,56,98,clear day,
2017,Winter,10:00:00 PM,25,15,10,partly cloudy night,
2017,Winter,07:00:00 PM,247,111,136,clear night,
2018,Winter,02:00:00 PM,1111,531,580,clear day,
2018,Winter,11:00:00 PM,28,13,15,clear night,
2017,Fall,12:00:00 AM,34,10,24,clear night,
2017,Fall,05:00:00 PM,2801,1364,1437,clear day,
2017,Fall,02:00:00 AM,4,3,1,clear night,
2017,Fall,12:00:00 PM,1756,829,927,clear day,
2017,Fall,07:00:00 AM,133,65,68,partly cloudy day,Veterans Day observed
2018,Winter,07:00:00 AM,96,39,57,partly cloudy night,
2018,Winter,07:00:00 AM,139,67,72,partly cloudy night,
2017,Fall,02:00:00 PM,1748,810,938,partly cloudy day,
2017,Fall,05:00:00 PM,840,415,425,cloudy,
2017,Fall,12:00:00 AM,145,75,70,partly cloudy night,
2017,Fall,07:00:00 PM,502,211,291,clear night,
2017,Fall,10:00:00 PM,139,69,70,partly cloudy night,
2018,Winter,07:00:00 PM,217,169,48,partly cloudy night,
2017,Fall,02:00:00 AM,29,17,12,clear night,
2017,Fall,05:00:00 AM,22,10,12,clear night,
2018,Winter,01:00:00 AM,2,0,2,clear night,
2017,Fall,06:00:00 AM,96,64,32,clear night,
2017,Winter,10:00:00 AM,1076,538,538,clear day,
2017,Fall,03:00:00 AM,5,3,2,clear night,
2017,Fall,03:00:00 AM,5,2,3,clear night,
2017,Winter,05:00:00 PM,880,447,433,clear night,
2017,Fall,02:00:00 AM,17,6,11,clear night,
2018,Winter,02:00:00 AM,5,3,2,clear night,
2017,Winter,09:00:00 AM,422,189,233,clear day,
2017,Fall,12:00:00 PM,1254,573,681,clear day,
2018,Winter,12:00:00 PM,229,137,92,partly cloudy day,
2018,Winter,11:00:00 PM,57,49,8,clear night,
2017,Fall,09:00:00 PM,147,74,73,clear night,
2017,Winter,04:00:00 AM,2,1,1,partly cloudy night,
2018,Winter,07:00:00 AM,128,57,71,clear night,
2018,Winter,12:00:00 AM,7,5,2,fog,
2017,Fall,02:00:00 PM,1087,584,503,cloudy,Daylight Saving Time ends
2017,Fall,10:00:00 PM,311,129,182,clear night,
2017,Winter,04:00:00 PM,922,492,430,partly cloudy day,
2017,Fall,07:00:00 AM,110,54,56,clear day,Black Friday
2017,Winter,06:00:00 PM,533,279,254,partly cloudy night,
2017,Winter,03:00:00 PM,1865,853,1012,partly cloudy day,
2017,Fall,03:00:00 PM,2606,1376,1230,partly cloudy day,
2017,Fall,07:00:00 PM,899,298,601,clear night,
2017,Fall,08:00:00 PM,170,101,69,clear night,
2017,Winter,05:00:00 PM,185,113,72,fog,
2017,Fall,02:00:00 PM,1580,788,792,clear day,
2017,Fall,12:00:00 AM,40,27,13,clear night,
2017,Fall,10:00:00 PM,168,82,86,clear night,
2017,Winter,10:00:00 AM,1145,682,463,clear day,Christmas Day
2017,Fall,03:00:00 AM,6,3,3,partly cloudy night,
2017,Winter,05:00:00 AM,16,6,10,clear night,
2017,Fall,09:00:00 AM,360,153,207,partly cloudy day,
2018,Winter,08:00:00 AM,225,69,156,partly cloudy day,
2017,Fall,01:00:00 AM,12,8,4,partly cloudy night,
2017,Winter,04:00:00 PM,1796,850,946,clear day,
2017,Fall,01:00:00 PM,2001,941,1060,clear day,
2017,Fall,03:00:00 AM,5,3,2,partly cloudy night,
2017,Fall,03:00:00 PM,2094,1023,1071,clear day,Halloween
2017,Fall,12:00:00 PM,1975,785,1190,partly cloudy day,
2018,Winter,08:00:00 PM,180,156,24,clear night,
2018,Winter,03:00:00 PM,1337,691,646,clear day,
2017,Fall,05:00:00 PM,2344,1256,1088,partly cloudy day,
2017,Fall,08:00:00 PM,258,198,60,clear night,
2017,Winter,11:00:00 AM,1280,611,669,cloudy,
2017,Fall,06:00:00 PM,722,348,374,partly cloudy day,Columbus Day (regional holiday)
2018,Winter,03:00:00 PM,642,272,370,partly cloudy day,
2018,Winter,04:00:00 PM,677,348,329,clear day,
2017,Fall,02:00:00 PM,3047,1418,1629,partly cloudy day,
2017,Fall,11:00:00 AM,1644,923,721,clear day,
2017,Fall,11:00:00 PM,77,30,47,clear night,
2017,Fall,02:00:00 AM,9,3,6,clear night,
2017,Fall,04:00:00 AM,18,10,8,partly cloudy night,
2017,Fall,06:00:00 AM,92,53,39,partly cloudy night,
2017,Winter,05:00:00 PM,831,354,477,clear night,New Year's Eve
2017,Fall,06:00:00 AM,126,74,52,clear night,
2017,Fall,06:00:00 AM,121,86,35,partly cloudy night,
2017,Fall,09:00:00 AM,666,404,262,clear day,
2017,Winter,09:00:00 PM,171,83,88,clear night,
2017,Fall,04:00:00 PM,2083,1122,961,clear day,
2017,Fall,07:00:00 PM,318,163,155,clear night,
2017,Fall,06:00:00 PM,757,291,466,clear night,Black Friday
2017,Fall,05:00:00 AM,14,11,3,partly cloudy night,
2017,Winter,04:00:00 PM,533,250,283,fog,
2017,Winter,07:00:00 AM,210,106,104,clear night,
2017,Winter,01:00:00 AM,29,16,13,partly cloudy night,
2018,Winter,06:00:00 AM,5,3,2,clear night,
2017,Winter,02:00:00 AM,4,3,1,partly cloudy night,New Year's Eve
2017,Fall,02:00:00 AM,20,15,5,clear night,
2017,Fall,04:00:00 AM,1,1,0,partly cloudy night,
2017,Fall,10:00:00 PM,196,87,109,partly cloudy night,
2017,Fall,07:00:00 AM,291,125,166,clear night,
2017,Fall,03:00:00 PM,2384,1245,1139,clear day,
2017,Fall,03:00:00 AM,7,2,5,clear night,Columbus Day (regional holiday)
2018,Winter,10:00:00 AM,113,70,43,rain,
2017,Fall,05:00:00 AM,29,16,13,clear night,
2017,Fall,03:00:00 PM,3390,1556,1834,clear day,
2017,Winter,01:00:00 PM,2239,1014,1225,clear day,
2017,Winter,06:00:00 AM,17,8,9,clear night,
2018,Winter,04:00:00 AM,3,0,3,partly cloudy night,
2017,Winter,01:00:00 AM,10,5,5,partly cloudy night,
2018,Winter,04:00:00 PM,1844,792,1052,partly cloudy day,
2017,Fall,08:00:00 PM,107,55,52,partly cloudy night,
2017,Fall,09:00:00 AM,571,316,255,clear day,
2017,Fall,06:00:00 PM,1409,731,678,clear day,
2017,Fall,06:00:00 PM,561,361,200,clear night,
2017,Fall,11:00:00 PM,57,30,27,cloudy,
2018,Winter,05:00:00 PM,517,202,315,clear night,
2017,Fall,12:00:00 AM,16,9,7,clear night,
2017,Winter,01:00:00 PM,954,402,552,clear day,
2017,Fall,04:00:00 PM,3750,1758,1992,clear day,
2018,Winter,02:00:00 PM,861,445,416,clear day,
2017,Fall,01:00:00 AM,14,9,5,clear night,
2018,Winter,09:00:00 AM,198,83,115,partly cloudy day,
2017,Fall,04:00:00 PM,2226,1040,1186,clear day,Thanksgiving Day
2017,Winter,06:00:00 AM,57,27,30,partly cloudy night,
2017,Fall,04:00:00 PM,1495,833,662,clear day,
2017,Fall,09:00:00 PM,165,101,64,partly cloudy night,
2018,Winter,09:00:00 AM,168,87,81,partly cloudy day,
2017,Winter,03:00:00 AM,3,2,1,partly cloudy night,
2018,Winter,04:00:00 AM,5,2,3,clear night,
2018,Winter,02:00:00 AM,5,1,4,partly cloudy night,
2017,Winter,07:00:00 PM,465,296,169,partly cloudy night,
2018,Winter,06:00:00 AM,7,3,4,partly cloudy night,
2017,Fall,12:00:00 PM,2792,1508,1284,clear day,
2018,Winter,03:00:00 PM,2325,1386,939,clear day,New Year's Day
2017,Fall,12:00:00 AM,113,100,13,partly cloudy night,Veterans Day observed
2017,Fall,11:00:00 AM,2150,1126,1024,clear day,
2018,Winter,11:00:00 AM,544,280,264,clear day,
2017,Winter,09:00:00 AM,555,254,301,clear day,
2018,Winter,03:00:00 AM,1,0,1,clear night,
2017,Fall,04:00:00 AM,5,3,2,partly cloudy night,
2017,Fall,09:00:00 AM,408,197,211,partly cloudy day,
2017,Winter,12:00:00 AM,6,2,4,cloudy,Christmas Day
2017,Fall,12:00:00 AM,11,8,3,rain,
2017,Fall,12:00:00 AM,25,7,18,clear night,Halloween
2018,Winter,12:00:00 PM,611,313,298,clear day,
2018,Winter,04:00:00 AM,3,3,0,clear night,
2017,Fall,01:00:00 PM,1900,782,1118,clear day,
2018,Winter,09:00:00 PM,8,7,1,rain,
2017,Fall,07:00:00 PM,411,0,0,partly cloudy night,
2017,Winter,05:00:00 AM,3,0,3,clear night,Christmas Eve
2017,Fall,02:00:00 AM,26,15,11,partly cloudy night,
2017,Winter,11:00:00 PM,31,14,17,clear night,Christmas Day
2017,Winter,02:00:00 AM,3,2,1,partly cloudy night,
2017,Fall,10:00:00 PM,181,85,96,clear night,
2018,Winter,11:00:00 AM,828,315,513,clear day,
2018,Winter,11:00:00 PM,66,64,2,clear night,
2017,Fall,04:00:00 AM,5,2,3,clear night,
2017,Fall,07:00:00 PM,606,246,360,clear night,
2017,Fall,10:00:00 PM,80,38,42,partly cloudy night,
2017,Winter,02:00:00 PM,935,414,521,partly cloudy day,
2018,Winter,05:00:00 AM,3,0,3,partly cloudy night,Martin Luther King Jr. Day
2017,Fall,04:00:00 PM,1230,613,617,partly cloudy day,
2017,Fall,07:00:00 AM,283,128,155,clear night,
2017,Fall,01:00:00 PM,1112,508,604,clear day,
2017,Winter,10:00:00 AM,651,374,277,partly cloudy day,
2017,Fall,11:00:00 AM,1454,757,697,clear day,
2017,Fall,12:00:00 AM,26,15,11,clear night,
2018,Winter,01:00:00 AM,0,0,0,clear night,
2017,Fall,11:00:00 PM,112,61,51,cloudy,
2017,Fall,08:00:00 AM,350,131,219,clear day,Halloween
2017,Fall,08:00:00 PM,179,70,109,clear night,Halloween
2017,Fall,12:00:00 PM,1801,860,941,clear day,
2018,Winter,06:00:00 AM,14,6,8,partly cloudy night,
2018,Winter,09:00:00 AM,403,243,160,clear day,
2017,Fall,03:00:00 AM,6,4,2,clear night,Veterans Day
2017,Winter,03:00:00 PM,2028,1069,959,clear day,
2017,Winter,11:00:00 PM,126,110,16,clear night,
2018,Winter,02:00:00 AM,0,0,0,partly cloudy night,
2017,Fall,08:00:00 AM,289,158,131,clear day,
2018,Winter,07:00:00 PM,263,189,74,partly cloudy night,
2017,Fall,08:00:00 AM,360,143,217,clear day,
2017,Winter,05:00:00 AM,1,0,1,clear night,
2017,Winter,09:00:00 AM,321,169,152,partly cloudy day,
2017,Fall,08:00:00 PM,575,248,327,partly cloudy night,
2017,Fall,01:00:00 AM,15,6,9,partly cloudy night,
2018,Winter,01:00:00 AM,12,5,7,partly cloudy night,
2017,Winter,03:00:00 AM,0,0,0,clear night,
2017,Fall,01:00:00 PM,1431,658,773,partly cloudy day,
2018,Winter,02:00:00 PM,754,317,437,clear day,
2018,Winter,06:00:00 AM,27,11,16,clear night,
2017,Fall,08:00:00 PM,185,92,93,partly cloudy night,
2017,Fall,11:00:00 PM,50,14,36,partly cloudy night,
2017,Fall,12:00:00 AM,120,102,18,clear night,
2017,Fall,07:00:00 PM,536,195,341,clear night,
2018,Winter,07:00:00 PM,159,113,46,clear night,
2017,Winter,08:00:00 PM,420,238,182,partly cloudy night,
2017,Fall,08:00:00 PM,164,86,78,partly cloudy night,Daylight Saving Time ends
2018,Winter,03:00:00 PM,2514,1156,1358,clear day,
2018,Winter,08:00:00 AM,87,18,69,partly cloudy day,
2018,Winter,06:00:00 PM,490,352,138,partly cloudy night,
2017,Fall,04:00:00 PM,1364,619,745,clear day,
2018,Winter,01:00:00 PM,399,206,193,rain,
2017,Winter,01:00:00 AM,23,9,14,clear night,
2017,Fall,08:00:00 PM,319,137,182,partly cloudy night,
2017,Fall,10:00:00 AM,957,507,450,clear day,
2017,Winter,10:00:00 PM,37,34,3,rain,
2018,Winter,09:00:00 AM,278,160,118,snow,
2017,Fall,11:00:00 AM,3716,2316,1400,partly cloudy day,
2017,Fall,12:00:00 AM,49,23,26,clear night,
2018,Winter,07:00:00 PM,240,167,73,clear night,
2017,Winter,08:00:00 AM,195,96,99,partly cloudy day,
2017,Fall,08:00:00 PM,326,155,171,clear night,
2017,Winter,02:00:00 PM,1818,813,1005,clear day,
2017,Fall,01:00:00 PM,1827,806,1021,clear day,
2017,Fall,03:00:00 AM,5,4,1,clear night,
2018,Winter,03:00:00 PM,603,266,337,partly cloudy day,
2017,Fall,08:00:00 PM,11,9,2,rain,
2017,Fall,08:00:00 AM,199,102,97,clear day,Veterans Day
2017,Winter,12:00:00 PM,2629,1265,1364,clear day,
2017,Winter,03:00:00 AM,5,4,1,partly cloudy night,
2017,Fall,03:00:00 AM,3,3,0,clear night,Halloween
2018,Winter,08:00:00 PM,202,149,53,clear night,
2017,Fall,06:00:00 AM,42,28,14,clear night,
2018,Winter,11:00:00 AM,1045,579,466,partly cloudy day,
2017,Fall,11:00:00 AM,1593,893,700,clear day,
2017,Fall,11:00:00 PM,78,46,32,clear night,
2017,Fall,03:00:00 PM,2245,1189,1056,clear day,
2017,Winter,05:00:00 AM,20,10,10,clear night,
2017,Fall,07:00:00 PM,1132,373,759,clear night,
2017,Fall,08:00:00 AM,296,130,166,partly cloudy day,Columbus Day (regional holiday)
2018,Winter,07:00:00 PM,205,116,89,clear night,
2017,Fall,10:00:00 AM,970,607,363,cloudy,Daylight Saving Time ends
2017,Winter,09:00:00 AM,445,198,247,clear day,
2017,Fall,08:00:00 PM,341,160,181,clear night,
2017,Winter,01:00:00 PM,1291,452,839,clear day,
2018,Winter,11:00:00 PM,95,64,31,clear night,
2018,Winter,08:00:00 AM,56,21,35,partly cloudy day,
2017,Fall,10:00:00 PM,56,37,19,clear night,Veterans Day observed
2017,Fall,02:00:00 PM,1642,762,880,clear day,
2017,Winter,08:00:00 AM,240,73,167,cloudy,
2017,Fall,03:00:00 PM,1293,633,660,clear day,
2017,Fall,08:00:00 PM,226,113,113,clear night,Veterans Day
2017,Fall,10:00:00 AM,479,247,232,partly cloudy day,
2017,Fall,03:00:00 AM,3,0,3,clear night,Black Friday
2017,Fall,01:00:00 PM,1883,943,940,partly cloudy day,
2017,Winter,06:00:00 AM,86,49,37,cloudy,
2017,Fall,07:00:00 PM,16,8,8,rain,
2018,Winter,12:00:00 PM,463,228,235,rain,
2017,Winter,01:00:00 PM,1678,811,867,partly cloudy day,
2018,Winter,11:00:00 AM,1018,539,479,clear day,
2017,Fall,10:00:00 AM,1479,910,569,clear day,
2017,Fall,07:00:00 AM,223,108,115,cloudy,
2017,Winter,05:00:00 PM,1336,502,834,clear night,
2017,Fall,07:00:00 AM,191,83,108,clear night,
2018,Winter,02:00:00 PM,2160,1069,1091,clear day,
2017,Winter,01:00:00 PM,1600,607,993,clear day,
2017,Fall,04:00:00 PM,984,518,466,clear day,
2017,Fall,09:00:00 PM,406,170,236,clear night,
2018,Winter,08:00:00 PM,86,40,46,partly cloudy night,
2017,Fall,09:00:00 AM,537,248,289,clear day,
2017,Fall,07:00:00 AM,341,231,110,clear night,
2017,Winter,02:00:00 AM,5,1,4,clear night,
2017,Fall,06:00:00 PM,1739,1081,658,clear day,
2017,Fall,03:00:00 PM,1829,983,846,partly cloudy day,
2018,Winter,01:00:00 PM,1351,671,680,partly cloudy day,
2017,Fall,11:00:00 AM,2286,1130,1156,clear day,
2017,Fall,02:00:00 PM,1808,861,947,clear day,
2017,Fall,11:00:00 AM,2037,1087,950,clear day,
2017,Winter,10:00:00 PM,184,150,34,clear night,
2018,Winter,06:00:00 PM,319,239,80,partly cloudy night,
2017,Fall,10:00:00 AM,2628,2191,437,cloudy,
2017,Fall,06:00:00 AM,87,58,29,clear night,
2018,Winter,08:00:00 AM,169,81,88,clear day,
2018,Winter,11:00:00 PM,36,20,16,clear night,
2018,Winter,12:00:00 AM,10,6,4,clear night,
2017,Fall,11:00:00 AM,2004,1060,944,clear day,
2017,Fall,12:00:00 AM,27,8,19,clear night,
2017,Fall,01:00:00 AM,62,36,26,partly cloudy night,
2017,Fall,02:00:00 AM,8,3,5,partly cloudy night,
2018,Winter,05:00:00 PM,376,150,226,clear night,
2017,Winter,09:00:00 PM,200,107,93,partly cloudy night,
2017,Fall,01:00:00 PM,2245,1176,1069,clear day,
2017,Winter,12:00:00 AM,17,10,7,clear night,
2017,Fall,11:00:00 PM,25,13,12,clear night,
2017,Fall,04:00:00 AM,0,0,0,clear night,
2017,Winter,06:00:00 PM,580,348,232,clear night,
2018,Winter,07:00:00 PM,149,65,84,clear night,Martin Luther King Jr. Day
2018,Winter,01:00:00 AM,9,5,4,partly cloudy night,
2017,Fall,06:00:00 PM,1330,555,775,cloudy,
2017,Fall,11:00:00 AM,1530,830,700,clear day,
2017,Fall,11:00:00 PM,87,57,30,clear night,
2017,Winter,01:00:00 AM,10,7,3,clear night,
2017,Fall,01:00:00 AM,8,5,3,clear night,
2017,Fall,11:00:00 AM,1319,664,655,partly cloudy day,
2017,Winter,10:00:00 PM,404,301,103,clear night,New Year's Eve
2017,Winter,09:00:00 AM,263,126,137,partly cloudy day,
2017,Winter,01:00:00 AM,13,7,6,partly cloudy night,
2018,Winter,07:00:00 AM,125,55,70,clear night,
2017,Fall,08:00:00 AM,184,110,74,partly cloudy day,
2017,Winter,10:00:00 AM,1062,576,486,clear day,
2017,Fall,09:00:00 PM,356,163,193,partly cloudy night,
2018,Winter,02:00:00 AM,10,6,4,clear night,
2017,Fall,11:00:00 PM,67,56,11,partly cloudy night,
2017,Fall,11:00:00 AM,4330,2150,2180,clear day,
2018,Winter,10:00:00 PM,23,16,7,clear night,
2017,Winter,05:00:00 AM,31,18,13,partly cloudy night,
2017,Fall,03:00:00 PM,2391,1187,1204,partly cloudy day,
2017,Winter,02:00:00 AM,11,5,6,clear night,Christmas Eve
2018,Winter,10:00:00 AM,277,158,119,partly cloudy day,
2018,Winter,12:00:00 AM,22,14,8,clear night,
2018,Winter,12:00:00 PM,872,404,468,clear day,
2017,Winter,12:00:00 AM,123,114,9,partly cloudy night,
2017,Winter,07:00:00 PM,282,156,126,clear night,Christmas Day
2017,Fall,11:00:00 PM,80,42,38,partly cloudy night,Columbus Day (regional holiday)
2018,Winter,02:00:00 PM,828,383,445,clear day,
2018,Winter,06:00:00 AM,20,10,10,clear night,
2017,Winter,02:00:00 AM,15,9,6,clear night,
2017,Fall,05:00:00 AM,17,9,8,partly cloudy night,
2018,Winter,05:00:00 PM,163,92,71,partly cloudy night,
2017,Fall,07:00:00 AM,297,180,117,clear night,
2017,Fall,08:00:00 AM,507,236,271,partly cloudy day,
2017,Fall,12:00:00 AM,24,11,13,clear night,
2017,Fall,03:00:00 PM,2679,1281,1398,clear day,
2018,Winter,11:00:00 PM,47,27,20,partly cloudy night,
2017,Winter,05:00:00 PM,549,323,226,clear night,
2017,Winter,09:00:00 PM,219,163,56,clear night,
2017,Fall,11:00:00 AM,1484,861,623,partly cloudy day,
2017,Fall,04:00:00 AM,5,5,0,partly cloudy night,
2018,Winter,05:00:00 AM,10,8,2,partly cloudy night,
2017,Winter,10:00:00 AM,916,450,466,partly cloudy day,
2018,Winter,02:00:00 AM,8,4,4,clear night,
2018,Winter,11:00:00 PM,7,3,4,clear night,
2017,Fall,11:00:00 AM,2464,1519,945,clear day,
2017,Fall,08:00:00 AM,297,98,199,clear day,
2018,Winter,05:00:00 PM,510,266,244,partly cloudy day,
2017,Winter,07:00:00 AM,46,28,18,clear night,New Year's Eve
2017,Fall,04:00:00 AM,1,0,1,partly cloudy night,
2017,Fall,09:00:00 AM,400,213,187,clear day,
2017,Winter,12:00:00 PM,943,396,547,clear day,
2017,Winter,06:00:00 PM,669,360,309,clear night,
2017,Fall,06:00:00 AM,131,76,55,clear night,
2017,Winter,11:00:00 PM,43,20,23,clear night,
2017,Fall,04:00:00 PM,2241,1201,1040,partly cloudy day,
2017,Winter,04:00:00 AM,3,2,1,partly cloudy night,
2018,Winter,11:00:00 PM,6,5,1,rain,
2018,Winter,10:00:00 PM,76,40,36,clear night,
2017,Fall,04:00:00 PM,3558,1763,1795,clear day,
2017,Fall,10:00:00 PM,150,68,82,clear night,
2017,Fall,01:00:00 PM,1321,609,712,partly cloudy day,
2017,Fall,04:00:00 AM,3,2,1,partly cloudy night,
2017,Fall,12:00:00 PM,1940,955,985,partly cloudy day,
2017,Fall,04:00:00 PM,1960,1000,960,clear day,
2017,Winter,04:00:00 PM,1634,724,910,clear day,
2018,Winter,04:00:00 AM,1,0,1,cloudy,
2018,Winter,11:00:00 AM,777,423,354,partly cloudy day,
2017,Fall,06:00:00 PM,450,224,226,clear night,
2017,Winter,05:00:00 PM,655,337,318,partly cloudy night,
2017,Fall,04:00:00 AM,2,1,1,partly cloudy night,
2018,Winter,03:00:00 PM,979,450,529,clear day,
2017,Fall,06:00:00 AM,38,23,15,clear night,
2017,Fall,01:00:00 AM,11,7,4,clear night,
2017,Winter,10:00:00 PM,168,99,69,partly cloudy night,
2017,Fall,12:00:00 PM,1213,506,707,clear day,Veterans Day observed
2018,Winter,11:00:00 AM,535,298,237,partly cloudy day,
2018,Spring,04:00:00 AM,7,5,2,partly cloudy night,
2018,Spring,10:00:00 PM,70,39,31,partly cloudy night,
2018,Spring,05:00:00 AM,7,2,5,clear night,
2018,Winter,10:00:00 PM,16,13,3,partly cloudy night,
2018,Spring,04:00:00 PM,2285,1037,1248,partly cloudy day,
2018,Summer,10:00:00 PM,229,87,142,cloudy,
2018,Spring,03:00:00 AM,3,1,2,partly cloudy night,Easter Sunday
2018,Spring,10:00:00 AM,730,348,382,cloudy,
2018,Spring,05:00:00 AM,13,8,5,clear night,
2018,Summer,03:00:00 PM,2567,1165,1402,clear day,
2018,Spring,03:00:00 PM,2478,1127,1351,clear day,
2018,Spring,03:00:00 AM,7,5,2,partly cloudy night,
2018,Spring,02:00:00 PM,2083,848,1235,partly cloudy day,
2018,Spring,05:00:00 AM,38,21,17,clear night,
2018,Spring,06:00:00 PM,888,331,557,cloudy,
2018,Spring,08:00:00 AM,424,154,270,clear day,
2018,Spring,06:00:00 PM,2235,1004,1231,clear day,Easter Sunday
2018,Spring,03:00:00 PM,1297,628,669,partly cloudy day,Tax Day
2018,Spring,07:00:00 AM,335,122,213,clear day,
2018,Spring,08:00:00 PM,527,247,280,clear night,
2018,Spring,06:00:00 AM,26,11,15,partly cloudy night,
2018,Spring,09:00:00 PM,765,260,505,clear night,
2018,Spring,05:00:00 PM,1366,737,629,clear day,
2018,Spring,06:00:00 AM,37,23,14,cloudy,
2018,Winter,06:00:00 AM,108,74,34,fog,
2018,Spring,09:00:00 AM,759,432,327,cloudy,
2018,Spring,02:00:00 AM,4,3,1,clear night,
2018,Winter,07:00:00 PM,119,96,23,rain,
2018,Summer,10:00:00 AM,1176,694,482,partly cloudy day,
2018,Spring,12:00:00 AM,148,115,33,clear night,
2018,Spring,03:00:00 PM,2515,1226,1289,clear day,
2018,Spring,05:00:00 PM,1767,681,1086,partly cloudy day,
2018,Spring,04:00:00 PM,2610,1199,1411,clear day,
2018,Spring,03:00:00 AM,7,2,5,partly cloudy night,
2018,Summer,06:00:00 AM,178,86,92,clear day,
2018,Spring,05:00:00 PM,860,445,415,snow,
2018,Spring,02:00:00 PM,751,344,407,rain,Mother's Day
2018,Winter,06:00:00 AM,56,36,20,clear night,
2018,Spring,09:00:00 AM,587,355,232,partly cloudy day,Mother's Day
2018,Summer,09:00:00 AM,440,250,190,partly cloudy day,
2018,Spring,10:00:00 PM,355,177,178,partly cloudy night,
2018,Spring,08:00:00 PM,938,394,544,partly cloudy night,
2018,Spring,03:00:00 PM,2031,913,1118,partly cloudy day,
2018,Spring,04:00:00 PM,842,392,450,partly cloudy day,
2018,Spring,02:00:00 AM,25,14,11,clear night,
2018,Spring,07:00:00 PM,786,424,362,cloudy,
2018,Spring,09:00:00 AM,759,372,387,clear day,
2018,Spring,04:00:00 PM,669,363,306,partly cloudy day,
2018,Spring,04:00:00 AM,7,5,2,rain,
2018,Spring,08:00:00 AM,370,154,216,partly cloudy day,
2018,Winter,12:00:00 AM,96,89,7,partly cloudy night,
2018,Spring,12:00:00 AM,13,12,1,clear night,
2018,Spring,02:00:00 AM,6,3,3,clear night,
2018,Winter,12:00:00 PM,1518,696,822,partly cloudy day,Presidents' Day (regional holiday)
2018,Spring,02:00:00 AM,6,4,2,partly cloudy night,
2018,Spring,01:00:00 PM,558,224,334,rain,
2018,Summer,09:00:00 PM,572,202,370,partly cloudy night,
2018,Spring,02:00:00 PM,1699,711,988,partly cloudy day,
2018,Spring,07:00:00 AM,123,58,65,clear night,
2018,Spring,10:00:00 PM,71,48,23,partly cloudy night,
2018,Summer,06:00:00 PM,1378,739,639,cloudy,
2018,Winter,10:00:00 PM,76,44,32,clear night,
2018,Spring,05:00:00 AM,4,0,4,partly cloudy night,
2018,Spring,12:00:00 AM,20,15,5,clear night,
2018,Winter,10:00:00 AM,628,363,265,partly cloudy day,
2018,Spring,04:00:00 PM,2247,972,1275,cloudy,
2018,Spring,04:00:00 AM,1,0,1,partly cloudy night,
2018,Spring,06:00:00 AM,57,37,20,partly cloudy night,
2018,Spring,05:00:00 PM,2353,970,1383,clear day,
2018,Spring,08:00:00 PM,791,325,466,clear night,
2018,Summer,04:00:00 AM,15,13,2,cloudy,
2018,Spring,04:00:00 AM,4,3,1,clear night,
2018,Winter,03:00:00 PM,1433,746,687,clear day,
2018,Spring,03:00:00 AM,4,1,3,clear night,
2018,Spring,04:00:00 AM,6,5,1,fog,
2018,Spring,04:00:00 AM,2,0,2,cloudy,
2018,Spring,09:00:00 AM,227,140,87,rain,
2018,Spring,04:00:00 AM,0,0,0,partly cloudy night,
2018,Spring,03:00:00 AM,1,1,0,clear night,St. Patrick's Day
2018,Spring,03:00:00 PM,3812,1826,1986,clear day,
2018,Winter,01:00:00 PM,2047,897,1150,partly cloudy day,
2018,Spring,04:00:00 PM,319,155,164,rain,
2018,Winter,07:00:00 PM,409,251,158,clear night,Valentine's Day
2018,Spring,01:00:00 AM,38,18,20,clear night,
2018,Spring,06:00:00 AM,80,48,32,clear night,
2018,Winter,01:00:00 AM,0,0,0,partly cloudy night,
2018,Spring,04:00:00 AM,4,2,2,clear night,
2018,Spring,04:00:00 AM,4,2,2,cloudy,Mother's Day
2018,Spring,10:00:00 AM,834,432,402,partly cloudy day,
2018,Winter,04:00:00 AM,13,9,4,clear night,
2018,Spring,07:00:00 PM,405,238,167,partly cloudy night,
2018,Spring,07:00:00 PM,1733,756,977,clear day,
2018,Spring,12:00:00 AM,55,21,34,clear night,
2018,Spring,01:00:00 PM,1028,536,492,partly cloudy day,
2018,Spring,07:00:00 AM,189,75,114,clear day,
2018,Winter,05:00:00 PM,994,474,520,partly cloudy day,
2018,Spring,02:00:00 PM,1110,470,640,partly cloudy day,
2018,Spring,01:00:00 AM,12,6,6,clear night,
2018,Spring,07:00:00 PM,563,299,264,partly cloudy day,
2018,Spring,07:00:00 AM,176,48,128,clear day,
2018,Spring,07:00:00 AM,11,4,7,rain,
2018,Winter,02:00:00 AM,9,7,2,partly cloudy night,
2018,Winter,05:00:00 PM,825,298,527,partly cloudy day,Presidents' Day (regional holiday)
2018,Spring,07:00:00 PM,1564,817,747,clear day,
2018,Spring,12:00:00 PM,2205,945,1260,partly cloudy day,
2018,Spring,08:00:00 AM,425,147,278,clear day,
2018,Spring,01:00:00 AM,1,0,1,clear night,
2018,Spring,02:00:00 PM,1787,832,955,clear day,
2018,Spring,11:00:00 PM,74,29,45,partly cloudy night,
2018,Winter,01:00:00 AM,24,7,17,cloudy,
2018,Spring,06:00:00 PM,1285,556,729,clear day,St. Patrick's Day
2018,Winter,03:00:00 AM,8,1,7,clear night,
2018,Spring,12:00:00 PM,1769,779,990,clear day,
2018,Winter,08:00:00 PM,283,185,98,clear night,
2018,Spring,07:00:00 AM,79,36,43,clear day,
2018,Spring,06:00:00 AM,28,14,14,rain,
2018,Spring,05:00:00 PM,2840,1124,1716,partly cloudy day,
2018,Spring,07:00:00 AM,169,84,85,clear day,
2018,Summer,01:00:00 AM,71,46,25,clear night,
2018,Spring,07:00:00 PM,163,63,100,partly cloudy night,
2018,Spring,05:00:00 AM,32,20,12,partly cloudy night,
2018,Spring,10:00:00 PM,123,73,50,clear night,
2018,Spring,03:00:00 AM,7,0,7,clear night,
2018,Spring,06:00:00 AM,192,95,97,clear day,
2018,Summer,01:00:00 PM,1859,861,998,partly cloudy day,
2018,Spring,01:00:00 PM,1583,721,862,clear day,
2018,Spring,03:00:00 PM,1385,671,714,partly cloudy day,
2018,Winter,08:00:00 PM,135,71,64,clear night,
2018,Spring,05:00:00 PM,1814,1017,797,clear day,
2018,Spring,12:00:00 PM,1258,593,665,partly cloudy day,
2018,Spring,11:00:00 AM,208,86,122,partly cloudy day,
2018,Spring,07:00:00 PM,694,340,354,rain,
2018,Spring,11:00:00 AM,1775,866,909,clear day,
2018,Winter,02:00:00 AM,2,0,2,partly cloudy night,Valentine's Day
2018,Winter,01:00:00 PM,1133,534,599,partly cloudy day,
2018,Spring,12:00:00 AM,44,26,18,clear night,
2018,Spring,07:00:00 AM,211,101,110,clear day,
2018,Spring,01:00:00 PM,147,88,59,snow,
2018,Summer,01:00:00 AM,23,14,9,rain,
2018,Spring,11:00:00 AM,1035,497,538,partly cloudy day,
2018,Spring,05:00:00 AM,48,39,9,clear night,
2018,Spring,12:00:00 AM,29,11,18,cloudy,
2018,Spring,06:00:00 AM,123,58,65,fog,
2018,Spring,08:00:00 PM,306,182,124,rain,
2018,Summer,05:00:00 AM,53,34,19,partly cloudy night,
2018,Spring,11:00:00 PM,185,111,74,clear night,
2018,Spring,04:00:00 AM,4,1,3,clear night,
2018,Spring,05:00:00 PM,1246,633,613,cloudy,
2018,Spring,09:00:00 AM,672,410,262,clear day,
2018,Spring,08:00:00 PM,1899,709,1190,clear day,
2018,Spring,11:00:00 AM,1930,901,1029,clear day,
2018,Spring,11:00:00 AM,1359,684,675,clear day,
2018,Spring,08:00:00 AM,561,214,347,clear day,
2018,Summer,05:00:00 PM,2208,1156,1052,clear day,
2018,Summer,02:00:00 AM,15,4,11,clear night,
2018,Spring,11:00:00 PM,179,60,119,clear night,
2018,Spring,10:00:00 AM,739,440,299,fog,
2018,Spring,07:00:00 AM,150,69,81,clear day,
2018,Winter,09:00:00 PM,16,7,9,snow,
2018,Summer,08:00:00 PM,999,423,576,clear day,
2018,Spring,10:00:00 AM,1020,529,491,clear day,
2018,Spring,08:00:00 PM,860,327,533,clear night,
2018,Spring,05:00:00 PM,1824,974,850,clear day,
2018,Spring,10:00:00 PM,2,0,2,partly cloudy night,
2018,Spring,06:00:00 PM,107,64,43,snow,
2018,Spring,08:00:00 AM,73,36,37,rain,
2018,Spring,09:00:00 AM,210,95,115,partly cloudy day,
2018,Spring,01:00:00 PM,1825,896,929,cloudy,
2018,Spring,11:00:00 PM,68,26,42,partly cloudy night,
2018,Winter,06:00:00 AM,50,34,16,clear night,
2018,Spring,01:00:00 AM,6,1,5,clear night,
2018,Spring,10:00:00 AM,144,96,48,partly cloudy day,
2018,Summer,01:00:00 PM,1928,841,1087,partly cloudy day,
2018,Spring,06:00:00 AM,99,53,46,clear night,
2018,Winter,06:00:00 PM,148,109,39,cloudy,
2018,Winter,01:00:00 AM,25,16,9,clear night,
2018,Spring,12:00:00 PM,1565,771,794,clear day,
2018,Spring,03:00:00 AM,10,8,2,clear night,
2018,Winter,08:00:00 AM,253,83,170,partly cloudy day,
2018,Spring,08:00:00 AM,369,123,246,clear day,
2018,Spring,03:00:00 AM,6,2,4,partly cloudy night,
2018,Summer,06:00:00 AM,77,33,44,partly cloudy day,
2018,Spring,03:00:00 PM,3088,1564,1524,clear day,
2018,Winter,08:00:00 PM,416,249,167,clear night,
2018,Spring,10:00:00 PM,177,136,41,cloudy,
2018,Spring,03:00:00 PM,739,392,347,rain,
2018,Winter,09:00:00 AM,257,117,140,cloudy,
2018,Spring,08:00:00 AM,190,100,90,cloudy,
2018,Winter,08:00:00 AM,329,131,198,clear day,
2018,Spring,05:00:00 AM,35,25,10,cloudy,
2018,Spring,04:00:00 AM,7,4,3,partly cloudy night,
2018,Spring,06:00:00 PM,1642,794,848,clear day,
2018,Summer,11:00:00 PM,12,7,5,partly cloudy night,
2018,Spring,10:00:00 PM,98,43,55,partly cloudy night,
2018,Spring,03:00:00 PM,18,12,6,rain,
2018,Spring,01:00:00 PM,370,222,148,rain,
2018,Winter,06:00:00 AM,34,18,16,partly cloudy night,
2018,Spring,06:00:00 AM,64,33,31,partly cloudy night,
2018,Spring,10:00:00 AM,2167,1272,895,clear day,
2018,Winter,11:00:00 AM,993,482,511,clear day,
2018,Spring,10:00:00 PM,18,15,3,rain,
2018,Spring,10:00:00 PM,119,54,65,clear night,
2018,Spring,10:00:00 AM,481,230,251,clear day,
2018,Spring,10:00:00 PM,52,19,33,partly cloudy night,
2018,Spring,10:00:00 PM,75,38,37,partly cloudy night,
2018,Spring,11:00:00 PM,90,53,37,clear night,
2018,Spring,10:00:00 AM,1072,617,455,clear day,
2018,Winter,11:00:00 AM,883,435,448,clear day,
2018,Spring,12:00:00 PM,2206,983,1223,partly cloudy day,
2018,Spring,02:00:00 AM,2,1,1,partly cloudy night,Tax Day
2018,Summer,06:00:00 PM,1333,585,748,partly cloudy day,
2018,Spring,11:00:00 PM,7,5,2,snow,
2018,Spring,01:00:00 PM,2006,911,1095,clear day,
2018,Spring,11:00:00 AM,2693,1196,1497,clear day,
2018,Spring,04:00:00 PM,812,351,461,cloudy,
2018,Spring,01:00:00 AM,19,13,6,clear night,
2018,Winter,02:00:00 AM,6,4,2,partly cloudy night,
2018,Winter,01:00:00 AM,4,3,1,partly cloudy night,
2018,Winter,09:00:00 AM,127,45,82,partly cloudy day,
2018,Spring,12:00:00 AM,81,72,9,cloudy,
2018,Summer,02:00:00 AM,11,3,8,clear night,
2018,Spring,10:00:00 AM,1269,684,585,clear day,
2018,Spring,04:00:00 PM,1886,899,987,clear day,
2018,Spring,11:00:00 PM,182,92,90,cloudy,
2018,Spring,05:00:00 AM,6,3,3,cloudy,
2018,Spring,03:00:00 PM,4001,1975,2026,clear day,
2018,Winter,06:00:00 AM,97,49,48,clear night,
2018,Summer,05:00:00 AM,47,33,14,partly cloudy night,
2018,Spring,08:00:00 PM,181,94,87,partly cloudy night,
2018,Winter,11:00:00 PM,36,20,16,clear night,
2018,Winter,11:00:00 PM,96,91,5,partly cloudy night,
2018,Spring,05:00:00 AM,65,36,29,partly cloudy night,
2018,Summer,03:00:00 PM,1793,813,980,cloudy,
2018,Summer,09:00:00 PM,713,246,467,clear night,
2018,Spring,08:00:00 AM,379,194,185,cloudy,
2018,Spring,08:00:00 PM,617,249,368,clear night,
2018,Winter,09:00:00 PM,78,37,41,cloudy,
2018,Spring,01:00:00 AM,26,12,14,partly cloudy night,
2018,Spring,01:00:00 PM,1817,829,988,partly cloudy day,
2018,Spring,08:00:00 AM,248,148,100,partly cloudy day,
2018,Spring,06:00:00 AM,43,21,22,clear night,
2018,Spring,01:00:00 PM,1952,938,1014,partly cloudy day,
2018,Spring,08:00:00 PM,272,187,85,partly cloudy night,
2018,Spring,01:00:00 AM,38,18,20,clear night,
2018,Summer,06:00:00 AM,124,55,69,cloudy,
2018,Spring,04:00:00 AM,9,5,4,partly cloudy night,
2018,Spring,06:00:00 AM,113,57,56,clear day,Cinco de Mayo
2018,Spring,11:00:00 AM,1050,540,510,partly cloudy day,
2018,Spring,01:00:00 AM,6,4,2,clear night,
2018,Spring,01:00:00 AM,27,9,18,partly cloudy night,
2018,Winter,05:00:00 PM,800,377,423,partly cloudy day,
2018,Spring,10:00:00 AM,743,418,325,partly cloudy day,
2018,Spring,11:00:00 PM,171,131,40,partly cloudy night,
2018,Spring,08:00:00 AM,298,174,124,partly cloudy day,Easter Sunday
2018,Spring,05:00:00 AM,10,9,1,cloudy,
2018,Spring,12:00:00 PM,2190,996,1194,clear day,
2018,Spring,09:00:00 AM,617,352,265,cloudy,
2018,Spring,01:00:00 PM,1443,728,715,cloudy,
2018,Spring,03:00:00 AM,9,4,5,clear night,
2018,Spring,12:00:00 AM,12,7,5,partly cloudy night,
2018,Spring,09:00:00 PM,169,108,61,rain,
2018,Spring,12:00:00 PM,2023,863,1160,clear day,
2018,Spring,10:00:00 AM,461,259,202,partly cloudy day,
2018,Spring,11:00:00 PM,102,38,64,clear night,Easter Sunday
2018,Spring,04:00:00 AM,0,0,0,clear night,
2018,Spring,02:00:00 AM,7,1,6,partly cloudy night,
2018,Spring,09:00:00 AM,980,596,384,clear day,
2018,Spring,01:00:00 PM,1989,896,1093,partly cloudy day,
2018,Summer,10:00:00 PM,378,192,186,clear night,
2018,Spring,10:00:00 AM,858,421,437,partly cloudy day,
2018,Spring,08:00:00 AM,67,22,45,partly cloudy day,
2018,Spring,11:00:00 AM,719,297,422,partly cloudy day,
2018,Summer,01:00:00 PM,2190,1008,1182,partly cloudy day,
2018,Winter,05:00:00 AM,9,7,2,clear night,Presidents' Day (regional holiday)
2018,Spring,03:00:00 AM,1,0,1,partly cloudy night,
2018,Winter,11:00:00 AM,1065,500,565,clear day,
2018,Spring,11:00:00 AM,568,357,211,snow,
2018,Winter,10:00:00 AM,239,144,95,rain,
2018,Spring,11:00:00 AM,2454,1353,1101,clear day,Cinco de Mayo
2018,Spring,08:00:00 PM,396,220,176,partly cloudy night,
2018,Spring,11:00:00 PM,101,88,13,partly cloudy night,
2018,Spring,07:00:00 PM,651,297,354,partly cloudy night,
2018,Spring,09:00:00 AM,627,341,286,partly cloudy day,
2018,Spring,07:00:00 PM,930,421,509,partly cloudy day,
2018,Spring,11:00:00 PM,30,16,14,partly cloudy night,
2018,Spring,08:00:00 AM,496,208,288,partly cloudy day,
2018,Spring,02:00:00 PM,2176,996,1180,clear day,Daylight Saving Time starts
2018,Winter,07:00:00 AM,149,63,86,partly cloudy day,
2018,Spring,04:00:00 PM,1170,590,580,clear day,
2018,Winter,09:00:00 PM,215,151,64,rain,
2018,Spring,09:00:00 PM,162,62,100,clear night,
2018,Spring,07:00:00 PM,1216,514,702,clear day,
2018,Spring,11:00:00 AM,974,523,451,clear day,
2018,Winter,06:00:00 PM,751,375,376,clear night,
2018,Spring,12:00:00 PM,2463,1343,1120,clear day,
2018,Spring,09:00:00 AM,719,342,377,clear day,
2018,Spring,09:00:00 PM,92,51,41,cloudy,Mother's Day
2018,Spring,06:00:00 PM,1352,642,710,clear day,
2018,Spring,12:00:00 PM,1903,915,988,clear day,
2018,Summer,09:00:00 PM,806,291,515,partly cloudy night,
2018,Spring,07:00:00 AM,258,115,143,clear day,
2018,Spring,09:00:00 AM,209,102,107,partly cloudy day,
2018,Spring,07:00:00 PM,432,251,181,cloudy,
2018,Spring,08:00:00 PM,487,234,253,cloudy,
2018,Spring,08:00:00 PM,551,283,268,partly cloudy night,
2018,Spring,12:00:00 AM,20,0,20,partly cloudy night,
2018,Spring,04:00:00 AM,11,9,2,partly cloudy night,
2018,Spring,05:00:00 AM,53,31,22,clear night,
2018,Spring,07:00:00 AM,194,101,93,clear day,
2018,Winter,07:00:00 PM,284,206,78,clear night,
2018,Summer,10:00:00 AM,1539,929,610,clear day,
2018,Spring,08:00:00 PM,882,356,526,clear night,
2018,Spring,12:00:00 AM,9,8,1,cloudy,
2018,Spring,05:00:00 PM,1166,552,614,partly cloudy day,
2018,Spring,03:00:00 PM,1362,614,748,partly cloudy day,
2018,Spring,02:00:00 AM,9,3,6,clear night,
2018,Spring,02:00:00 PM,1364,639,725,clear day,
2018,Spring,05:00:00 AM,43,21,22,partly cloudy night,
2018,Spring,02:00:00 AM,11,8,3,clear night,
2018,Winter,10:00:00 AM,551,285,266,partly cloudy day,
2018,Winter,01:00:00 AM,6,0,6,clear night,
2018,Spring,02:00:00 PM,1983,925,1058,clear day,St. Patrick's Day
2018,Spring,10:00:00 PM,76,44,32,clear night,
2018,Spring,03:00:00 PM,895,414,481,partly cloudy day,
2018,Winter,01:00:00 AM,15,13,2,clear night,
2018,Spring,06:00:00 AM,100,50,50,clear night,
2018,Spring,07:00:00 PM,1099,457,642,partly cloudy day,
2018,Spring,04:00:00 PM,2537,1213,1324,clear day,
2018,Spring,07:00:00 PM,1410,407,1003,clear day,
2018,Spring,02:00:00 PM,3435,1643,1792,clear day,
2018,Spring,02:00:00 AM,3,2,1,rain,
2018,Summer,07:00:00 AM,284,115,169,clear day,
2018,Spring,04:00:00 PM,1701,882,819,rain,
2018,Spring,06:00:00 PM,1064,576,488,partly cloudy day,
2018,Spring,07:00:00 PM,215,136,79,cloudy,
2018,Winter,02:00:00 PM,2000,899,1101,partly cloudy day,
2018,Spring,07:00:00 PM,1550,805,745,partly cloudy day,
2018,Spring,09:00:00 PM,185,93,92,partly cloudy night,Tax Day
2018,Spring,12:00:00 PM,1900,938,962,partly cloudy day,
2018,Winter,09:00:00 AM,536,359,177,clear day,
2018,Spring,02:00:00 PM,2153,986,1167,partly cloudy day,
2018,Winter,02:00:00 PM,1149,572,577,clear day,
2018,Spring,11:00:00 PM,39,16,23,clear night,
2018,Spring,09:00:00 PM,799,267,532,clear night,
2018,Spring,01:00:00 AM,24,14,10,partly cloudy night,
2018,Spring,04:00:00 AM,7,3,4,clear night,
2018,Summer,06:00:00 PM,1744,946,798,clear day,
2018,Spring,06:00:00 PM,797,439,358,partly cloudy day,
2018,Spring,12:00:00 AM,61,43,18,partly cloudy night,
2018,Summer,12:00:00 PM,2223,1131,1092,clear day,
2018,Winter,05:00:00 AM,19,15,4,partly cloudy night,
2018,Spring,04:00:00 AM,6,0,6,clear night,
2018,Spring,01:00:00 AM,62,24,38,partly cloudy night,Cinco de Mayo
2018,Winter,02:00:00 PM,842,371,471,partly cloudy day,
2018,Spring,09:00:00 AM,97,44,53,rain,
2018,Spring,07:00:00 AM,143,60,83,clear day,
2018,Spring,06:00:00 PM,1123,494,629,cloudy,
2018,Spring,12:00:00 AM,39,19,20,partly cloudy night,Tax Day
2018,Spring,12:00:00 PM,2611,1134,1477,clear day,
2018,Spring,06:00:00 AM,126,68,58,partly cloudy day,
2018,Spring,05:00:00 AM,12,10,2,partly cloudy night,
2018,Spring,04:00:00 PM,2110,1033,1077,clear day,
2018,Spring,07:00:00 PM,968,399,569,partly cloudy day,
2018,Winter,02:00:00 AM,3,0,3,clear night,
2018,Spring,07:00:00 AM,202,59,143,partly cloudy day,
2018,Summer,02:00:00 PM,1825,850,975,partly cloudy day,
2018,Spring,04:00:00 PM,1690,742,948,clear day,
2018,Spring,04:00:00 AM,4,0,4,partly cloudy night,
2018,Summer,06:00:00 AM,215,101,114,clear day,
2018,Winter,06:00:00 PM,722,411,311,clear night,
2018,Spring,03:00:00 PM,3025,1345,1680,clear day,
2018,Winter,06:00:00 AM,101,51,50,cloudy,
2018,Spring,09:00:00 PM,543,273,270,clear night,
2018,Winter,05:00:00 AM,7,2,5,clear night,
2018,Spring,12:00:00 AM,21,15,6,partly cloudy night,
2018,Spring,06:00:00 PM,1507,748,759,partly cloudy day,
2018,Spring,05:00:00 AM,13,0,13,partly cloudy night,
2018,Spring,04:00:00 PM,1891,623,1268,partly cloudy day,
2018,Winter,03:00:00 PM,919,455,464,clear day,
2018,Spring,06:00:00 AM,78,43,35,partly cloudy night,Tax Day
2018,Spring,12:00:00 PM,1961,935,1026,clear day,
2018,Spring,01:00:00 AM,23,11,12,cloudy,Mother's Day
2018,Summer,01:00:00 PM,1702,810,892,partly cloudy day,
2018,Summer,06:00:00 AM,119,54,65,partly cloudy day,
2018,Winter,07:00:00 PM,435,250,185,clear night,
2018,Spring,05:00:00 PM,2072,984,1088,clear day,
2018,Spring,03:00:00 PM,2774,1220,1554,partly cloudy day,
2018,Spring,12:00:00 AM,120,67,53,clear night,
2018,Summer,07:00:00 AM,183,83,100,clear day,
2018,Spring,06:00:00 PM,2670,1042,1628,clear day,
2018,Spring,12:00:00 AM,52,17,35,partly cloudy night,
2018,Winter,05:00:00 PM,1487,800,687,clear day,
2018,Spring,11:00:00 AM,2595,1373,1222,partly cloudy day,Memorial Day
2018,Spring,09:00:00 AM,284,124,160,partly cloudy day,
2018,Spring,05:00:00 AM,4,2,2,cloudy,
2018,Spring,03:00:00 AM,9,6,3,partly cloudy night,
2018,Spring,04:00:00 AM,11,6,5,partly cloudy night,
2018,Spring,12:00:00 AM,20,15,5,partly cloudy night,
2018,Spring,12:00:00 PM,1396,502,894,cloudy,Mother's Day
2018,Spring,06:00:00 PM,553,248,305,partly cloudy night,
2018,Summer,11:00:00 PM,158,71,87,clear night,
2018,Spring,02:00:00 PM,1714,785,929,partly cloudy day,
2018,Spring,08:00:00 PM,838,358,480,partly cloudy day,
2018,Winter,01:00:00 PM,1567,719,848,partly cloudy day,
2018,Winter,01:00:00 AM,8,4,4,partly cloudy night,
2018,Spring,12:00:00 AM,30,14,16,clear night,
2018,Winter,03:00:00 PM,1041,483,558,partly cloudy day,
2018,Spring,09:00:00 PM,580,180,400,cloudy,Memorial Day
2018,Spring,12:00:00 PM,349,168,181,rain,
2018,Spring,06:00:00 AM,33,18,15,partly cloudy day,
2018,Spring,11:00:00 AM,2245,1160,1085,clear day,Easter Sunday
2018,Spring,09:00:00 PM,663,304,359,clear night,
2018,Spring,01:00:00 PM,1937,929,1008,clear day,
2018,Spring,05:00:00 PM,1449,639,810,cloudy,
2018,Spring,10:00:00 AM,1227,672,555,clear day,
2018,Spring,12:00:00 PM,961,465,496,clear day,
2018,Spring,04:00:00 AM,4,2,2,partly cloudy night,Easter Sunday
2018,Spring,08:00:00 PM,13,8,5,partly cloudy night,
2018,Spring,11:00:00 PM,35,11,24,clear night,Daylight Saving Time starts
2018,Spring,12:00:00 AM,2,1,1,clear night,
2018,Spring,07:00:00 PM,1205,650,555,partly cloudy day,
2018,Spring,06:00:00 AM,37,20,17,clear night,
2018,Spring,07:00:00 AM,153,72,81,clear day,
2018,Spring,08:00:00 AM,168,63,105,clear day,
2018,Spring,11:00:00 AM,1465,762,703,partly cloudy day,
2018,Winter,06:00:00 AM,22,14,8,partly cloudy night,
2018,Winter,09:00:00 AM,489,279,210,clear day,Presidents' Day (regional holiday)
2018,Spring,07:00:00 PM,1477,738,739,cloudy,
2018,Spring,03:00:00 AM,24,15,9,clear night,
2018,Spring,06:00:00 PM,2969,1373,1596,clear day,
2018,Spring,08:00:00 AM,260,135,125,partly cloudy day,
2018,Spring,02:00:00 AM,6,2,4,partly cloudy night,
2018,Spring,06:00:00 PM,971,535,436,partly cloudy day,
2018,Spring,04:00:00 PM,1718,745,973,clear day,
2018,Spring,07:00:00 PM,404,232,172,partly cloudy day,
2018,Spring,05:00:00 PM,1182,608,574,cloudy,
2018,Spring,09:00:00 AM,895,589,306,clear day,
2018,Summer,06:00:00 PM,1576,916,660,partly cloudy day,
2018,Spring,11:00:00 PM,83,56,27,clear night,
2018,Winter,10:00:00 PM,71,47,24,fog,Presidents' Day (regional holiday)
2018,Spring,04:00:00 PM,2251,1106,1145,clear day,
2018,Spring,01:00:00 AM,24,16,8,partly cloudy night,
2018,Spring,07:00:00 PM,1267,608,659,cloudy,
2018,Spring,03:00:00 PM,2125,1108,1017,clear day,
2018,Winter,05:00:00 AM,15,9,6,clear night,
2018,Spring,11:00:00 PM,117,60,57,partly cloudy night,
2018,Spring,04:00:00 AM,0,0,0,cloudy,
2018,Spring,05:00:00 AM,11,6,5,clear night,
2018,Summer,08:00:00 PM,1153,463,690,clear day,
2018,Spring,02:00:00 PM,1413,632,781,partly cloudy day,
2018,Spring,10:00:00 AM,1433,901,532,cloudy,
2018,Spring,04:00:00 AM,2,0,2,rain,
2018,Spring,05:00:00 AM,33,21,12,partly cloudy night,
2018,Winter,03:00:00 PM,1402,715,687,clear day,
2018,Winter,05:00:00 AM,7,5,2,partly cloudy night,
2018,Winter,02:00:00 PM,310,172,138,rain,
2018,Spring,04:00:00 PM,3277,1520,1757,cloudy,Memorial Day
2018,Spring,10:00:00 AM,460,300,160,partly cloudy day,
2018,Spring,09:00:00 PM,174,104,70,cloudy,
2018,Spring,03:00:00 AM,1,0,1,partly cloudy night,
2018,Spring,02:00:00 AM,0,0,0,,Daylight Saving Time starts
2018,Spring,04:00:00 AM,7,5,2,cloudy,Memorial Day
2018,Spring,03:00:00 PM,1441,632,809,partly cloudy day,
2018,Winter,08:00:00 AM,351,120,231,clear day,
2018,Spring,01:00:00 AM,96,88,8,clear night,
2018,Spring,02:00:00 AM,11,7,4,cloudy,
2018,Spring,03:00:00 PM,2147,990,1157,partly cloudy day,
2018,Spring,02:00:00 PM,1411,637,774,clear day,
2018,Spring,09:00:00 PM,219,86,133,partly cloudy night,
2018,Spring,12:00:00 PM,644,230,414,partly cloudy day,
2018,Summer,02:00:00 AM,4,2,2,rain,
2018,Spring,10:00:00 AM,1223,776,447,partly cloudy day,
2018,Spring,04:00:00 AM,7,4,3,partly cloudy night,
2018,Spring,08:00:00 AM,104,29,75,partly cloudy day,
2018,Spring,03:00:00 AM,4,1,3,clear night,
2018,Winter,10:00:00 PM,46,26,20,clear night,
2018,Winter,09:00:00 PM,52,28,24,clear night,
2018,Spring,08:00:00 PM,493,207,286,partly cloudy night,
2018,Spring,12:00:00 AM,58,8,50,partly cloudy night,
2018,Spring,10:00:00 AM,1626,979,647,clear day,
2018,Spring,09:00:00 AM,478,215,263,partly cloudy day,
2018,Spring,12:00:00 AM,61,22,39,clear night,Easter Sunday
2018,Spring,01:00:00 AM,13,7,6,partly cloudy night,Tax Day
2018,Winter,02:00:00 PM,533,260,273,partly cloudy day,
2018,Spring,07:00:00 AM,34,13,21,snow,
2018,Spring,07:00:00 PM,738,344,394,partly cloudy day,
2018,Spring,08:00:00 AM,316,125,191,partly cloudy day,
2018,Spring,04:00:00 PM,2408,1107,1301,partly cloudy day,
2018,Winter,11:00:00 PM,35,18,17,clear night,
2018,Spring,02:00:00 AM,22,11,11,clear night,
2018,Spring,10:00:00 AM,847,463,384,clear day,St. Patrick's Day
2018,Winter,10:00:00 PM,145,121,24,clear night,
2018,Spring,10:00:00 PM,186,66,120,partly cloudy night,
2018,Spring,07:00:00 AM,18,7,11,rain,
2018,Spring,04:00:00 AM,6,5,1,partly cloudy night,
2018,Spring,01:00:00 PM,1406,664,742,partly cloudy day,
2018,Spring,06:00:00 AM,55,31,24,clear night,
2018,Winter,09:00:00 PM,228,175,53,clear night,
2018,Spring,03:00:00 AM,2,1,1,partly cloudy night,
2018,Spring,02:00:00 PM,1940,872,1068,partly cloudy day,
2018,Spring,07:00:00 AM,126,45,81,fog,
2018,Spring,06:00:00 PM,654,380,274,clear day,
2018,Winter,09:00:00 AM,254,108,146,partly cloudy day,
2018,Spring,12:00:00 PM,1409,658,751,clear day,
2018,Spring,08:00:00 PM,1283,477,806,clear day,
2018,Summer,02:00:00 AM,11,6,5,cloudy,
2018,Winter,02:00:00 PM,2420,1312,1108,rain,
2018,Spring,12:00:00 PM,2187,1009,1178,clear day,
2018,Winter,09:00:00 AM,120,77,43,rain,
2018,Spring,09:00:00 AM,458,243,215,clear day,
2018,Summer,03:00:00 PM,2127,928,1199,cloudy,
2018,Spring,01:00:00 AM,34,6,28,clear night,
2018,Spring,07:00:00 PM,1520,888,632,clear day,
2018,Winter,01:00:00 PM,1059,439,620,clear day,Valentine's Day
2018,Spring,11:00:00 PM,218,123,95,partly cloudy night,Cinco de Mayo
2018,Spring,09:00:00 AM,577,279,298,partly cloudy day,
2018,Spring,10:00:00 AM,1894,1129,765,clear day,
2018,Winter,02:00:00 AM,10,5,5,clear night,
2018,Spring,10:00:00 PM,132,99,33,clear night,
2018,Winter,05:00:00 PM,468,253,215,cloudy,
2018,Spring,10:00:00 PM,520,251,269,partly cloudy night,
2018,Spring,04:00:00 PM,3321,1484,1837,clear day,
2018,Spring,07:00:00 AM,76,42,34,clear day,
2018,Winter,10:00:00 AM,120,50,70,snow,
2018,Summer,02:00:00 PM,2854,1382,1472,partly cloudy day,
2018,Winter,05:00:00 AM,1,0,1,partly cloudy night,
2018,Spring,07:00:00 PM,859,400,459,clear day,
2018,Spring,08:00:00 PM,321,159,162,partly cloudy night,
2018,Winter,07:00:00 AM,123,51,72,partly cloudy night,
2018,Spring,04:00:00 AM,10,6,4,clear night,
2018,Spring,03:00:00 AM,6,3,3,clear night,
2018,Summer,09:00:00 PM,393,113,280,partly cloudy night,
2018,Spring,01:00:00 PM,1738,758,980,clear day,
2018,Spring,02:00:00 PM,2457,1105,1352,clear day,
2018,Spring,09:00:00 PM,116,42,74,clear night,
2018,Winter,10:00:00 PM,97,94,3,partly cloudy night,
2018,Spring,09:00:00 AM,392,191,201,partly cloudy day,
2018,Spring,12:00:00 AM,30,21,9,clear night,
2018,Winter,06:00:00 AM,67,37,30,clear night,
2018,Summer,10:00:00 PM,489,264,225,partly cloudy night,
2018,Spring,09:00:00 AM,588,321,267,partly cloudy day,
2018,Spring,04:00:00 PM,2829,1091,1738,partly cloudy day,
2018,Spring,07:00:00 PM,861,399,462,cloudy,
2018,Spring,03:00:00 PM,2117,1010,1107,clear day,
2018,Winter,01:00:00 AM,7,4,3,partly cloudy night,Valentine's Day
2018,Spring,02:00:00 AM,11,8,3,clear night,
2018,Summer,11:00:00 PM,150,76,74,partly cloudy night,
2018,Spring,06:00:00 AM,219,104,115,clear day,
2018,Spring,12:00:00 AM,7,4,3,clear night,
2018,Winter,08:00:00 PM,116,65,51,partly cloudy night,
2018,Spring,01:00:00 PM,1492,629,863,clear day,
2018,Spring,01:00:00 AM,40,20,20,clear night,
2018,Spring,03:00:00 AM,14,7,7,clear night,
2018,Winter,01:00:00 PM,509,265,244,partly cloudy day,
2018,Winter,09:00:00 PM,97,47,50,partly cloudy night,
2018,Spring,02:00:00 AM,20,6,14,partly cloudy night,
2018,Spring,07:00:00 AM,145,60,85,clear day,
2018,Spring,01:00:00 PM,958,423,535,rain,
2018,Spring,09:00:00 AM,377,237,140,cloudy,
2018,Summer,11:00:00 AM,1786,887,899,cloudy,
2018,Spring,09:00:00 PM,110,88,22,partly cloudy night,
2018,Spring,11:00:00 AM,1384,679,705,partly cloudy day,Tax Day
2018,Spring,12:00:00 PM,1239,562,677,partly cloudy day,
2018,Spring,10:00:00 PM,86,50,36,clear night,
2018,Spring,06:00:00 PM,1676,967,709,clear day,
2018,Spring,12:00:00 PM,2924,1435,1489,clear day,
2018,Winter,12:00:00 PM,1326,625,701,partly cloudy day,
2018,Spring,11:00:00 AM,749,416,333,partly cloudy day,
2018,Spring,03:00:00 AM,12,8,4,clear night,
2018,Spring,04:00:00 PM,1182,543,639,clear day,
2018,Spring,06:00:00 AM,49,29,20,partly cloudy night,
2018,Summer,09:00:00 PM,887,280,607,clear night,
2018,Winter,12:00:00 PM,736,386,350,partly cloudy day,
2018,Spring,04:00:00 PM,449,244,205,cloudy,
2018,Spring,11:00:00 PM,78,41,37,cloudy,
2018,Spring,09:00:00 AM,244,115,129,clear day,
2018,Spring,06:00:00 AM,51,31,20,clear night,
2018,Summer,02:00:00 PM,1783,802,981,partly cloudy day,
2018,Spring,01:00:00 AM,64,36,28,clear night,
2018,Winter,10:00:00 AM,1037,674,363,clear day,
2018,Spring,10:00:00 PM,324,139,185,cloudy,
2018,Winter,05:00:00 PM,1753,924,829,clear day,
2018,Spring,04:00:00 AM,10,4,6,cloudy,
2018,Spring,11:00:00 AM,2470,1371,1099,clear day,
2018,Spring,03:00:00 AM,4,2,2,clear night,
2018,Spring,04:00:00 AM,13,5,8,clear night,
2018,Spring,05:00:00 AM,41,28,13,clear night,
2018,Spring,12:00:00 AM,16,10,6,partly cloudy night,
2018,Spring,03:00:00 PM,3491,1783,1708,partly cloudy day,Easter Sunday
2018,Winter,08:00:00 PM,263,195,68,partly cloudy night,
2018,Spring,11:00:00 PM,100,72,28,partly cloudy night,
2018,Winter,02:00:00 PM,1199,544,655,partly cloudy day,
2018,Summer,01:00:00 AM,21,8,13,clear night,
2018,Spring,03:00:00 AM,1,0,1,rain,
2018,Winter,06:00:00 AM,6,4,2,rain,
2018,Spring,09:00:00 AM,650,315,335,clear day,
2018,Spring,07:00:00 PM,430,223,207,clear night,Daylight Saving Time starts
2018,Spring,11:00:00 AM,1746,863,883,clear day,
2018,Spring,05:00:00 PM,2071,1021,1050,clear day,
2018,Spring,11:00:00 AM,1835,932,903,partly cloudy day,
2018,Winter,11:00:00 AM,906,427,479,partly cloudy day,
2018,Winter,11:00:00 PM,109,102,7,partly cloudy night,Valentine's Day
2018,Spring,05:00:00 AM,17,10,7,clear night,
2018,Summer,10:00:00 PM,262,148,114,cloudy,
2018,Spring,11:00:00 AM,2928,1489,1439,partly cloudy day,
2018,Winter,02:00:00 AM,9,7,2,partly cloudy night,
2018,Winter,11:00:00 AM,1517,801,716,partly cloudy day,
2018,Spring,12:00:00 AM,125,98,27,partly cloudy night,
2018,Spring,02:00:00 AM,1,0,1,clear night,
2018,Spring,12:00:00 PM,2493,1283,1210,clear day,
2018,Spring,04:00:00 PM,477,252,225,partly cloudy day,
2018,Spring,01:00:00 PM,1310,618,692,clear day,
2018,Winter,01:00:00 PM,1609,743,866,cloudy,Presidents' Day (regional holiday)
2018,Winter,11:00:00 PM,104,64,40,partly cloudy night,
2018,Spring,11:00:00 PM,162,89,73,clear night,
2018,Spring,10:00:00 PM,6,4,2,partly cloudy night,
2018,Spring,09:00:00 PM,642,170,472,clear night,
2018,Spring,07:00:00 PM,308,182,126,partly cloudy day,
2018,Spring,05:00:00 PM,1018,538,480,cloudy,
2018,Spring,12:00:00 PM,1143,483,660,cloudy,
2018,Spring,03:00:00 PM,2119,993,1126,cloudy,
2018,Winter,01:00:00 PM,1104,470,634,partly cloudy day,
2018,Spring,10:00:00 PM,167,111,56,partly cloudy night,
2018,Winter,06:00:00 PM,198,137,61,cloudy,Presidents' Day (regional holiday)
2018,Spring,08:00:00 AM,250,135,115,cloudy,Mother's Day
2018,Spring,07:00:00 AM,103,54,49,clear night,St. Patrick's Day
2018,Spring,06:00:00 PM,1032,560,472,cloudy,
2018,Spring,08:00:00 AM,288,120,168,clear day,
2018,Spring,12:00:00 PM,2077,956,1121,partly cloudy day,
2018,Spring,10:00:00 AM,1379,831,548,clear day,
2018,Spring,08:00:00 PM,129,98,31,partly cloudy night,
2018,Spring,06:00:00 AM,72,36,36,clear night,Daylight Saving Time starts
2018,Spring,02:00:00 AM,8,5,3,partly cloudy night,
2018,Spring,06:00:00 PM,703,390,313,partly cloudy day,
2018,Winter,01:00:00 AM,10,4,6,partly cloudy night,
2018,Spring,03:00:00 AM,3,1,2,rain,
2018,Spring,01:00:00 PM,2962,1320,1642,partly cloudy day,
2018,Spring,10:00:00 PM,163,99,64,clear night,St. Patrick's Day
2018,Spring,11:00:00 PM,30,14,16,partly cloudy night,
2018,Summer,01:00:00 PM,1959,956,1003,partly cloudy day,
2018,Winter,04:00:00 AM,1,0,1,rain,
2018,Spring,08:00:00 PM,712,267,445,clear night,
2018,Spring,07:00:00 PM,1579,865,714,clear day,
2018,Spring,06:00:00 PM,1396,575,821,partly cloudy day,
2018,Winter,02:00:00 PM,1804,883,921,clear day,
2018,Spring,04:00:00 PM,1151,539,612,cloudy,
2018,Spring,04:00:00 PM,2451,1186,1265,clear day,
2018,Spring,02:00:00 PM,1759,844,915,partly cloudy day,
2018,Spring,09:00:00 AM,797,425,372,clear day,
2018,Spring,10:00:00 AM,1337,736,601,partly cloudy day,
2018,Winter,05:00:00 PM,457,255,202,partly cloudy day,
2018,Spring,03:00:00 AM,15,6,9,clear night,
2018,Summer,02:00:00 AM,18,10,8,rain,
2018,Spring,02:00:00 AM,8,5,3,clear night,
2018,Summer,06:00:00 AM,41,21,20,rain,
2018,Spring,04:00:00 PM,1809,772,1037,clear day,
2018,Winter,02:00:00 PM,80,46,34,rain,
2018,Spring,11:00:00 AM,1480,746,734,clear day,
2018,Spring,01:00:00 AM,6,4,2,partly cloudy night,
2018,Spring,02:00:00 PM,539,275,264,partly cloudy day,
2018,Spring,09:00:00 PM,100,48,52,clear night,
2018,Spring,07:00:00 AM,227,95,132,clear day,
2018,Spring,03:00:00 PM,41,28,13,rain,
2018,Winter,06:00:00 AM,48,28,20,partly cloudy night,Valentine's Day
2018,Spring,08:00:00 AM,111,47,64,partly cloudy day,
2018,Spring,12:00:00 PM,539,224,315,rain,
2018,Winter,06:00:00 AM,41,28,13,clear night,
2018,Spring,09:00:00 PM,238,164,74,clear night,
2018,Spring,03:00:00 AM,1,0,1,partly cloudy night,
2018,Spring,03:00:00 PM,1778,755,1023,clear day,
2018,Spring,04:00:00 AM,9,2,7,clear night,
2018,Spring,09:00:00 PM,414,183,231,clear night,
2018,Spring,05:00:00 PM,133,82,51,snow,
2018,Summer,01:00:00 PM,1984,873,1111,clear day,
2018,Spring,11:00:00 AM,2245,1061,1184,clear day,
2018,Winter,10:00:00 PM,48,31,17,cloudy,
2018,Spring,04:00:00 PM,1635,714,921,partly cloudy day,
2018,Winter,01:00:00 PM,1054,447,607,partly cloudy day,
2018,Spring,03:00:00 PM,2190,1063,1127,clear day,
2018,Spring,01:00:00 AM,7,3,4,cloudy,
2018,Spring,07:00:00 AM,124,55,69,partly cloudy day,
2018,Spring,08:00:00 PM,908,372,536,clear day,
2018,Summer,04:00:00 AM,17,11,6,clear night,
2018,Spring,03:00:00 AM,1,0,1,cloudy,
2018,Spring,01:00:00 PM,853,356,497,cloudy,
2018,Winter,01:00:00 PM,1743,836,907,clear day,
2018,Spring,03:00:00 PM,1555,776,779,partly cloudy day,
2018,Spring,02:00:00 AM,32,9,23,partly cloudy night,Cinco de Mayo
2018,Winter,06:00:00 PM,542,338,204,partly cloudy night,
2018,Spring,08:00:00 AM,41,13,28,snow,
2018,Winter,02:00:00 PM,927,483,444,partly cloudy day,
2018,Spring,01:00:00 PM,1648,775,873,partly cloudy day,
2018,Spring,11:00:00 AM,2013,1134,879,partly cloudy day,
2018,Spring,03:00:00 PM,1944,980,964,clear day,
2018,Summer,02:00:00 AM,12,6,6,clear night,
2018,Spring,11:00:00 AM,1669,869,800,clear day,
2018,Winter,04:00:00 AM,8,7,1,cloudy,
2018,Spring,02:00:00 AM,9,3,6,partly cloudy night,
2018,Spring,05:00:00 AM,3,2,1,clear night,
2018,Summer,04:00:00 PM,2128,1053,1075,partly cloudy day,
2018,Spring,07:00:00 AM,273,116,157,clear day,
2018,Spring,12:00:00 AM,121,56,65,clear night,
2018,Spring,06:00:00 PM,1622,741,881,partly cloudy day,
2018,Winter,09:00:00 PM,98,53,45,clear night,
2018,Spring,04:00:00 PM,1484,718,766,clear day,
2018,Spring,03:00:00 PM,1832,855,977,partly cloudy day,
2018,Winter,04:00:00 AM,5,2,3,partly cloudy night,
2018,Spring,02:00:00 PM,854,517,337,partly cloudy day,
2018,Spring,12:00:00 AM,62,30,32,clear night,
2018,Winter,09:00:00 PM,134,96,38,partly cloudy night,
2018,Spring,02:00:00 AM,1,0,1,clear night,
2018,Summer,09:00:00 PM,666,254,412,clear night,
2018,Summer,02:00:00 PM,2127,1020,1107,partly cloudy day,
2018,Winter,02:00:00 AM,5,2,3,clear night,
2018,Spring,05:00:00 PM,1355,671,684,clear day,
2018,Spring,01:00:00 AM,3,0,3,clear night,
2018,Spring,06:00:00 PM,1007,446,561,partly cloudy day,
2018,Spring,07:00:00 PM,811,394,417,partly cloudy day,
2018,Winter,02:00:00 AM,11,6,5,partly cloudy night,
2018,Spring,10:00:00 AM,757,381,376,clear day,
2018,Spring,05:00:00 PM,716,176,540,clear day,
2018,Spring,07:00:00 PM,1606,575,1031,clear day,Cinco de Mayo
2018,Spring,10:00:00 AM,674,328,346,partly cloudy day,
2018,Winter,04:00:00 AM,5,3,2,clear night,
2018,Winter,12:00:00 AM,27,10,17,clear night,
2018,Winter,01:00:00 AM,5,3,2,cloudy,
2018,Winter,03:00:00 AM,1,0,1,partly cloudy night,
2018,Spring,07:00:00 AM,183,90,93,partly cloudy day,
2018,Spring,10:00:00 PM,163,65,98,partly cloudy night,
2018,Spring,05:00:00 PM,1372,719,653,clear day,
2018,Winter,03:00:00 PM,1344,607,737,clear day,
2018,Spring,07:00:00 PM,1670,946,724,clear day,
2018,Summer,07:00:00 AM,184,80,104,clear day,
2018,Summer,05:00:00 AM,63,35,28,clear night,
2018,Spring,08:00:00 AM,433,228,205,partly cloudy day,
2018,Spring,05:00:00 AM,30,12,18,clear night,
2018,Spring,03:00:00 AM,12,7,5,partly cloudy night,
2018,Spring,04:00:00 PM,1975,963,1012,clear day,
2018,Summer,03:00:00 AM,8,5,3,clear night,
2018,Winter,08:00:00 PM,37,16,21,snow,
2018,Spring,08:00:00 PM,588,268,320,partly cloudy night,
2018,Spring,07:00:00 PM,67,24,43,snow,
2018,Spring,09:00:00 PM,339,212,127,clear night,
2018,Summer,07:00:00 PM,1051,577,474,cloudy,
2018,Spring,08:00:00 PM,693,265,428,partly cloudy night,
2018,Winter,05:00:00 AM,7,4,3,clear night,
2018,Summer,12:00:00 PM,1737,959,778,partly cloudy day,
2018,Spring,07:00:00 AM,183,74,109,clear day,
2018,Winter,06:00:00 PM,659,370,289,partly cloudy night,Valentine's Day
2018,Winter,09:00:00 PM,59,42,17,cloudy,
2018,Winter,07:00:00 AM,109,44,65,partly cloudy night,
2018,Spring,09:00:00 AM,354,166,188,clear day,
2018,Winter,09:00:00 AM,334,140,194,partly cloudy day,
2018,Winter,01:00:00 PM,93,28,65,rain,
2018,Winter,09:00:00 PM,195,108,87,clear night,
2018,Winter,10:00:00 PM,134,97,37,clear night,
2018,Winter,09:00:00 AM,417,182,235,clear day,
2018,Spring,07:00:00 AM,145,54,91,clear night,
2018,Winter,08:00:00 AM,177,62,115,cloudy,
2018,Summer,07:00:00 AM,302,113,189,partly cloudy day,
2018,Spring,09:00:00 PM,425,166,259,partly cloudy night,
2018,Spring,07:00:00 AM,123,57,66,partly cloudy day,
2018,Spring,02:00:00 AM,18,13,5,cloudy,
2018,Winter,07:00:00 AM,69,33,36,partly cloudy day,
2018,Winter,02:00:00 AM,4,2,2,clear night,
2018,Spring,12:00:00 PM,166,99,67,rain,
2018,Spring,07:00:00 AM,246,105,141,partly cloudy day,
2018,Spring,11:00:00 PM,83,42,41,clear night,
2018,Spring,02:00:00 PM,1643,733,910,partly cloudy day,
2018,Winter,07:00:00 PM,398,265,133,clear night,
2018,Spring,02:00:00 AM,5,4,1,partly cloudy night,
2018,Spring,07:00:00 AM,270,118,152,clear day,
2018,Spring,02:00:00 PM,1578,711,867,clear day,
2018,Winter,02:00:00 PM,962,486,476,clear day,
2018,Spring,11:00:00 AM,3420,1828,1592,clear day,
2018,Winter,10:00:00 AM,716,374,342,clear day,
2018,Spring,12:00:00 AM,22,10,12,clear night,
2018,Spring,01:00:00 PM,2409,1075,1334,cloudy,
2018,Spring,05:00:00 AM,19,11,8,cloudy,
2018,Spring,02:00:00 AM,11,4,7,partly cloudy night,
2018,Spring,06:00:00 PM,459,193,266,partly cloudy night,
2018,Spring,07:00:00 AM,279,156,123,clear day,
2018,Spring,07:00:00 PM,423,199,224,cloudy,
2018,Spring,07:00:00 PM,1777,669,1108,clear day,Easter Sunday
2018,Winter,10:00:00 PM,138,66,72,clear night,
2018,Spring,08:00:00 AM,609,220,389,clear day,
2018,Spring,07:00:00 AM,101,45,56,cloudy,
2018,Spring,08:00:00 PM,173,97,76,fog,
2018,Spring,05:00:00 AM,32,14,18,partly cloudy night,Tax Day
2018,Spring,06:00:00 AM,200,88,112,clear day,
2018,Spring,08:00:00 AM,294,120,174,clear day,
2018,Spring,02:00:00 AM,19,14,5,clear night,
2018,Winter,05:00:00 AM,8,4,4,partly cloudy night,Valentine's Day
2018,Winter,07:00:00 AM,178,59,119,fog,
2018,Spring,04:00:00 PM,2686,505,2181,clear day,
2018,Winter,07:00:00 AM,196,90,106,clear day,
2018,Spring,01:00:00 AM,18,11,7,clear night,
2018,Spring,05:00:00 PM,2446,1226,1220,clear day,
2018,Spring,04:00:00 AM,8,0,8,rain,
2018,Summer,07:00:00 AM,262,109,153,clear day,
2018,Spring,02:00:00 AM,31,21,10,clear night,
2018,Winter,07:00:00 AM,103,36,67,clear night,
2018,Spring,08:00:00 PM,1025,425,600,partly cloudy night,
2018,Spring,12:00:00 PM,130,62,68,snow,
2018,Spring,09:00:00 AM,527,249,278,partly cloudy day,
2018,Spring,01:00:00 AM,13,6,7,cloudy,
2018,Spring,06:00:00 AM,169,77,92,clear day,
2018,Summer,07:00:00 AM,124,55,69,cloudy,
2018,Spring,09:00:00 PM,1060,336,724,clear night,
2018,Spring,05:00:00 PM,802,419,383,partly cloudy day,
2018,Summer,02:00:00 AM,12,8,4,partly cloudy night,
2018,Spring,07:00:00 PM,321,185,136,partly cloudy night,
2018,Spring,09:00:00 PM,311,139,172,clear night,
2018,Spring,07:00:00 AM,232,102,130,fog,
2018,Spring,10:00:00 PM,289,114,175,clear night,
2018,Spring,02:00:00 PM,1071,516,555,cloudy,
2018,Spring,09:00:00 AM,656,442,214,partly cloudy day,
2018,Spring,05:00:00 AM,19,13,6,clear night,
2018,Spring,04:00:00 PM,717,370,347,partly cloudy day,
2018,Spring,03:00:00 AM,1,0,1,partly cloudy night,
2018,Spring,07:00:00 AM,93,51,42,clear day,
2018,Summer,02:00:00 PM,2270,1009,1261,clear day,
2018,Spring,02:00:00 AM,2,0,2,cloudy,
2018,Spring,12:00:00 PM,1548,737,811,partly cloudy day,
2018,Spring,03:00:00 AM,8,5,3,partly cloudy night,
2018,Spring,06:00:00 PM,1836,944,892,partly cloudy day,
2018,Spring,10:00:00 AM,416,253,163,rain,
2018,Spring,10:00:00 PM,468,221,247,clear night,
2018,Winter,11:00:00 PM,85,36,49,clear night,
2018,Spring,06:00:00 PM,2464,1147,1317,cloudy,Memorial Day
2018,Spring,09:00:00 AM,659,384,275,partly cloudy day,
2018,Spring,10:00:00 AM,848,458,390,partly cloudy day,
2018,Spring,08:00:00 PM,86,62,24,cloudy,
2018,Spring,05:00:00 AM,7,4,3,cloudy,
2018,Spring,08:00:00 PM,290,157,133,partly cloudy night,Tax Day
2018,Spring,11:00:00 PM,67,53,14,partly cloudy night,
2018,Spring,10:00:00 PM,75,45,30,clear night,
2018,Spring,12:00:00 AM,11,8,3,cloudy,
2018,Spring,07:00:00 AM,136,62,74,clear night,
2018,Spring,03:00:00 AM,0,0,0,partly cloudy night,
2018,Spring,12:00:00 PM,1008,582,426,rain,
2018,Spring,10:00:00 AM,1424,833,591,clear day,
2018,Spring,05:00:00 AM,15,6,9,cloudy,
2018,Spring,10:00:00 PM,396,152,244,clear night,
2018,Spring,10:00:00 AM,1270,659,611,clear day,Daylight Saving Time starts
2018,Spring,12:00:00 AM,26,16,10,clear night,
2018,Spring,05:00:00 PM,477,278,199,rain,
2018,Summer,10:00:00 PM,428,196,232,clear night,
2018,Spring,06:00:00 PM,1727,982,745,clear day,
2018,Spring,02:00:00 PM,1365,654,711,clear day,
2018,Spring,11:00:00 AM,1007,501,506,partly cloudy day,
2018,Spring,11:00:00 AM,653,297,356,clear day,
2018,Spring,05:00:00 PM,1236,627,609,partly cloudy day,
2018,Spring,10:00:00 PM,295,106,189,clear night,
2018,Spring,08:00:00 AM,272,96,176,clear day,
2018,Spring,05:00:00 AM,65,37,28,clear night,
2018,Spring,12:00:00 PM,823,450,373,snow,
2018,Spring,09:00:00 PM,180,79,101,partly cloudy night,
2018,Spring,10:00:00 PM,87,59,28,rain,
2018,Spring,08:00:00 AM,284,75,209,partly cloudy day,
2018,Winter,03:00:00 PM,1876,821,1055,cloudy,
2018,Winter,09:00:00 PM,210,158,52,partly cloudy night,
2018,Spring,08:00:00 PM,360,209,151,partly cloudy night,
2018,Spring,11:00:00 PM,11,6,5,partly cloudy night,
2018,Winter,02:00:00 PM,1559,717,842,cloudy,Presidents' Day (regional holiday)
2018,Spring,11:00:00 AM,1264,666,598,clear day,
2018,Spring,11:00:00 PM,43,11,32,partly cloudy night,
2018,Winter,05:00:00 AM,20,11,9,clear night,
2018,Spring,09:00:00 PM,18,12,6,rain,
2018,Spring,10:00:00 PM,364,141,223,clear night,
2018,Winter,03:00:00 PM,903,426,477,partly cloudy day,
2018,Spring,06:00:00 PM,1140,603,537,partly cloudy day,
2018,Spring,11:00:00 PM,13,11,2,rain,
2018,Spring,12:00:00 PM,2854,1574,1280,clear day,Cinco de Mayo
2018,Winter,05:00:00 PM,301,172,129,partly cloudy day,
2018,Summer,11:00:00 PM,75,24,51,partly cloudy night,
2018,Spring,03:00:00 PM,1947,822,1125,partly cloudy day,
2018,Spring,12:00:00 AM,53,26,27,cloudy,
2018,Spring,05:00:00 AM,25,17,8,partly cloudy night,Daylight Saving Time starts
2018,Winter,10:00:00 AM,644,348,296,clear day,
2018,Spring,11:00:00 AM,1021,439,582,cloudy,
2018,Winter,09:00:00 AM,456,200,256,cloudy,
2018,Spring,12:00:00 AM,70,40,30,clear night,
2018,Winter,10:00:00 AM,1037,582,455,clear day,
2018,Winter,11:00:00 PM,31,25,6,partly cloudy night,
2018,Summer,06:00:00 PM,1709,950,759,partly cloudy day,
2018,Winter,05:00:00 PM,187,99,88,rain,
2018,Winter,01:00:00 AM,2,0,2,clear night,
2018,Winter,12:00:00 AM,33,19,14,cloudy,
2018,Spring,10:00:00 PM,49,24,25,clear night,
2018,Spring,07:00:00 AM,75,36,39,partly cloudy day,
2018,Summer,10:00:00 AM,966,554,412,cloudy,
2018,Spring,03:00:00 PM,2032,928,1104,clear day,
2018,Winter,10:00:00 PM,151,124,27,partly cloudy night,
2018,Spring,01:00:00 AM,31,15,16,clear night,
2018,Winter,12:00:00 PM,1097,556,541,clear day,
2018,Spring,09:00:00 PM,112,69,43,clear night,
2018,Winter,10:00:00 PM,44,22,22,clear night,
2018,Spring,12:00:00 PM,1966,958,1008,clear day,
2018,Spring,03:00:00 PM,3390,1490,1900,clear day,Cinco de Mayo
2018,Spring,03:00:00 AM,6,2,4,clear night,
2018,Winter,06:00:00 PM,205,151,54,partly cloudy night,
2018,Spring,05:00:00 PM,664,288,376,partly cloudy day,
2018,Winter,10:00:00 PM,50,32,18,cloudy,
2018,Summer,11:00:00 AM,2084,1239,845,clear day,
2018,Spring,12:00:00 AM,139,118,21,clear night,Daylight Saving Time starts
2018,Spring,09:00:00 PM,673,289,384,partly cloudy night,
2018,Summer,11:00:00 AM,1658,929,729,partly cloudy day,
2018,Spring,03:00:00 PM,518,220,298,rain,
2018,Spring,10:00:00 AM,203,99,104,partly cloudy day,
2018,Spring,09:00:00 AM,991,534,457,clear day,
2018,Spring,09:00:00 PM,202,100,102,clear night,
2018,Winter,10:00:00 AM,426,254,172,partly cloudy day,
2018,Spring,03:00:00 PM,1865,844,1021,partly cloudy day,
2018,Spring,12:00:00 AM,34,14,20,partly cloudy night,
2018,Spring,12:00:00 PM,1805,772,1033,partly cloudy day,
2018,Spring,01:00:00 AM,11,5,6,clear night,
2018,Summer,07:00:00 AM,288,96,192,clear day,
2018,Winter,09:00:00 PM,159,136,23,clear night,
2018,Spring,08:00:00 AM,312,148,164,clear day,
2018,Spring,05:00:00 AM,6,4,2,partly cloudy night,
2018,Winter,12:00:00 PM,2127,1012,1115,partly cloudy day,
2018,Spring,10:00:00 PM,344,131,213,clear night,
2018,Spring,05:00:00 PM,2290,1075,1215,cloudy,
2018,Spring,07:00:00 PM,1613,817,796,clear day,
2018,Winter,02:00:00 PM,1032,490,542,partly cloudy day,Valentine's Day
2018,Spring,08:00:00 AM,188,69,119,clear day,
2018,Spring,11:00:00 PM,139,57,82,partly cloudy night,
2018,Winter,03:00:00 PM,1092,525,567,clear day,
2018,Winter,05:00:00 AM,2,1,1,rain,
2018,Summer,06:00:00 PM,1817,1078,739,partly cloudy day,
2018,Spring,01:00:00 AM,13,4,9,clear night,
2018,Winter,01:00:00 PM,1110,546,564,partly cloudy day,
2018,Spring,02:00:00 PM,2887,1271,1616,clear day,
2018,Spring,07:00:00 PM,765,359,406,clear day,
2018,Winter,06:00:00 AM,55,27,28,clear night,
2018,Winter,02:00:00 AM,5,3,2,fog,
2018,Spring,10:00:00 PM,69,30,39,clear night,
2018,Spring,01:00:00 PM,2282,1047,1235,clear day,
2018,Winter,06:00:00 PM,95,92,3,rain,
2018,Spring,07:00:00 AM,34,18,16,rain,
2018,Spring,01:00:00 AM,0,0,0,rain,
2018,Spring,02:00:00 AM,0,0,0,partly cloudy night,
2018,Spring,10:00:00 AM,593,387,206,partly cloudy day,
2018,Spring,06:00:00 AM,29,16,13,cloudy,
2018,Spring,01:00:00 AM,21,14,7,partly cloudy night,
2018,Spring,10:00:00 PM,122,63,59,cloudy,
2018,Spring,04:00:00 PM,796,436,360,partly cloudy day,
2018,Spring,01:00:00 PM,1328,617,711,clear day,
2018,Spring,12:00:00 AM,218,80,138,clear night,
2018,Spring,08:00:00 PM,286,144,142,partly cloudy night,
2018,Spring,05:00:00 AM,15,10,5,cloudy,Mother's Day
2018,Summer,07:00:00 PM,1810,801,1009,partly cloudy day,
2018,Winter,04:00:00 AM,2,0,2,partly cloudy night,
2018,Summer,01:00:00 PM,2722,1005,1717,clear day,
2018,Winter,02:00:00 AM,2,1,1,clear night,
2018,Winter,06:00:00 PM,969,373,596,clear night,
2018,Spring,03:00:00 AM,1,0,1,clear night,
2018,Summer,05:00:00 PM,1799,975,824,partly cloudy day,
2018,Spring,08:00:00 AM,227,87,140,partly cloudy day,
2018,Spring,05:00:00 PM,1529,732,797,clear day,
2018,Spring,01:00:00 AM,25,10,15,clear night,
2018,Spring,06:00:00 PM,840,339,501,partly cloudy night,
2018,Spring,08:00:00 AM,16,6,10,rain,
2018,Spring,06:00:00 PM,1533,668,865,partly cloudy day,
2018,Spring,05:00:00 AM,65,43,22,clear night,
2018,Spring,08:00:00 PM,1005,369,636,clear night,
2018,Spring,05:00:00 PM,2276,1226,1050,clear day,
2018,Spring,08:00:00 AM,276,90,186,clear day,
2018,Spring,05:00:00 PM,2225,1064,1161,partly cloudy day,
2018,Spring,06:00:00 PM,2061,1157,904,clear day,
2018,Winter,07:00:00 PM,401,255,146,clear night,
2018,Spring,03:00:00 PM,2232,1136,1096,clear day,Daylight Saving Time starts
2018,Spring,02:00:00 AM,1,0,1,clear night,
2018,Spring,08:00:00 PM,697,330,367,partly cloudy night,
2018,Spring,08:00:00 AM,163,85,78,partly cloudy day,
2018,Winter,06:00:00 AM,37,27,10,partly cloudy night,
2018,Spring,01:00:00 PM,2910,1396,1514,clear day,
2018,Spring,12:00:00 PM,2156,866,1290,clear day,
2018,Spring,10:00:00 PM,234,118,116,partly cloudy night,
2018,Winter,02:00:00 PM,773,431,342,partly cloudy day,
2018,Spring,11:00:00 AM,1559,743,816,clear day,
2018,Spring,01:00:00 AM,31,21,10,cloudy,
2018,Spring,12:00:00 AM,5,1,4,snow,
2018,Spring,08:00:00 PM,261,109,152,clear night,
2018,Spring,12:00:00 AM,98,69,29,,Mother's Day
2018,Spring,06:00:00 AM,197,81,116,clear day,
2018,Spring,02:00:00 PM,1031,495,536,rain,
2018,Summer,05:00:00 AM,38,23,15,partly cloudy night,
2018,Summer,03:00:00 AM,4,0,4,clear night,
2018,Spring,06:00:00 PM,989,468,521,partly cloudy day,Mother's Day
2018,Spring,11:00:00 AM,1301,639,662,partly cloudy day,
2018,Spring,08:00:00 PM,405,156,249,clear night,
2018,Spring,04:00:00 AM,12,5,7,clear night,
2018,Spring,04:00:00 PM,1546,843,703,partly cloudy day,
2018,Spring,04:00:00 AM,3,0,3,clear night,
2018,Spring,05:00:00 PM,1114,563,551,partly cloudy day,Mother's Day
2018,Spring,10:00:00 AM,761,389,372,cloudy,
2018,Winter,12:00:00 AM,7,0,7,clear night,
2018,Spring,01:00:00 AM,20,12,8,partly cloudy night,
2018,Spring,09:00:00 PM,232,85,147,cloudy,
2018,Spring,10:00:00 AM,1190,710,480,partly cloudy day,
2018,Spring,06:00:00 AM,168,78,90,cloudy,
2018,Spring,03:00:00 AM,30,18,12,clear night,
2018,Spring,01:00:00 AM,4,0,4,cloudy,
2018,Spring,09:00:00 PM,528,179,349,clear night,
2018,Spring,01:00:00 AM,34,10,24,partly cloudy night,
2018,Spring,08:00:00 PM,483,215,268,partly cloudy night,
2018,Spring,03:00:00 PM,1527,726,801,clear day,
2018,Winter,01:00:00 AM,9,7,2,partly cloudy night,
2018,Summer,10:00:00 AM,1182,611,571,clear day,
2018,Spring,01:00:00 PM,1781,823,958,partly cloudy day,
2018,Spring,03:00:00 PM,376,197,179,fog,
2018,Spring,03:00:00 AM,5,0,5,clear night,
2018,Winter,01:00:00 PM,2215,1132,1083,rain,
2018,Spring,02:00:00 PM,1501,664,837,partly cloudy day,
2018,Spring,03:00:00 PM,2300,1028,1272,clear day,St. Patrick's Day
2018,Spring,10:00:00 AM,621,260,361,partly cloudy day,
2018,Spring,05:00:00 AM,13,6,7,clear night,
2018,Spring,02:00:00 PM,2888,1426,1462,clear day,
2018,Winter,10:00:00 PM,71,35,36,clear night,
2018,Winter,09:00:00 AM,341,170,171,partly cloudy day,Valentine's Day
2018,Spring,03:00:00 AM,0,0,0,clear night,
2018,Spring,11:00:00 AM,1289,673,616,cloudy,
2018,Spring,05:00:00 PM,1674,791,883,partly cloudy day,
2018,Spring,02:00:00 PM,1783,866,917,clear day,
2018,Spring,07:00:00 AM,25,13,12,snow,
2018,Spring,05:00:00 PM,2501,1245,1256,clear day,
2018,Winter,04:00:00 PM,1584,830,754,clear day,
2018,Spring,09:00:00 AM,516,221,295,partly cloudy day,
2018,Spring,11:00:00 PM,6,1,5,partly cloudy night,
2018,Spring,09:00:00 PM,767,373,394,partly cloudy night,
2018,Spring,03:00:00 AM,11,8,3,partly cloudy night,
2018,Spring,02:00:00 AM,4,2,2,clear night,
2018,Spring,10:00:00 AM,601,377,224,partly cloudy day,
2018,Spring,03:00:00 AM,7,2,5,fog,
2018,Spring,11:00:00 AM,1247,639,608,partly cloudy day,
2018,Spring,06:00:00 AM,43,23,20,partly cloudy night,
2018,Spring,04:00:00 PM,3638,1484,2154,clear day,
2018,Spring,11:00:00 AM,315,153,162,partly cloudy day,
2018,Spring,10:00:00 PM,342,168,174,partly cloudy night,Cinco de Mayo
2018,Summer,09:00:00 AM,817,447,370,partly cloudy day,
2018,Spring,04:00:00 PM,2625,1209,1416,clear day,
2018,Spring,04:00:00 AM,8,6,2,clear night,
2018,Spring,11:00:00 AM,956,396,560,partly cloudy day,
2018,Spring,08:00:00 PM,1559,595,964,partly cloudy day,
2018,Spring,01:00:00 PM,1713,803,910,clear day,
2018,Spring,11:00:00 PM,150,117,33,cloudy,
2018,Spring,04:00:00 AM,3,1,2,clear night,
2018,Spring,09:00:00 PM,139,92,47,clear night,
2018,Spring,12:00:00 PM,1188,687,501,partly cloudy day,
2018,Summer,07:00:00 PM,1399,756,643,clear day,
2018,Summer,03:00:00 PM,3062,1495,1567,clear day,
2018,Winter,06:00:00 AM,23,20,3,clear night,
2018,Spring,02:00:00 AM,13,7,6,partly cloudy night,
2018,Spring,03:00:00 AM,7,6,1,partly cloudy night,
2018,Spring,01:00:00 PM,1492,689,803,partly cloudy day,
2018,Summer,06:00:00 PM,1548,836,712,clear day,
2018,Spring,11:00:00 PM,51,16,35,partly cloudy night,
2018,Spring,07:00:00 PM,935,437,498,clear day,
2018,Spring,10:00:00 AM,648,378,270,clear day,
2018,Spring,10:00:00 AM,629,396,233,partly cloudy day,
2018,Spring,10:00:00 PM,354,159,195,cloudy,
2018,Spring,05:00:00 AM,11,8,3,clear night,
2018,Winter,01:00:00 PM,232,114,118,rain,
2018,Spring,04:00:00 PM,39,26,13,rain,
2018,Summer,04:00:00 PM,1578,785,793,cloudy,
2018,Summer,10:00:00 AM,1232,733,499,partly cloudy day,
2018,Spring,09:00:00 AM,850,480,370,partly cloudy day,Easter Sunday
2018,Spring,08:00:00 AM,334,118,216,partly cloudy day,
2018,Spring,08:00:00 AM,234,87,147,partly cloudy day,
2018,Summer,10:00:00 PM,400,151,249,partly cloudy night,
2018,Spring,06:00:00 PM,850,474,376,partly cloudy day,
2018,Spring,10:00:00 AM,1354,828,526,rain,
2018,Spring,09:00:00 AM,30,11,19,fog,
2018,Spring,08:00:00 AM,209,80,129,clear day,
2018,Spring,10:00:00 PM,300,89,211,cloudy,Memorial Day
2018,Spring,03:00:00 AM,1,1,0,partly cloudy night,
2018,Spring,04:00:00 AM,4,2,2,partly cloudy night,
2018,Spring,09:00:00 AM,653,342,311,clear day,
2018,Spring,06:00:00 AM,29,14,15,partly cloudy night,
2018,Spring,09:00:00 PM,233,101,132,clear night,St. Patrick's Day
2018,Winter,08:00:00 PM,407,240,167,partly cloudy night,
2018,Spring,05:00:00 AM,38,26,12,cloudy,Memorial Day
2018,Spring,11:00:00 AM,1609,833,776,clear day,
2018,Winter,10:00:00 AM,671,313,358,clear day,
2018,Spring,04:00:00 AM,6,2,4,partly cloudy night,
2018,Spring,07:00:00 AM,125,71,54,partly cloudy day,Memorial Day
2018,Spring,10:00:00 AM,1742,1041,701,clear day,
2018,Spring,05:00:00 PM,1175,629,546,clear day,
2018,Winter,09:00:00 PM,80,40,40,clear night,
2018,Spring,02:00:00 PM,2978,1281,1697,partly cloudy day,
2018,Spring,05:00:00 PM,604,258,346,cloudy,
2018,Spring,05:00:00 AM,18,11,7,partly cloudy night,
2018,Spring,11:00:00 PM,56,14,42,clear night,
2018,Winter,05:00:00 AM,18,11,7,cloudy,
2018,Spring,07:00:00 AM,232,93,139,clear day,
2018,Spring,03:00:00 PM,1780,829,951,clear day,
2018,Spring,04:00:00 PM,2459,1166,1293,clear day,
2018,Winter,06:00:00 AM,51,26,25,clear night,
2018,Spring,11:00:00 AM,1831,1021,810,clear day,
2018,Spring,01:00:00 PM,1892,798,1094,clear day,
2018,Spring,04:00:00 PM,1452,653,799,partly cloudy day,Tax Day
2018,Winter,09:00:00 PM,70,48,22,partly cloudy night,Presidents' Day (regional holiday)
2018,Summer,03:00:00 AM,1,0,1,rain,
2018,Spring,06:00:00 PM,2247,1249,998,clear day,
2018,Winter,02:00:00 AM,10,8,2,partly cloudy night,
2018,Spring,06:00:00 PM,548,344,204,partly cloudy night,
2018,Winter,10:00:00 PM,109,105,4,rain,
2018,Spring,06:00:00 AM,10,3,7,sleet,
2018,Spring,11:00:00 AM,58,28,30,rain,
2018,Spring,04:00:00 AM,1,0,1,partly cloudy night,
2018,Spring,04:00:00 PM,1414,643,771,partly cloudy day,
2018,Spring,11:00:00 PM,283,113,170,clear night,
2018,Winter,01:00:00 PM,663,249,414,partly cloudy day,
2018,Spring,03:00:00 PM,1835,842,993,partly cloudy day,
2018,Spring,01:00:00 PM,1575,675,900,partly cloudy day,
2018,Winter,08:00:00 PM,141,63,78,cloudy,
2018,Summer,02:00:00 AM,50,25,25,partly cloudy night,
2018,Spring,06:00:00 AM,34,23,11,clear night,
2018,Summer,07:00:00 PM,1027,491,536,partly cloudy day,
2018,Spring,06:00:00 PM,885,465,420,partly cloudy day,
2018,Spring,06:00:00 AM,58,25,33,fog,
2018,Winter,02:00:00 PM,1036,483,553,partly cloudy day,
2018,Winter,05:00:00 PM,2021,854,1167,clear day,
2018,Spring,08:00:00 AM,288,98,190,clear day,
2018,Winter,04:00:00 PM,794,408,386,partly cloudy day,
2018,Winter,05:00:00 PM,1131,562,569,clear day,
2018,Spring,01:00:00 PM,2328,1006,1322,clear day,
2018,Spring,06:00:00 AM,34,18,16,cloudy,
2018,Summer,03:00:00 PM,1927,891,1036,partly cloudy day,
2018,Spring,04:00:00 AM,0,0,0,rain,
2018,Spring,09:00:00 PM,89,40,49,clear night,
2018,Spring,10:00:00 AM,1508,888,620,clear day,Easter Sunday
2018,Spring,09:00:00 AM,582,310,272,partly cloudy day,
2018,Summer,10:00:00 PM,324,148,176,partly cloudy night,
2018,Spring,09:00:00 PM,157,74,83,clear night,
2018,Spring,03:00:00 AM,0,0,0,partly cloudy night,
2018,Spring,08:00:00 AM,384,168,216,partly cloudy day,
2018,Winter,09:00:00 AM,113,72,41,rain,
2018,Spring,06:00:00 PM,1374,651,723,rain,
2018,Winter,05:00:00 AM,3,1,2,partly cloudy night,
2018,Spring,09:00:00 PM,260,151,109,partly cloudy night,
2018,Spring,11:00:00 PM,213,120,93,clear night,
2018,Winter,10:00:00 AM,688,366,322,partly cloudy day,Valentine's Day
2018,Spring,04:00:00 AM,9,0,9,cloudy,
2018,Summer,01:00:00 AM,91,44,47,partly cloudy night,
2018,Spring,08:00:00 PM,161,97,64,rain,
2018,Winter,04:00:00 AM,2,1,1,clear night,Presidents' Day (regional holiday)
2018,Spring,09:00:00 PM,240,107,133,partly cloudy night,
2018,Spring,10:00:00 PM,162,121,41,partly cloudy night,
2018,Winter,06:00:00 AM,55,33,22,clear night,
2018,Winter,03:00:00 AM,1,0,1,clear night,
2018,Spring,10:00:00 AM,799,430,369,partly cloudy day,
2018,Spring,06:00:00 PM,549,340,209,partly cloudy day,
2018,Summer,11:00:00 PM,293,162,131,partly cloudy night,
2018,Spring,07:00:00 AM,153,79,74,clear day,
2018,Spring,12:00:00 PM,1775,776,999,partly cloudy day,
2018,Winter,02:00:00 AM,0,0,0,clear night,
2018,Spring,10:00:00 PM,179,102,77,partly cloudy night,
2018,Winter,10:00:00 AM,888,478,410,clear day,
2018,Spring,10:00:00 PM,46,22,24,clear night,
2018,Summer,01:00:00 PM,1613,793,820,cloudy,
2018,Spring,02:00:00 PM,1335,571,764,partly cloudy day,
2018,Spring,03:00:00 PM,1287,576,711,cloudy,
2018,Spring,08:00:00 PM,275,156,119,cloudy,
2018,Spring,08:00:00 PM,37,17,20,snow,
2018,Winter,09:00:00 PM,84,65,19,partly cloudy night,
2018,Spring,09:00:00 AM,668,373,295,clear day,
2018,Spring,09:00:00 AM,470,304,166,partly cloudy day,
2018,Summer,11:00:00 AM,1607,768,839,partly cloudy day,
2018,Spring,08:00:00 AM,360,127,233,partly cloudy day,
2018,Spring,05:00:00 PM,1890,1006,884,partly cloudy day,
2018,Spring,07:00:00 PM,403,178,225,cloudy,
2018,Spring,11:00:00 PM,88,67,21,clear night,
2018,Spring,02:00:00 PM,2442,1032,1410,clear day,
2018,Spring,01:00:00 PM,2150,948,1202,partly cloudy day,
2018,Spring,09:00:00 AM,773,378,395,clear day,
2018,Winter,11:00:00 PM,74,20,54,clear night,
2018,Spring,07:00:00 PM,1481,509,972,clear day,
2018,Spring,02:00:00 PM,1981,990,991,clear day,
2018,Spring,01:00:00 AM,11,8,3,clear night,
2018,Spring,09:00:00 PM,144,64,80,partly cloudy night,
2018,Winter,10:00:00 AM,314,170,144,rain,
2018,Spring,10:00:00 PM,400,145,255,clear night,
2018,Summer,09:00:00 AM,632,344,288,partly cloudy day,
2018,Spring,06:00:00 PM,1996,1046,950,clear day,
2018,Spring,11:00:00 AM,2302,1330,972,clear day,
2018,Spring,04:00:00 PM,2327,1046,1281,clear day,
2018,Spring,01:00:00 PM,1889,874,1015,cloudy,
2018,Spring,03:00:00 PM,1999,826,1173,clear day,
2018,Spring,10:00:00 PM,82,63,19,rain,Mother's Day
2018,Spring,09:00:00 PM,544,246,298,partly cloudy night,
2018,Spring,11:00:00 PM,48,19,29,partly cloudy night,
2018,Spring,07:00:00 AM,141,37,104,partly cloudy day,
2018,Spring,08:00:00 AM,425,154,271,partly cloudy day,
2018,Spring,09:00:00 AM,313,163,150,clear day,
2018,Spring,08:00:00 AM,289,95,194,clear day,
2018,Spring,03:00:00 PM,971,471,500,clear day,
2018,Spring,10:00:00 PM,304,138,166,partly cloudy night,
2018,Spring,03:00:00 AM,24,12,12,clear night,
2018,Spring,06:00:00 PM,1236,646,590,partly cloudy day,
2018,Spring,01:00:00 PM,3263,1581,1682,clear day,
2018,Spring,05:00:00 AM,29,15,14,clear night,
2018,Summer,03:00:00 AM,15,10,5,clear night,
2018,Spring,01:00:00 AM,43,25,18,cloudy,
2018,Spring,10:00:00 AM,2023,1137,886,clear day,
2018,Spring,08:00:00 AM,261,101,160,clear day,
2018,Spring,08:00:00 AM,194,64,130,clear day,
2018,Spring,11:00:00 AM,1364,563,801,clear day,St. Patrick's Day
2018,Spring,02:00:00 PM,2064,964,1100,partly cloudy day,
2018,Spring,04:00:00 AM,4,1,3,clear night,
2018,Winter,08:00:00 PM,269,188,81,clear night,
2018,Spring,05:00:00 PM,1898,952,946,clear day,
2018,Winter,09:00:00 PM,214,167,47,partly cloudy night,
2018,Spring,11:00:00 AM,1240,527,713,clear day,
2018,Spring,10:00:00 PM,163,88,75,cloudy,
2018,Winter,01:00:00 AM,3,0,3,clear night,
2018,Spring,04:00:00 AM,5,2,3,partly cloudy night,
2018,Spring,11:00:00 PM,11,4,7,partly cloudy night,
2018,Spring,10:00:00 PM,68,26,42,clear night,Daylight Saving Time starts
2018,Spring,02:00:00 AM,28,17,11,clear night,
2018,Summer,05:00:00 PM,1963,1103,860,partly cloudy day,
2018,Spring,05:00:00 AM,15,8,7,partly cloudy night,Easter Sunday
2018,Spring,06:00:00 AM,172,81,91,clear day,
2018,Spring,09:00:00 AM,1012,621,391,partly cloudy day,
2018,Winter,10:00:00 AM,787,448,339,partly cloudy day,
2018,Spring,11:00:00 AM,1357,678,679,clear day,
2018,Spring,12:00:00 AM,36,26,10,cloudy,
2018,Spring,01:00:00 AM,8,6,2,clear night,
2018,Spring,04:00:00 PM,1709,788,921,cloudy,
2018,Spring,02:00:00 PM,1905,865,1040,clear day,
2018,Spring,03:00:00 AM,16,14,2,clear night,
2018,Summer,05:00:00 AM,46,25,21,cloudy,
2018,Spring,02:00:00 PM,1967,921,1046,clear day,
2018,Spring,05:00:00 AM,24,14,10,partly cloudy night,
2018,Spring,08:00:00 PM,228,126,102,clear night,
2018,Spring,02:00:00 AM,8,6,2,clear night,
2018,Spring,06:00:00 AM,105,64,41,clear night,
2018,Winter,12:00:00 PM,1342,585,757,partly cloudy day,
2018,Spring,11:00:00 PM,239,192,47,partly cloudy night,
2018,Spring,03:00:00 PM,2507,1184,1323,partly cloudy day,
2018,Spring,02:00:00 AM,9,7,2,cloudy,
2018,Spring,12:00:00 AM,83,26,57,clear night,
2018,Spring,05:00:00 PM,2531,1293,1238,clear day,
2018,Spring,02:00:00 AM,5,3,2,partly cloudy night,
2018,Spring,06:00:00 PM,1777,870,907,cloudy,
2018,Spring,12:00:00 PM,1110,573,537,partly cloudy day,
2018,Spring,07:00:00 PM,10,6,4,snow,
2018,Spring,01:00:00 AM,51,24,27,partly cloudy night,
2018,Spring,07:00:00 PM,520,263,257,partly cloudy day,
2018,Spring,04:00:00 AM,6,2,4,partly cloudy night,
2018,Summer,05:00:00 AM,25,20,5,partly cloudy night,
2018,Spring,05:00:00 PM,1886,891,995,clear day,
2018,Spring,03:00:00 PM,466,205,261,rain,
2018,Spring,04:00:00 PM,1108,574,534,cloudy,
2018,Summer,02:00:00 PM,2060,908,1152,partly cloudy day,
2018,Spring,07:00:00 AM,242,97,145,clear day,
2018,Spring,07:00:00 PM,494,271,223,fog,
2018,Spring,06:00:00 PM,2405,934,1471,partly cloudy day,Cinco de Mayo
2018,Summer,09:00:00 PM,591,229,362,partly cloudy night,
2018,Spring,12:00:00 PM,1714,772,942,clear day,
2018,Spring,08:00:00 AM,321,173,148,clear day,
2018,Spring,08:00:00 AM,301,118,183,partly cloudy day,
2018,Spring,04:00:00 AM,2,0,2,partly cloudy night,
2018,Spring,07:00:00 AM,96,44,52,cloudy,
2018,Spring,01:00:00 PM,1010,456,554,wind,
2018,Spring,07:00:00 AM,198,100,98,partly cloudy day,
2018,Spring,05:00:00 PM,1084,594,490,partly cloudy day,
2018,Summer,08:00:00 PM,727,251,476,partly cloudy day,
2018,Spring,12:00:00 PM,1751,900,851,clear day,
2018,Spring,04:00:00 AM,1,0,1,partly cloudy night,
2018,Spring,05:00:00 PM,2029,1034,995,clear day,
2018,Spring,01:00:00 PM,2290,990,1300,clear day,
2018,Spring,02:00:00 PM,1974,913,1061,partly cloudy day,
2018,Spring,06:00:00 PM,1841,860,981,cloudy,
2018,Spring,05:00:00 AM,7,4,3,partly cloudy night,
2018,Spring,07:00:00 PM,216,109,107,partly cloudy day,
2018,Winter,02:00:00 AM,7,6,1,partly cloudy night,
2018,Spring,01:00:00 AM,27,17,10,clear night,
2018,Winter,06:00:00 AM,79,41,38,partly cloudy night,
2018,Spring,12:00:00 AM,30,10,20,partly cloudy night,
2018,Spring,10:00:00 AM,1942,1088,854,partly cloudy day,
2018,Spring,03:00:00 PM,2982,1237,1745,partly cloudy day,
2018,Spring,02:00:00 AM,15,4,11,fog,
2018,Spring,02:00:00 AM,0,0,0,partly cloudy night,
2018,Spring,11:00:00 PM,70,30,40,cloudy,
2018,Spring,12:00:00 AM,168,154,14,clear night,
2018,Winter,02:00:00 PM,890,428,462,clear day,
2018,Spring,04:00:00 AM,12,8,4,clear night,
2018,Winter,10:00:00 AM,919,479,440,partly cloudy day,
2018,Spring,05:00:00 PM,3350,1313,2037,clear day,
2018,Spring,07:00:00 PM,895,339,556,clear day,
2018,Spring,05:00:00 AM,27,16,11,clear night,
2018,Summer,06:00:00 AM,76,29,47,clear day,
2018,Spring,03:00:00 AM,11,4,7,clear night,
2018,Winter,06:00:00 PM,782,368,414,clear night,
2018,Spring,02:00:00 PM,2874,1231,1643,partly cloudy day,
2018,Summer,07:00:00 AM,76,40,36,rain,
2018,Spring,07:00:00 AM,192,76,116,partly cloudy day,
2018,Spring,01:00:00 PM,2307,966,1341,clear day,
2018,Spring,11:00:00 AM,1282,799,483,rain,
2018,Spring,04:00:00 PM,1558,731,827,clear day,
2018,Spring,10:00:00 AM,1735,978,757,partly cloudy day,Memorial Day
2018,Spring,11:00:00 PM,72,37,35,partly cloudy night,
2018,Spring,12:00:00 PM,1480,650,830,partly cloudy day,Tax Day
2018,Spring,05:00:00 PM,979,518,461,partly cloudy day,Tax Day
2018,Spring,12:00:00 PM,3325,1783,1542,partly cloudy day,
2018,Winter,06:00:00 PM,443,310,133,clear night,
2018,Spring,12:00:00 PM,1222,571,651,partly cloudy day,
2018,Summer,06:00:00 AM,75,26,49,partly cloudy day,
2018,Spring,05:00:00 PM,1674,882,792,clear day,
2018,Spring,05:00:00 AM,39,28,11,clear night,Cinco de Mayo
2018,Winter,12:00:00 PM,1425,698,727,cloudy,
2018,Spring,09:00:00 PM,418,152,266,partly cloudy night,
2018,Winter,12:00:00 AM,14,7,7,partly cloudy night,
2018,Spring,06:00:00 AM,16,11,5,rain,
2018,Spring,08:00:00 AM,188,81,107,partly cloudy day,
2018,Spring,02:00:00 AM,4,3,1,cloudy,
2018,Spring,08:00:00 PM,873,259,614,clear night,
2018,Spring,07:00:00 PM,1721,875,846,clear day,
2018,Spring,02:00:00 PM,1451,710,741,clear day,
2018,Winter,03:00:00 PM,581,309,272,rain,
2018,Spring,02:00:00 PM,3180,1492,1688,partly cloudy day,Easter Sunday
2018,Spring,07:00:00 PM,1722,913,809,clear day,
2018,Spring,02:00:00 PM,1777,804,973,partly cloudy day,
2018,Spring,07:00:00 PM,1082,448,634,partly cloudy day,
2018,Winter,02:00:00 AM,2,1,1,partly cloudy night,
2018,Spring,10:00:00 AM,1249,810,439,clear day,
2018,Winter,09:00:00 AM,549,299,250,partly cloudy day,
2018,Winter,08:00:00 AM,246,130,116,clear day,Presidents' Day (regional holiday)
2018,Winter,10:00:00 PM,167,126,41,partly cloudy night,Valentine's Day
2018,Spring,12:00:00 AM,21,13,8,cloudy,
2018,Summer,05:00:00 AM,22,10,12,cloudy,
2018,Spring,11:00:00 PM,278,195,83,clear night,
2018,Winter,10:00:00 AM,590,365,225,partly cloudy day,
2018,Winter,05:00:00 AM,17,11,6,partly cloudy night,
2018,Summer,11:00:00 PM,136,65,71,cloudy,
2018,Spring,03:00:00 AM,5,3,2,clear night,
2018,Spring,01:00:00 AM,38,28,10,partly cloudy night,
2018,Winter,03:00:00 AM,1,0,1,clear night,
2018,Spring,08:00:00 PM,853,316,537,partly cloudy night,
2018,Spring,03:00:00 PM,3278,1532,1746,clear day,
2018,Spring,07:00:00 AM,42,26,16,partly cloudy night,
2018,Spring,03:00:00 AM,2,0,2,clear night,
2018,Spring,06:00:00 PM,1343,687,656,partly cloudy day,
2018,Winter,03:00:00 AM,4,3,1,partly cloudy night,
2018,Spring,03:00:00 PM,3657,1640,2017,cloudy,Memorial Day
2018,Spring,03:00:00 AM,12,6,6,clear night,
2018,Spring,02:00:00 AM,11,5,6,partly cloudy night,
2018,Spring,10:00:00 AM,1022,503,519,clear day,
2018,Spring,04:00:00 AM,3,1,2,partly cloudy night,
2018,Winter,01:00:00 AM,15,10,5,fog,
2018,Spring,01:00:00 AM,29,16,13,clear night,
2018,Spring,02:00:00 PM,2183,979,1204,partly cloudy day,
2018,Winter,02:00:00 PM,1184,530,654,clear day,
2018,Spring,04:00:00 AM,5,3,2,partly cloudy night,
2018,Winter,05:00:00 AM,19,13,6,clear night,
2018,Winter,12:00:00 AM,4,3,1,snow,
2018,Spring,04:00:00 PM,1244,694,550,clear day,
2018,Summer,04:00:00 AM,6,3,3,clear night,
2018,Spring,10:00:00 AM,740,358,382,clear day,
2018,Winter,02:00:00 PM,1498,650,848,clear day,
2018,Spring,04:00:00 AM,5,4,1,clear night,
2018,Spring,10:00:00 AM,888,505,383,cloudy,
2018,Spring,06:00:00 PM,2035,1178,857,clear day,
2018,Spring,10:00:00 PM,76,46,30,partly cloudy night,
2018,Spring,09:00:00 AM,444,248,196,partly cloudy day,Tax Day
2018,Spring,11:00:00 PM,59,26,33,clear night,
2018,Spring,11:00:00 PM,29,12,17,partly cloudy night,
2018,Spring,01:00:00 PM,1861,888,973,clear day,
2018,Spring,01:00:00 PM,1871,791,1080,partly cloudy day,
2018,Spring,07:00:00 PM,917,379,538,clear day,
2018,Summer,12:00:00 PM,1900,928,972,clear day,
2018,Spring,03:00:00 PM,2747,1391,1356,partly cloudy day,
2018,Winter,03:00:00 PM,1807,848,959,clear day,
2018,Spring,04:00:00 AM,1,0,1,clear night,
2018,Spring,05:00:00 PM,2388,1273,1115,clear day,
2018,Spring,03:00:00 AM,14,5,9,cloudy,
2018,Winter,07:00:00 AM,177,70,107,clear day,
2018,Spring,04:00:00 PM,183,105,78,snow,
2018,Spring,03:00:00 AM,2,1,1,partly cloudy night,
2018,Spring,12:00:00 PM,1969,882,1087,clear day,
2018,Spring,03:00:00 AM,0,0,0,partly cloudy night,
2018,Summer,12:00:00 PM,1571,639,932,partly cloudy day,
2018,Spring,05:00:00 PM,2156,1054,1102,clear day,
2018,Spring,09:00:00 AM,454,235,219,partly cloudy day,
2018,Summer,10:00:00 AM,1209,753,456,partly cloudy day,
2018,Spring,08:00:00 AM,123,74,49,cloudy,
2018,Spring,02:00:00 AM,19,9,10,clear night,
2018,Spring,04:00:00 AM,4,2,2,clear night,
2018,Spring,02:00:00 PM,2087,891,1196,clear day,
2018,Spring,07:00:00 PM,637,264,373,clear day,
2018,Spring,12:00:00 AM,13,10,3,partly cloudy night,
2018,Spring,04:00:00 PM,1857,744,1113,partly cloudy day,
2018,Spring,06:00:00 AM,145,81,64,clear day,
2018,Spring,06:00:00 AM,144,67,77,clear day,
2018,Spring,09:00:00 AM,596,300,296,clear day,
2018,Summer,08:00:00 PM,1606,640,966,partly cloudy day,
2018,Winter,03:00:00 AM,3,0,3,clear night,
2018,Spring,02:00:00 AM,17,14,3,clear night,
2018,Spring,06:00:00 PM,912,429,483,partly cloudy day,
2018,Spring,11:00:00 PM,375,185,190,clear night,
2018,Spring,10:00:00 AM,1231,601,630,clear day,
2018,Spring,06:00:00 AM,60,22,38,partly cloudy night,
2018,Spring,03:00:00 AM,5,3,2,clear night,
2018,Spring,11:00:00 AM,764,413,351,clear day,
2018,Spring,11:00:00 AM,1693,844,849,cloudy,Mother's Day
2018,Spring,05:00:00 AM,10,8,2,cloudy,
2018,Spring,12:00:00 AM,16,6,10,cloudy,
2018,Spring,10:00:00 AM,1874,1062,812,clear day,
2018,Spring,03:00:00 PM,1684,825,859,partly cloudy day,
2018,Spring,11:00:00 PM,18,13,5,partly cloudy night,
2018,Spring,01:00:00 AM,11,5,6,clear night,
2018,Spring,05:00:00 AM,19,11,8,cloudy,
2018,Spring,03:00:00 PM,1553,695,858,clear day,
2018,Summer,06:00:00 AM,218,103,115,partly cloudy day,
2018,Spring,10:00:00 AM,1536,787,749,partly cloudy day,
2018,Spring,04:00:00 AM,4,1,3,clear night,
2018,Spring,09:00:00 AM,852,544,308,clear day,Cinco de Mayo
2018,Spring,07:00:00 PM,414,221,193,partly cloudy night,
2018,Spring,07:00:00 AM,117,58,59,partly cloudy day,
2018,Spring,11:00:00 AM,336,162,174,rain,
2018,Winter,11:00:00 AM,1523,788,735,clear day,
2018,Summer,09:00:00 AM,510,244,266,cloudy,
2018,Spring,08:00:00 AM,160,82,78,clear day,
2018,Spring,06:00:00 PM,1728,991,737,clear day,
2018,Spring,05:00:00 PM,3587,1472,2115,clear day,
2018,Winter,05:00:00 AM,20,10,10,cloudy,
2018,Spring,10:00:00 AM,1524,879,645,partly cloudy day,
2018,Spring,06:00:00 AM,35,24,11,clear night,St. Patrick's Day
2018,Spring,07:00:00 AM,62,24,38,partly cloudy day,
2018,Spring,12:00:00 AM,26,9,17,partly cloudy night,
2018,Spring,11:00:00 PM,30,14,16,clear night,
2018,Spring,04:00:00 AM,7,4,3,partly cloudy night,
2018,Spring,07:00:00 PM,14,13,1,partly cloudy night,
2018,Spring,01:00:00 PM,796,322,474,partly cloudy day,
2018,Spring,02:00:00 PM,571,261,310,rain,
2018,Winter,06:00:00 PM,169,137,32,partly cloudy night,
2018,Spring,02:00:00 PM,1380,725,655,partly cloudy day,
2018,Spring,05:00:00 PM,1677,766,911,cloudy,
2018,Winter,10:00:00 AM,808,462,346,partly cloudy day,
2018,Spring,07:00:00 PM,1147,440,707,clear day,
2018,Spring,03:00:00 AM,0,0,0,partly cloudy night,
2018,Spring,01:00:00 PM,2552,1214,1338,clear day,
2018,Winter,11:00:00 PM,60,46,14,partly cloudy night,
2018,Spring,04:00:00 PM,1726,798,928,partly cloudy day,
2018,Summer,01:00:00 AM,27,15,12,partly cloudy night,
2018,Spring,01:00:00 AM,0,0,0,wind,
2018,Spring,07:00:00 PM,558,264,294,partly cloudy day,
2018,Spring,04:00:00 PM,950,520,430,cloudy,
2018,Spring,01:00:00 PM,1093,449,644,partly cloudy day,
2018,Spring,12:00:00 AM,19,13,6,clear night,
2018,Spring,10:00:00 PM,255,131,124,clear night,
2018,Spring,08:00:00 PM,630,264,366,partly cloudy night,
2018,Spring,06:00:00 PM,513,336,177,partly cloudy day,
2018,Spring,02:00:00 PM,3235,1430,1805,clear day,Cinco de Mayo
2018,Summer,07:00:00 PM,1866,1104,762,clear day,
2018,Spring,06:00:00 PM,1910,1162,748,clear day,
2018,Spring,06:00:00 AM,108,48,60,partly cloudy day,
2018,Spring,08:00:00 PM,354,137,217,partly cloudy night,
2018,Spring,09:00:00 AM,794,486,308,clear day,Daylight Saving Time starts
2018,Winter,11:00:00 PM,56,16,40,partly cloudy night,
2018,Spring,08:00:00 PM,468,191,277,partly cloudy night,
2018,Winter,09:00:00 AM,251,130,121,partly cloudy day,
2018,Winter,11:00:00 AM,717,326,391,partly cloudy day,
2018,Spring,02:00:00 AM,12,7,5,partly cloudy night,
2018,Winter,05:00:00 AM,2,0,2,rain,
2018,Spring,03:00:00 AM,2,1,1,rain,
2018,Spring,08:00:00 PM,518,185,333,clear night,
2018,Summer,02:00:00 PM,2041,867,1174,partly cloudy day,
2018,Winter,01:00:00 AM,13,8,5,partly cloudy night,
2018,Spring,01:00:00 PM,868,391,477,partly cloudy day,
2018,Spring,08:00:00 AM,510,171,339,partly cloudy day,
2018,Winter,10:00:00 PM,62,30,32,clear night,
2018,Spring,05:00:00 PM,1418,722,696,partly cloudy day,
2018,Winter,06:00:00 PM,151,114,37,rain,
2018,Spring,02:00:00 AM,2,0,2,partly cloudy night,
2018,Winter,04:00:00 PM,526,238,288,partly cloudy day,
2018,Winter,05:00:00 PM,111,89,22,rain,
2018,Spring,11:00:00 AM,1748,919,829,clear day,
2018,Spring,01:00:00 PM,1301,590,711,partly cloudy day,
2018,Spring,06:00:00 AM,98,70,28,clear night,
2018,Spring,12:00:00 PM,1405,641,764,clear day,
2018,Spring,11:00:00 PM,235,91,144,clear night,
2018,Winter,10:00:00 PM,90,53,37,partly cloudy night,
2018,Winter,01:00:00 PM,1465,645,820,partly cloudy day,
2018,Spring,06:00:00 PM,817,419,398,partly cloudy night,
2018,Winter,09:00:00 AM,536,338,198,clear day,
2018,Winter,06:00:00 PM,448,281,167,clear night,
2018,Winter,01:00:00 PM,806,387,419,partly cloudy day,
2018,Summer,03:00:00 PM,1754,781,973,cloudy,
2018,Spring,07:00:00 AM,152,61,91,partly cloudy day,
2018,Spring,05:00:00 AM,59,41,18,clear night,
2018,Winter,06:00:00 AM,5,4,1,rain,
2018,Spring,01:00:00 AM,27,14,13,partly cloudy night,
2018,Spring,12:00:00 AM,176,125,51,clear night,
2018,Winter,04:00:00 PM,1912,1003,909,clear day,
2018,Spring,02:00:00 PM,112,44,68,sleet,
2018,Spring,05:00:00 AM,51,38,13,cloudy,
2018,Spring,02:00:00 AM,0,0,0,rain,
2018,Spring,09:00:00 AM,353,171,182,clear day,
2018,Spring,03:00:00 AM,5,4,1,clear night,
2018,Spring,04:00:00 AM,6,4,2,partly cloudy night,Daylight Saving Time starts
2018,Winter,11:00:00 AM,994,457,537,clear day,
2018,Spring,05:00:00 PM,997,471,526,partly cloudy day,
2018,Spring,04:00:00 PM,1954,844,1110,clear day,St. Patrick's Day
2018,Winter,09:00:00 AM,537,281,256,partly cloudy day,
2018,Spring,10:00:00 AM,1755,963,792,clear day,
2018,Spring,04:00:00 PM,1692,786,906,clear day,
2018,Winter,04:00:00 PM,292,116,176,rain,
2018,Summer,07:00:00 PM,1516,810,706,partly cloudy day,
2018,Spring,12:00:00 AM,32,11,21,clear night,
2018,Spring,11:00:00 PM,43,20,23,clear night,
2018,Winter,12:00:00 AM,14,9,5,clear night,
2018,Spring,09:00:00 PM,101,56,45,fog,
2018,Winter,07:00:00 PM,783,428,355,clear night,
2018,Spring,09:00:00 AM,886,489,397,clear day,
2018,Summer,04:00:00 AM,1,0,1,cloudy,
2018,Summer,11:00:00 AM,1604,964,640,cloudy,
2018,Spring,06:00:00 PM,1822,1002,820,clear day,
2018,Spring,01:00:00 PM,46,19,27,sleet,
2018,Spring,01:00:00 PM,1767,811,956,clear day,
2018,Winter,11:00:00 PM,26,9,17,clear night,
2018,Spring,08:00:00 AM,372,143,229,partly cloudy day,
2018,Spring,09:00:00 AM,766,378,388,clear day,
2018,Spring,10:00:00 PM,26,19,7,cloudy,
2018,Winter,09:00:00 PM,77,49,28,clear night,
2018,Summer,08:00:00 AM,157,70,87,cloudy,
2018,Summer,06:00:00 AM,52,28,24,cloudy,
2018,Spring,04:00:00 AM,1,0,1,clear night,
2018,Spring,10:00:00 PM,108,50,58,partly cloudy night,
2018,Spring,06:00:00 AM,164,68,96,clear day,
2018,Spring,06:00:00 PM,2458,1144,1314,clear day,
2018,Summer,06:00:00 PM,1794,712,1082,partly cloudy day,
2018,Spring,05:00:00 AM,34,19,15,clear night,
2018,Spring,05:00:00 AM,16,11,5,partly cloudy night,
2018,Summer,06:00:00 AM,121,57,64,clear day,
2018,Spring,01:00:00 PM,2085,1003,1082,clear day,
2018,Spring,06:00:00 PM,892,424,468,cloudy,
2018,Spring,06:00:00 PM,172,118,54,rain,
2018,Winter,11:00:00 PM,130,105,25,clear night,
2018,Spring,01:00:00 AM,9,7,2,cloudy,
2018,Spring,09:00:00 PM,395,243,152,wind,
2018,Spring,10:00:00 AM,1606,939,667,clear day,
2018,Spring,11:00:00 AM,479,268,211,cloudy,
2018,Spring,01:00:00 AM,12,3,9,partly cloudy night,
2018,Spring,07:00:00 PM,1951,955,996,partly cloudy day,
2018,Spring,01:00:00 AM,22,18,4,partly cloudy night,
2018,Spring,09:00:00 PM,51,34,17,cloudy,
2018,Spring,12:00:00 AM,1,0,1,partly cloudy night,
2018,Spring,12:00:00 PM,312,152,160,snow,
2018,Spring,11:00:00 AM,1675,892,783,clear day,Daylight Saving Time starts
2018,Spring,02:00:00 AM,6,3,3,partly cloudy night,
2018,Spring,04:00:00 PM,1573,762,811,clear day,
2018,Spring,04:00:00 AM,5,3,2,clear night,
2018,Winter,04:00:00 AM,3,1,2,clear night,
2018,Spring,12:00:00 AM,15,8,7,cloudy,
2018,Summer,11:00:00 PM,313,148,165,clear night,
2018,Summer,04:00:00 PM,2944,1252,1692,partly cloudy day,
2018,Spring,11:00:00 PM,127,99,28,clear night,
2018,Spring,12:00:00 PM,1670,784,886,partly cloudy day,
2018,Winter,12:00:00 PM,186,79,107,cloudy,
2018,Winter,11:00:00 PM,201,173,28,clear night,
2018,Spring,08:00:00 PM,559,200,359,clear night,
2018,Spring,10:00:00 PM,119,48,71,partly cloudy night,
2018,Spring,11:00:00 PM,81,43,38,partly cloudy night,
2018,Spring,05:00:00 AM,55,29,26,cloudy,
2018,Spring,10:00:00 PM,263,139,124,partly cloudy night,
2018,Spring,09:00:00 AM,367,172,195,clear day,
2018,Summer,10:00:00 AM,1467,905,562,clear day,
2018,Spring,09:00:00 PM,229,124,105,partly cloudy night,
2018,Winter,06:00:00 PM,300,158,142,clear night,
2018,Winter,01:00:00 PM,1217,562,655,clear day,
2018,Spring,08:00:00 AM,312,186,126,partly cloudy day,Memorial Day
2018,Spring,09:00:00 AM,347,171,176,partly cloudy day,
2018,Spring,03:00:00 AM,0,0,0,partly cloudy night,
2018,Winter,06:00:00 PM,796,414,382,clear night,
2018,Spring,01:00:00 AM,27,14,13,clear night,
2018,Summer,08:00:00 PM,1293,534,759,clear day,
2018,Winter,08:00:00 PM,335,241,94,clear night,
2018,Spring,11:00:00 PM,308,181,127,clear night,
2018,Winter,04:00:00 AM,2,0,2,clear night,
2018,Summer,08:00:00 AM,462,171,291,clear day,
2018,Winter,06:00:00 AM,67,32,35,cloudy,
2018,Spring,06:00:00 PM,754,337,417,partly cloudy night,
2018,Spring,01:00:00 PM,2945,1227,1718,partly cloudy day,
2018,Spring,02:00:00 AM,30,18,12,partly cloudy night,
2018,Winter,12:00:00 AM,11,7,4,partly cloudy night,
2018,Winter,08:00:00 AM,325,104,221,cloudy,
2018,Spring,12:00:00 PM,2234,1064,1170,clear day,
2018,Spring,04:00:00 PM,2210,840,1370,partly cloudy day,
2018,Winter,01:00:00 PM,827,350,477,clear day,
2018,Spring,10:00:00 AM,1445,826,619,partly cloudy day,
2018,Spring,11:00:00 AM,1776,848,928,clear day,
2018,Summer,12:00:00 AM,24,8,16,cloudy,
2018,Spring,02:00:00 PM,1067,508,559,cloudy,
2018,Winter,02:00:00 PM,767,368,399,partly cloudy day,
2018,Spring,01:00:00 AM,6,1,5,clear night,
2018,Winter,11:00:00 PM,62,42,20,clear night,
2018,Winter,07:00:00 AM,87,35,52,partly cloudy night,
2018,Spring,01:00:00 PM,2068,926,1142,clear day,
2018,Winter,09:00:00 PM,156,91,65,partly cloudy night,
2018,Spring,02:00:00 PM,1333,564,769,partly cloudy day,
2018,Spring,11:00:00 PM,106,65,41,cloudy,
2018,Spring,04:00:00 AM,2,0,2,partly cloudy night,Tax Day
2018,Winter,02:00:00 AM,3,2,1,partly cloudy night,
2018,Spring,02:00:00 PM,2778,1290,1488,clear day,
2018,Summer,04:00:00 AM,3,1,2,clear night,
2018,Summer,12:00:00 PM,1842,902,940,partly cloudy day,
2018,Spring,12:00:00 AM,103,89,14,cloudy,
2018,Spring,05:00:00 AM,11,3,8,cloudy,
2018,Spring,04:00:00 AM,4,2,2,clear night,
2018,Spring,05:00:00 PM,3372,1681,1691,clear day,
2018,Spring,12:00:00 PM,53,28,25,rain,
2018,Spring,08:00:00 PM,149,82,67,clear night,
2018,Winter,01:00:00 AM,6,4,2,cloudy,
2018,Spring,03:00:00 AM,11,6,5,clear night,
2018,Spring,06:00:00 PM,759,364,395,partly cloudy night,
2018,Spring,06:00:00 PM,1540,862,678,clear day,
2018,Winter,07:00:00 PM,210,125,85,cloudy,
2018,Spring,04:00:00 AM,9,5,4,clear night,
2018,Summer,08:00:00 AM,353,121,232,cloudy,
2018,Summer,03:00:00 AM,15,5,10,cloudy,
2018,Spring,06:00:00 AM,103,52,51,cloudy,
2018,Spring,03:00:00 AM,2,1,1,cloudy,
2018,Spring,04:00:00 AM,3,2,1,clear night,
2018,Spring,04:00:00 PM,1557,719,838,partly cloudy day,
2018,Spring,06:00:00 AM,37,14,23,partly cloudy night,
2018,Spring,01:00:00 PM,2982,1418,1564,clear day,Easter Sunday
2018,Winter,02:00:00 AM,2,1,1,clear night,
2018,Spring,07:00:00 PM,1435,746,689,clear day,
2018,Spring,12:00:00 AM,65,39,26,partly cloudy night,
2018,Spring,06:00:00 PM,1727,952,775,clear day,
2018,Winter,11:00:00 AM,1821,935,886,cloudy,
2018,Spring,04:00:00 PM,2237,1021,1216,clear day,
2018,Spring,01:00:00 PM,1246,565,681,rain,
2018,Winter,12:00:00 AM,29,16,13,clear night,Presidents' Day (regional holiday)
2018,Spring,07:00:00 PM,1908,804,1104,cloudy,Memorial Day
2018,Spring,07:00:00 AM,220,59,161,partly cloudy day,
2018,Spring,02:00:00 PM,391,145,246,partly cloudy day,
2018,Spring,11:00:00 AM,801,429,372,clear day,
2018,Winter,09:00:00 PM,249,190,59,partly cloudy night,Valentine's Day
2018,Spring,10:00:00 AM,1456,873,583,partly cloudy day,
2018,Spring,02:00:00 AM,3,2,1,partly cloudy night,
2018,Spring,08:00:00 AM,197,80,117,partly cloudy day,
2018,Spring,02:00:00 PM,923,343,580,cloudy,
2018,Spring,01:00:00 PM,2156,1023,1133,partly cloudy day,
2018,Winter,02:00:00 PM,1476,742,734,clear day,
2018,Spring,02:00:00 AM,4,0,4,cloudy,
2018,Spring,11:00:00 AM,867,491,376,partly cloudy day,
2018,Spring,09:00:00 AM,468,254,214,clear day,
2018,Spring,01:00:00 AM,43,26,17,partly cloudy night,
2018,Spring,03:00:00 AM,5,1,4,cloudy,
2018,Spring,12:00:00 PM,1352,673,679,partly cloudy day,
2018,Spring,07:00:00 AM,250,106,144,clear day,
2018,Spring,01:00:00 AM,3,0,3,partly cloudy night,
2018,Spring,06:00:00 AM,104,55,49,partly cloudy day,
2018,Spring,01:00:00 PM,2874,1456,1418,clear day,Cinco de Mayo
2018,Spring,07:00:00 AM,165,76,89,partly cloudy day,
2018,Spring,04:00:00 PM,2299,1044,1255,cloudy,
2018,Spring,01:00:00 PM,1014,510,504,partly cloudy day,
2018,Winter,03:00:00 PM,1648,699,949,cloudy,Presidents' Day (regional holiday)
2018,Spring,08:00:00 PM,13,8,5,rain,
2018,Winter,01:00:00 PM,1343,600,743,clear day,
2018,Winter,03:00:00 PM,981,485,496,partly cloudy day,
2018,Winter,04:00:00 PM,483,292,191,partly cloudy day,
2018,Spring,01:00:00 AM,13,7,6,partly cloudy night,
2018,Spring,03:00:00 PM,3205,1371,1834,partly cloudy day,
2018,Spring,09:00:00 PM,125,80,45,partly cloudy night,
2018,Spring,08:00:00 PM,408,159,249,clear night,St. Patrick's Day
2018,Spring,05:00:00 AM,3,2,1,rain,
2018,Spring,07:00:00 PM,1030,414,616,clear day,
2018,Spring,07:00:00 PM,686,300,386,partly cloudy day,Mother's Day
2018,Spring,04:00:00 PM,1860,899,961,partly cloudy day,
2018,Spring,10:00:00 AM,1203,698,505,partly cloudy day,
2018,Spring,08:00:00 AM,168,76,92,partly cloudy day,
2018,Spring,02:00:00 AM,14,8,6,clear night,
2018,Winter,08:00:00 PM,239,167,72,clear night,
2018,Spring,10:00:00 AM,991,520,471,clear day,
2018,Spring,10:00:00 AM,1428,875,553,partly cloudy day,
2018,Spring,08:00:00 AM,516,219,297,partly cloudy day,
2018,Spring,01:00:00 PM,1223,568,655,clear day,
2018,Winter,11:00:00 PM,140,112,28,cloudy,
2018,Spring,04:00:00 PM,2036,990,1046,cloudy,
2018,Winter,05:00:00 AM,20,10,10,partly cloudy night,
2018,Spring,04:00:00 PM,2212,1017,1195,clear day,Daylight Saving Time starts
2018,Winter,06:00:00 PM,463,279,184,partly cloudy night,
2018,Spring,10:00:00 AM,801,424,377,partly cloudy day,
2018,Spring,07:00:00 PM,1861,1002,859,clear day,
2018,Spring,06:00:00 AM,110,60,50,clear night,
2018,Spring,05:00:00 PM,1765,864,901,partly cloudy day,
2018,Spring,11:00:00 AM,2334,733,1601,partly cloudy day,
2018,Spring,07:00:00 AM,26,13,13,rain,
2018,Winter,04:00:00 AM,1,0,1,partly cloudy night,Valentine's Day
2018,Spring,04:00:00 PM,3255,1292,1963,clear day,Cinco de Mayo
2018,Spring,03:00:00 AM,9,4,5,clear night,
2018,Spring,10:00:00 PM,215,80,135,clear night,
2018,Spring,09:00:00 PM,596,259,337,partly cloudy night,
2018,Winter,11:00:00 AM,810,419,391,clear day,
2018,Spring,07:00:00 AM,324,135,189,clear day,
2018,Spring,08:00:00 AM,385,124,261,partly cloudy day,
2018,Spring,09:00:00 AM,754,374,380,clear day,
2018,Spring,04:00:00 PM,510,284,226,rain,
2018,Spring,11:00:00 PM,36,30,6,partly cloudy night,
2018,Spring,10:00:00 PM,112,52,60,fog,
2018,Summer,12:00:00 PM,2318,1179,1139,clear day,
2018,Spring,05:00:00 PM,1082,573,509,clear day,
2018,Summer,03:00:00 PM,2201,1057,1144,clear day,
2018,Spring,10:00:00 PM,553,214,339,clear night,
2018,Spring,11:00:00 PM,47,33,14,cloudy,
2018,Spring,02:00:00 PM,1668,741,927,clear day,
2018,Spring,03:00:00 PM,1479,678,801,partly cloudy day,
2018,Spring,07:00:00 AM,142,84,58,clear day,
2018,Spring,04:00:00 AM,2,1,1,clear night,
2018,Winter,12:00:00 PM,711,364,347,partly cloudy day,
2018,Spring,03:00:00 PM,1266,616,650,cloudy,
2018,Winter,10:00:00 AM,634,353,281,clear day,
2018,Spring,01:00:00 PM,1453,597,856,clear day,
2018,Summer,03:00:00 AM,11,9,2,partly cloudy night,
2018,Spring,05:00:00 PM,617,318,299,partly cloudy day,
2018,Spring,05:00:00 PM,46,30,16,snow,
2018,Spring,06:00:00 AM,17,10,7,snow,
2018,Spring,10:00:00 AM,1453,880,573,clear day,
2018,Winter,06:00:00 PM,995,476,519,clear night,
2018,Spring,02:00:00 AM,3,0,3,partly cloudy night,
2018,Spring,06:00:00 AM,120,51,69,partly cloudy night,
2018,Spring,07:00:00 AM,78,37,41,clear night,
2018,Spring,01:00:00 PM,1820,804,1016,clear day,
2018,Spring,05:00:00 AM,43,31,12,clear night,
2018,Spring,02:00:00 PM,2261,1041,1220,clear day,
2018,Summer,04:00:00 AM,6,4,2,clear night,
2018,Spring,03:00:00 PM,1976,923,1053,clear day,
2018,Spring,05:00:00 AM,14,11,3,partly cloudy night,
2018,Spring,08:00:00 PM,646,330,316,clear night,
2018,Spring,08:00:00 PM,1153,484,669,clear night,
2018,Winter,03:00:00 PM,1112,532,580,partly cloudy day,Valentine's Day
2018,Spring,07:00:00 AM,89,40,49,partly cloudy day,
2018,Winter,03:00:00 AM,4,2,2,cloudy,
2018,Winter,08:00:00 PM,68,38,30,partly cloudy night,
2018,Winter,05:00:00 AM,16,6,10,clear night,
2018,Winter,04:00:00 PM,1178,560,618,clear day,
2018,Winter,08:00:00 AM,198,61,137,partly cloudy day,
2018,Spring,07:00:00 PM,372,217,155,partly cloudy day,Tax Day
2018,Spring,06:00:00 AM,34,13,21,rain,
2018,Spring,05:00:00 PM,2121,1008,1113,clear day,
2018,Winter,06:00:00 AM,48,26,22,partly cloudy night,
2018,Spring,05:00:00 AM,37,24,13,partly cloudy night,
2018,Summer,08:00:00 AM,283,177,106,partly cloudy day,
2018,Spring,08:00:00 PM,291,146,145,partly cloudy night,
2018,Summer,04:00:00 PM,2023,971,1052,clear day,
2018,Spring,06:00:00 PM,18,10,8,snow,
2018,Winter,07:00:00 AM,87,46,41,clear day,
2018,Summer,06:00:00 PM,1693,918,775,clear day,
2018,Winter,06:00:00 AM,85,45,40,clear night,
2018,Spring,05:00:00 PM,774,375,399,partly cloudy day,
2018,Winter,04:00:00 PM,921,504,417,cloudy,
2018,Spring,02:00:00 AM,12,9,3,partly cloudy night,
2018,Spring,12:00:00 PM,781,373,408,partly cloudy day,
2018,Spring,02:00:00 AM,9,3,6,clear night,
2018,Winter,03:00:00 AM,2,1,1,cloudy,
2018,Summer,01:00:00 AM,3,2,1,rain,
2018,Summer,07:00:00 PM,1369,726,643,clear day,
2018,Winter,03:00:00 AM,6,2,4,clear night,
2018,Spring,05:00:00 PM,46,31,15,partly cloudy day,
2018,Winter,04:00:00 PM,1630,770,860,partly cloudy day,
2018,Spring,07:00:00 PM,574,279,295,partly cloudy day,
2018,Spring,03:00:00 AM,5,4,1,partly cloudy night,
2018,Winter,08:00:00 AM,143,55,88,partly cloudy day,
2018,Spring,11:00:00 AM,88,55,33,rain,
2018,Summer,05:00:00 PM,1777,939,838,partly cloudy day,
2018,Winter,05:00:00 PM,994,455,539,clear day,
2018,Spring,12:00:00 PM,1378,605,773,clear day,
2018,Spring,12:00:00 AM,1,0,1,rain,
2018,Summer,04:00:00 PM,1709,774,935,partly cloudy day,
2018,Spring,09:00:00 AM,531,279,252,partly cloudy day,
2018,Spring,12:00:00 AM,18,10,8,clear night,
2018,Spring,02:00:00 PM,2180,1018,1162,clear day,
2018,Spring,02:00:00 AM,11,3,8,partly cloudy night,
2018,Spring,12:00:00 PM,4058,1980,2078,clear day,
2018,Spring,12:00:00 AM,3,1,2,partly cloudy night,
2018,Spring,02:00:00 AM,26,8,18,clear night,
2018,Spring,12:00:00 AM,15,9,6,clear night,
2018,Spring,03:00:00 AM,0,0,0,clear night,
2018,Spring,12:00:00 PM,1010,444,566,wind,
2018,Spring,09:00:00 PM,358,151,207,partly cloudy night,
2018,Winter,10:00:00 PM,107,102,5,partly cloudy night,
2018,Summer,05:00:00 PM,2172,980,1192,clear day,
2018,Spring,08:00:00 PM,331,173,158,cloudy,
2018,Spring,11:00:00 PM,107,47,60,partly cloudy night,
2018,Winter,04:00:00 AM,5,3,2,cloudy,
2018,Spring,06:00:00 AM,119,65,54,clear night,
2018,Spring,08:00:00 AM,207,79,128,cloudy,
2018,Winter,03:00:00 PM,873,444,429,partly cloudy day,
2018,Spring,10:00:00 AM,1093,627,466,partly cloudy day,
2018,Summer,05:00:00 AM,37,27,10,clear night,
2018,Spring,01:00:00 AM,2,1,1,snow,
2018,Spring,05:00:00 PM,2253,1060,1193,clear day,
2018,Spring,08:00:00 AM,188,94,94,clear day,
2018,Spring,07:00:00 AM,236,114,122,cloudy,
2018,Spring,03:00:00 PM,1059,453,606,snow,
2018,Spring,08:00:00 PM,643,246,397,clear night,Easter Sunday
2018,Spring,02:00:00 PM,2118,954,1164,clear day,
2018,Spring,07:00:00 PM,1800,987,813,clear day,
2018,Summer,04:00:00 AM,5,1,4,partly cloudy night,
2018,Winter,10:00:00 AM,999,622,377,clear day,Presidents' Day (regional holiday)
2018,Spring,07:00:00 PM,444,213,231,partly cloudy night,
2018,Winter,08:00:00 AM,232,77,155,fog,
2018,Summer,08:00:00 AM,516,145,371,clear day,
2018,Spring,10:00:00 PM,92,43,49,clear night,
2018,Winter,01:00:00 AM,14,7,7,clear night,
2018,Spring,11:00:00 AM,2154,1325,829,rain,
2018,Spring,06:00:00 PM,1600,883,717,clear day,
2018,Winter,08:00:00 AM,320,127,193,clear day,
2018,Spring,04:00:00 PM,1097,571,526,rain,Mother's Day
2018,Spring,10:00:00 AM,1640,1064,576,clear day,
2018,Spring,01:00:00 AM,50,24,26,partly cloudy night,Daylight Saving Time starts
2018,Winter,08:00:00 AM,186,66,120,clear day,
2018,Spring,10:00:00 AM,51,28,23,rain,
2018,Spring,12:00:00 AM,66,43,23,partly cloudy night,
2018,Winter,12:00:00 PM,1926,1080,846,clear day,
2018,Spring,11:00:00 PM,326,219,107,clear night,
2018,Spring,02:00:00 AM,13,9,4,cloudy,
2018,Spring,09:00:00 PM,325,122,203,cloudy,
2018,Spring,12:00:00 PM,1917,869,1048,partly cloudy day,
2018,Spring,06:00:00 AM,171,78,93,partly cloudy day,
2018,Spring,10:00:00 PM,282,136,146,clear night,
2018,Spring,04:00:00 AM,9,5,4,partly cloudy night,
2018,Spring,07:00:00 PM,259,142,117,partly cloudy night,
2018,Winter,09:00:00 PM,60,56,4,rain,
2018,Spring,08:00:00 AM,228,123,105,clear day,
2018,Spring,02:00:00 PM,445,220,225,rain,
2018,Winter,10:00:00 PM,125,78,47,partly cloudy night,
2018,Spring,11:00:00 AM,1615,948,667,partly cloudy day,
2018,Spring,07:00:00 AM,57,16,41,partly cloudy day,
2018,Spring,11:00:00 PM,206,89,117,clear night,
2018,Spring,10:00:00 PM,14,5,9,partly cloudy night,
2018,Spring,10:00:00 PM,261,138,123,partly cloudy night,
2018,Winter,08:00:00 PM,165,137,28,partly cloudy night,
2018,Spring,03:00:00 PM,2123,1019,1104,clear day,
2018,Winter,04:00:00 AM,2,0,2,partly cloudy night,
2018,Spring,09:00:00 AM,323,178,145,clear day,
2018,Spring,05:00:00 AM,18,10,8,clear night,
2018,Winter,05:00:00 PM,1423,857,566,clear day,
2018,Winter,07:00:00 PM,48,46,2,rain,
2018,Summer,11:00:00 AM,1764,839,925,clear day,
2018,Winter,01:00:00 AM,1,0,1,partly cloudy night,
2018,Winter,12:00:00 PM,1100,501,599,partly cloudy day,
2018,Spring,11:00:00 AM,1027,482,545,partly cloudy day,
2018,Summer,08:00:00 PM,755,344,411,partly cloudy day,
2018,Spring,03:00:00 PM,2878,1299,1579,clear day,
2018,Spring,06:00:00 AM,74,62,12,partly cloudy night,Easter Sunday
2018,Summer,02:00:00 AM,11,6,5,cloudy,
2018,Spring,02:00:00 AM,18,12,6,clear night,
2018,Spring,10:00:00 PM,58,23,35,clear night,
2018,Spring,08:00:00 AM,199,78,121,clear day,
2018,Summer,07:00:00 AM,113,56,57,partly cloudy day,
2018,Spring,10:00:00 PM,178,96,82,partly cloudy night,
2018,Spring,05:00:00 AM,3,1,2,clear night,St. Patrick's Day
2018,Summer,07:00:00 PM,1393,753,640,partly cloudy day,
2018,Spring,03:00:00 AM,3,2,1,partly cloudy night,
2018,Spring,04:00:00 AM,1,0,1,partly cloudy night,
2018,Spring,01:00:00 AM,5,2,3,partly cloudy night,
2018,Spring,09:00:00 PM,196,110,86,clear night,
2018,Spring,02:00:00 AM,4,0,4,partly cloudy night,
2018,Spring,11:00:00 PM,155,71,84,clear night,
2018,Spring,09:00:00 PM,278,130,148,partly cloudy night,
2018,Spring,10:00:00 AM,1719,1015,704,clear day,
2018,Spring,08:00:00 AM,382,218,164,clear day,
2018,Spring,08:00:00 AM,205,99,106,clear day,
2018,Spring,03:00:00 PM,1538,696,842,clear day,
2018,Spring,09:00:00 PM,505,229,276,clear night,
2018,Spring,01:00:00 AM,72,41,31,clear night,
2018,Spring,10:00:00 PM,194,84,110,partly cloudy night,
2018,Spring,11:00:00 PM,87,75,12,partly cloudy night,
2018,Spring,10:00:00 AM,989,569,420,partly cloudy day,
2018,Spring,09:00:00 PM,107,50,57,partly cloudy night,
2018,Winter,12:00:00 PM,370,178,192,rain,
2018,Summer,01:00:00 AM,15,9,6,cloudy,
2018,Winter,07:00:00 AM,136,52,84,clear day,
2018,Spring,02:00:00 AM,2,1,1,clear night,
2018,Spring,02:00:00 PM,564,264,300,rain,
2018,Spring,02:00:00 PM,2523,1181,1342,clear day,
2018,Summer,11:00:00 PM,274,114,160,partly cloudy night,
2018,Winter,01:00:00 PM,1013,524,489,partly cloudy day,
2018,Winter,07:00:00 PM,580,323,257,clear night,
2018,Spring,02:00:00 AM,10,8,2,cloudy,Mother's Day
2018,Summer,11:00:00 AM,1703,867,836,partly cloudy day,
2018,Winter,07:00:00 AM,98,48,50,partly cloudy day,
2018,Spring,09:00:00 PM,240,169,71,partly cloudy night,
2018,Spring,06:00:00 AM,22,10,12,partly cloudy night,
2018,Spring,09:00:00 AM,239,132,107,partly cloudy day,
2018,Spring,11:00:00 PM,131,39,92,cloudy,Memorial Day
2018,Summer,08:00:00 AM,472,177,295,partly cloudy day,
2018,Spring,09:00:00 PM,529,253,276,clear night,
2018,Spring,09:00:00 AM,557,302,255,clear day,
2018,Spring,11:00:00 AM,1859,994,865,partly cloudy day,
2018,Spring,09:00:00 AM,14,5,9,rain,
2018,Spring,01:00:00 AM,6,2,4,partly cloudy night,
2018,Spring,02:00:00 PM,1323,600,723,cloudy,
2018,Winter,06:00:00 PM,811,404,407,clear night,
2018,Spring,08:00:00 PM,495,246,249,partly cloudy night,
2018,Spring,11:00:00 AM,583,349,234,partly cloudy day,
2018,Spring,12:00:00 AM,42,21,21,clear night,
2018,Spring,12:00:00 PM,2022,942,1080,partly cloudy day,
2018,Spring,07:00:00 PM,296,163,133,rain,
2018,Spring,11:00:00 PM,53,36,17,clear night,
2018,Winter,11:00:00 AM,1605,818,787,partly cloudy day,
2018,Spring,06:00:00 PM,1919,819,1100,clear day,
2018,Spring,05:00:00 AM,2,1,1,cloudy,
2018,Spring,04:00:00 PM,2079,1050,1029,clear day,
2018,Spring,07:00:00 AM,261,103,158,partly cloudy day,
2018,Winter,04:00:00 PM,1952,997,955,clear day,
2018,Summer,11:00:00 AM,1748,973,775,clear day,
2018,Spring,02:00:00 PM,2258,1029,1229,partly cloudy day,
2018,Spring,11:00:00 AM,1681,880,801,partly cloudy day,
2018,Spring,11:00:00 PM,71,58,13,partly cloudy night,Mother's Day
2018,Spring,02:00:00 PM,1951,919,1032,clear day,
2018,Spring,02:00:00 AM,11,6,5,partly cloudy night,
2018,Spring,11:00:00 AM,1199,525,674,partly cloudy day,
2018,Spring,08:00:00 PM,280,122,158,partly cloudy night,
2018,Spring,05:00:00 AM,59,38,21,clear night,
2018,Spring,12:00:00 AM,107,99,8,clear night,St. Patrick's Day
2018,Spring,12:00:00 PM,1838,835,1003,cloudy,
2018,Spring,02:00:00 PM,1841,724,1117,clear day,
2018,Spring,01:00:00 AM,3,2,1,partly cloudy night,
2018,Spring,12:00:00 PM,1931,930,1001,clear day,Daylight Saving Time starts
2018,Summer,04:00:00 AM,9,2,7,partly cloudy night,
2018,Spring,12:00:00 PM,2517,1116,1401,clear day,
2018,Spring,06:00:00 AM,100,42,58,partly cloudy day,
2018,Spring,01:00:00 PM,1945,893,1052,clear day,
2018,Spring,01:00:00 PM,774,358,416,partly cloudy day,
2018,Spring,07:00:00 AM,222,83,139,clear day,
2018,Spring,12:00:00 AM,11,5,6,clear night,
2018,Spring,10:00:00 PM,124,62,62,partly cloudy night,
2018,Spring,10:00:00 AM,762,511,251,rain,
2018,Spring,11:00:00 AM,94,48,46,snow,
2018,Winter,03:00:00 PM,733,327,406,partly cloudy day,
2018,Spring,06:00:00 AM,53,27,26,partly cloudy night,
2018,Spring,05:00:00 PM,1239,619,620,partly cloudy day,
2018,Spring,05:00:00 AM,78,51,27,clear night,
2018,Spring,05:00:00 AM,1,0,1,partly cloudy night,
2018,Spring,11:00:00 PM,189,110,79,partly cloudy night,
2018,Spring,01:00:00 PM,1220,520,700,partly cloudy day,
2018,Spring,12:00:00 PM,3050,1498,1552,clear day,
2018,Spring,04:00:00 AM,18,11,7,clear night,Cinco de Mayo
2018,Winter,12:00:00 AM,8,6,2,cloudy,
2018,Spring,08:00:00 PM,207,93,114,clear night,
2018,Spring,01:00:00 AM,39,19,20,clear night,
2018,Spring,06:00:00 PM,2282,1201,1081,clear day,
2018,Spring,08:00:00 AM,273,94,179,clear day,
2018,Spring,01:00:00 AM,15,7,8,clear night,
2018,Winter,08:00:00 AM,218,66,152,partly cloudy day,Valentine's Day
2018,Spring,09:00:00 AM,44,18,26,rain,
2018,Summer,04:00:00 AM,7,6,1,cloudy,
2018,Winter,11:00:00 AM,1273,726,547,partly cloudy day,
2018,Spring,03:00:00 AM,10,4,6,clear night,
2018,Winter,07:00:00 PM,138,95,43,snow,
2018,Spring,09:00:00 AM,861,474,387,clear day,
2018,Winter,04:00:00 PM,750,417,333,rain,
2018,Spring,10:00:00 AM,1001,518,483,clear day,
2018,Summer,02:00:00 PM,2038,923,1115,partly cloudy day,
2018,Summer,05:00:00 PM,1413,600,813,cloudy,
2018,Winter,12:00:00 PM,1031,424,607,clear day,
2018,Spring,12:00:00 AM,18,7,11,clear night,
2018,Spring,01:00:00 AM,23,13,10,clear night,
2018,Spring,01:00:00 PM,1729,755,974,clear day,
2018,Spring,05:00:00 PM,1591,742,849,clear day,
2018,Spring,05:00:00 PM,1854,922,932,clear day,
2018,Spring,08:00:00 PM,503,181,322,clear night,
2018,Spring,06:00:00 PM,1943,998,945,clear day,
2018,Spring,07:00:00 AM,163,70,93,partly cloudy day,
2018,Winter,12:00:00 PM,1988,990,998,clear day,
2018,Spring,02:00:00 PM,2422,1048,1374,partly cloudy day,
2018,Spring,04:00:00 PM,2497,1163,1334,clear day,
2018,Spring,02:00:00 PM,1758,706,1052,partly cloudy day,
2018,Winter,11:00:00 AM,1149,541,608,partly cloudy day,Valentine's Day
2018,Spring,11:00:00 PM,50,31,19,partly cloudy night,Tax Day
2018,Spring,09:00:00 PM,228,99,129,clear night,
2018,Summer,04:00:00 PM,2284,1065,1219,partly cloudy day,
2018,Spring,03:00:00 PM,1709,814,895,clear day,
2018,Spring,03:00:00 AM,9,4,5,cloudy,
2018,Spring,09:00:00 AM,513,355,158,clear day,
2018,Spring,12:00:00 AM,109,36,73,partly cloudy night,
2018,Winter,04:00:00 AM,3,0,3,partly cloudy night,
2018,Spring,12:00:00 PM,1267,598,669,clear day,
2018,Spring,11:00:00 PM,33,12,21,clear night,
2018,Winter,02:00:00 AM,4,1,3,partly cloudy night,
2018,Summer,12:00:00 AM,169,74,95,clear night,
2018,Spring,09:00:00 PM,708,265,443,clear night,Cinco de Mayo
2018,Winter,07:00:00 AM,126,59,67,partly cloudy day,
2018,Spring,12:00:00 AM,29,17,12,clear night,
2018,Winter,12:00:00 AM,20,10,10,partly cloudy night,
2018,Winter,02:00:00 AM,4,2,2,partly cloudy night,
2018,Winter,09:00:00 AM,294,145,149,clear day,
2018,Spring,06:00:00 AM,50,34,16,cloudy,
2018,Spring,03:00:00 PM,996,472,524,partly cloudy day,
2018,Spring,11:00:00 AM,1013,527,486,clear day,
2018,Winter,12:00:00 AM,16,6,10,partly cloudy night,
2018,Spring,06:00:00 AM,57,29,28,cloudy,Memorial Day
2018,Summer,09:00:00 AM,742,417,325,clear day,
2018,Spring,06:00:00 AM,74,33,41,partly cloudy night,
2018,Winter,12:00:00 PM,718,354,364,partly cloudy day,
2018,Spring,06:00:00 AM,52,29,23,clear night,
2018,Spring,06:00:00 AM,255,113,142,clear day,
2018,Summer,12:00:00 PM,1546,693,853,cloudy,
2018,Spring,11:00:00 AM,1380,674,706,partly cloudy day,
2018,Spring,11:00:00 AM,2508,1282,1226,partly cloudy day,
2018,Spring,03:00:00 AM,2,0,2,clear night,
2018,Spring,02:00:00 PM,2788,1165,1623,partly cloudy day,
2018,Spring,10:00:00 PM,131,77,54,clear night,
2018,Winter,06:00:00 PM,451,279,172,partly cloudy night,
2018,Spring,09:00:00 PM,32,12,20,snow,
2018,Spring,07:00:00 PM,1823,939,884,clear day,
2018,Summer,10:00:00 AM,1126,665,461,partly cloudy day,
2018,Spring,03:00:00 PM,2384,1008,1376,clear day,
2018,Spring,03:00:00 AM,0,0,0,partly cloudy night,
2018,Spring,05:00:00 AM,30,16,14,clear night,
2018,Spring,03:00:00 AM,10,7,3,clear night,
2018,Spring,08:00:00 AM,518,196,322,clear day,
2018,Winter,11:00:00 AM,249,146,103,rain,
2018,Spring,04:00:00 AM,4,2,2,partly cloudy night,
2018,Summer,11:00:00 AM,1558,883,675,cloudy,
2018,Summer,08:00:00 AM,386,159,227,partly cloudy day,
2018,Summer,09:00:00 AM,817,461,356,clear day,
2018,Spring,12:00:00 AM,19,11,8,partly cloudy night,
2018,Spring,10:00:00 AM,1805,1128,677,clear day,
2018,Summer,01:00:00 AM,26,10,16,clear night,
2018,Spring,07:00:00 AM,98,44,54,cloudy,
2018,Spring,11:00:00 PM,179,80,99,clear night,
2018,Spring,09:00:00 AM,738,323,415,clear day,
2018,Spring,09:00:00 AM,1101,649,452,clear day,
2018,Spring,02:00:00 AM,4,1,3,clear night,
2018,Winter,07:00:00 PM,107,79,28,partly cloudy night,
2018,Spring,07:00:00 AM,105,41,64,rain,
2018,Spring,03:00:00 PM,1976,916,1060,partly cloudy day,
2018,Spring,08:00:00 PM,687,273,414,rain,
2018,Spring,04:00:00 AM,4,0,4,clear night,
2018,Spring,09:00:00 AM,460,254,206,clear day,
2018,Spring,02:00:00 PM,1008,467,541,clear day,
2018,Winter,07:00:00 PM,111,82,29,partly cloudy night,
2018,Winter,04:00:00 AM,2,1,1,clear night,
2018,Spring,09:00:00 AM,328,173,155,clear day,
2018,Spring,02:00:00 AM,41,22,19,clear night,
2018,Spring,04:00:00 AM,3,2,1,cloudy,
2018,Summer,07:00:00 PM,2084,921,1163,clear day,
2018,Spring,04:00:00 AM,3,1,2,clear night,
2018,Spring,03:00:00 PM,2251,972,1279,cloudy,
2018,Summer,01:00:00 AM,36,16,20,cloudy,
2018,Spring,04:00:00 PM,1685,785,900,clear day,
2018,Spring,09:00:00 AM,433,227,206,partly cloudy day,
2018,Spring,04:00:00 PM,1652,757,895,partly cloudy day,
2018,Spring,01:00:00 PM,2898,1415,1483,clear day,
2018,Spring,12:00:00 AM,65,26,39,cloudy,
2018,Winter,09:00:00 PM,199,148,51,clear night,
2018,Spring,10:00:00 AM,252,128,124,rain,
2018,Spring,05:00:00 AM,13,10,3,clear night,
2018,Spring,04:00:00 PM,1700,872,828,partly cloudy day,
2018,Spring,10:00:00 PM,125,43,82,partly cloudy night,
2018,Winter,03:00:00 PM,1747,811,936,clear day,
2018,Winter,04:00:00 PM,1144,623,521,clear day,
2018,Summer,11:00:00 PM,151,79,72,clear night,
2018,Spring,08:00:00 AM,357,232,125,partly cloudy day,
2018,Spring,05:00:00 AM,0,0,0,rain,
2018,Spring,06:00:00 AM,49,26,23,partly cloudy night,
2018,Spring,01:00:00 PM,2003,917,1086,partly cloudy day,
2018,Spring,03:00:00 AM,1,0,1,clear night,
2018,Spring,07:00:00 AM,136,55,81,clear day,
2018,Spring,01:00:00 AM,21,10,11,partly cloudy night,
2018,Winter,06:00:00 PM,452,277,175,clear night,
2018,Winter,08:00:00 AM,39,20,19,rain,
2018,Spring,02:00:00 AM,20,11,9,clear night,
2018,Winter,05:00:00 PM,709,374,335,partly cloudy day,
2018,Spring,09:00:00 PM,166,74,92,partly cloudy night,
2018,Spring,10:00:00 PM,63,35,28,clear night,
2018,Spring,02:00:00 AM,2,0,2,snow,
2018,Spring,06:00:00 AM,37,22,15,clear night,
2018,Summer,12:00:00 AM,54,20,34,cloudy,
2018,Spring,02:00:00 PM,2134,969,1165,clear day,
2018,Spring,11:00:00 PM,46,40,6,rain,
2018,Summer,01:00:00 AM,29,14,15,clear night,
2018,Spring,06:00:00 PM,33,31,2,rain,
2018,Winter,01:00:00 PM,1224,583,641,partly cloudy day,
2018,Spring,09:00:00 PM,486,186,300,cloudy,
2018,Spring,07:00:00 PM,1389,693,696,partly cloudy day,
2018,Spring,04:00:00 AM,5,4,1,clear night,
2018,Spring,09:00:00 PM,357,113,244,clear night,Easter Sunday
2018,Winter,07:00:00 AM,109,45,64,clear day,Presidents' Day (regional holiday)
2018,Winter,04:00:00 AM,1,1,0,partly cloudy night,
2018,Spring,09:00:00 AM,642,344,298,partly cloudy day,
2018,Spring,06:00:00 AM,51,32,19,cloudy,Mother's Day
2018,Spring,06:00:00 PM,1839,832,1007,clear day,
2018,Summer,03:00:00 PM,2398,1111,1287,partly cloudy day,
2018,Spring,11:00:00 AM,1022,495,527,clear day,
2018,Spring,01:00:00 AM,24,14,10,partly cloudy night,
2018,Spring,09:00:00 PM,216,93,123,partly cloudy night,
2018,Spring,06:00:00 AM,167,92,75,clear day,
2018,Spring,03:00:00 PM,1181,503,678,partly cloudy day,
2018,Winter,08:00:00 PM,98,60,38,partly cloudy night,Presidents' Day (regional holiday)
2018,Spring,11:00:00 AM,944,408,536,partly cloudy day,
2018,Winter,02:00:00 AM,4,2,2,clear night,
2018,Summer,08:00:00 PM,1035,470,565,partly cloudy day,
2018,Spring,09:00:00 AM,424,281,143,clear day,St. Patrick's Day
2018,Winter,03:00:00 AM,0,0,0,partly cloudy night,
2018,Spring,06:00:00 AM,56,34,22,clear night,
2018,Spring,08:00:00 AM,357,237,120,clear day,Daylight Saving Time starts
2018,Spring,09:00:00 PM,123,50,73,clear night,Daylight Saving Time starts
2018,Spring,04:00:00 PM,1096,571,525,partly cloudy day,
2018,Spring,03:00:00 PM,2150,931,1219,clear day,
2018,Winter,03:00:00 AM,3,1,2,clear night,
2018,Winter,02:00:00 AM,7,6,1,rain,
2018,Spring,06:00:00 PM,494,282,212,partly cloudy day,
2018,Summer,03:00:00 PM,2102,975,1127,clear day,
2018,Spring,06:00:00 PM,2418,1074,1344,partly cloudy day,
2018,Spring,12:00:00 AM,44,18,26,partly cloudy night,
2018,Spring,10:00:00 PM,174,95,79,clear night,
2018,Spring,12:00:00 PM,870,357,513,partly cloudy day,
2018,Spring,09:00:00 AM,359,211,148,partly cloudy day,
2018,Spring,09:00:00 PM,299,130,169,clear night,
2018,Spring,11:00:00 PM,141,112,29,clear night,
2018,Spring,07:00:00 PM,1643,882,761,clear day,
2018,Winter,01:00:00 AM,3,0,3,clear night,
2018,Winter,10:00:00 PM,127,52,75,clear night,
2018,Spring,05:00:00 PM,1391,603,788,partly cloudy day,
2018,Winter,06:00:00 AM,123,74,49,clear night,
2018,Spring,08:00:00 PM,466,237,229,clear night,
2018,Spring,07:00:00 PM,644,303,341,partly cloudy day,
2018,Spring,05:00:00 AM,28,14,14,clear night,
2018,Spring,04:00:00 PM,1295,636,659,partly cloudy day,
2018,Spring,04:00:00 AM,8,6,2,cloudy,
2018,Spring,07:00:00 PM,319,158,161,partly cloudy night,
2018,Spring,05:00:00 AM,21,16,5,clear night,
2018,Winter,04:00:00 PM,69,41,28,rain,
2018,Summer,08:00:00 AM,188,72,116,cloudy,
2018,Spring,03:00:00 PM,1480,639,841,partly cloudy day,
2018,Spring,05:00:00 PM,1462,722,740,partly cloudy day,
2018,Spring,06:00:00 PM,708,405,303,cloudy,
2018,Spring,10:00:00 PM,152,75,77,partly cloudy night,
2018,Spring,06:00:00 PM,1120,601,519,clear day,
2018,Winter,08:00:00 AM,204,96,108,clear day,
2018,Winter,07:00:00 PM,229,153,76,clear night,
2018,Spring,03:00:00 PM,202,117,85,snow,
2018,Spring,09:00:00 AM,82,37,45,partly cloudy day,
2018,Spring,10:00:00 PM,579,238,341,clear night,
2018,Spring,10:00:00 AM,871,534,337,clear day,
2018,Winter,07:00:00 PM,296,207,89,clear night,
2018,Summer,02:00:00 AM,38,20,18,clear night,
2018,Spring,04:00:00 AM,5,4,1,clear night,
2018,Spring,12:00:00 AM,48,26,22,partly cloudy night,
2018,Spring,05:00:00 AM,13,6,7,clear night,
2018,Spring,02:00:00 AM,6,3,3,partly cloudy night,
2018,Winter,07:00:00 AM,22,11,11,rain,
2018,Spring,09:00:00 PM,570,185,385,clear night,
2018,Spring,04:00:00 PM,1886,875,1011,clear day,
2018,Spring,09:00:00 AM,443,198,245,fog,
2018,Spring,12:00:00 PM,1211,557,654,clear day,
2018,Spring,09:00:00 AM,719,365,354,partly cloudy day,
2018,Spring,12:00:00 AM,28,19,9,clear night,
2018,Winter,07:00:00 AM,105,38,67,cloudy,
2018,Spring,12:00:00 PM,1555,735,820,clear day,St. Patrick's Day
2018,Winter,12:00:00 AM,17,9,8,clear night,
2018,Spring,07:00:00 AM,181,70,111,clear day,
2018,Spring,08:00:00 AM,475,235,240,clear day,Cinco de Mayo
2018,Spring,09:00:00 PM,321,128,193,partly cloudy night,
2018,Spring,10:00:00 PM,268,186,82,clear night,
2018,Spring,09:00:00 PM,751,310,441,clear night,
2018,Winter,04:00:00 PM,2586,1259,1327,clear day,
2018,Spring,04:00:00 PM,3469,1532,1937,clear day,
2018,Spring,09:00:00 PM,766,338,428,clear night,
2018,Spring,10:00:00 PM,363,179,184,clear night,
2018,Spring,07:00:00 PM,554,248,306,clear night,
2018,Spring,05:00:00 AM,24,15,9,partly cloudy night,
2018,Spring,08:00:00 PM,3,2,1,sleet,
2018,Spring,03:00:00 PM,2102,1017,1085,cloudy,
2018,Spring,11:00:00 PM,198,74,124,clear night,
2018,Spring,01:00:00 AM,13,7,6,clear night,
2018,Spring,04:00:00 PM,1878,808,1070,partly cloudy day,
2018,Spring,05:00:00 AM,43,36,7,partly cloudy night,
2018,Summer,02:00:00 PM,3171,1066,2105,clear day,
2018,Spring,02:00:00 AM,3,0,3,cloudy,
2018,Spring,08:00:00 AM,344,131,213,cloudy,
2018,Spring,08:00:00 PM,232,154,78,fog,
2018,Summer,11:00:00 AM,1589,784,805,clear day,
2018,Spring,11:00:00 AM,1692,824,868,clear day,
2018,Spring,09:00:00 AM,672,349,323,partly cloudy day,
2018,Spring,08:00:00 PM,325,189,136,partly cloudy night,
2018,Winter,02:00:00 AM,8,6,2,cloudy,
2018,Spring,07:00:00 AM,117,52,65,partly cloudy day,
2018,Summer,07:00:00 PM,1309,563,746,partly cloudy day,
2018,Spring,09:00:00 PM,236,112,124,partly cloudy night,
2018,Spring,01:00:00 AM,76,24,52,partly cloudy night,
2018,Winter,12:00:00 AM,64,57,7,partly cloudy night,
2018,Spring,07:00:00 PM,513,231,282,clear day,
2018,Winter,11:00:00 PM,12,6,6,snow,
2018,Summer,09:00:00 AM,707,299,408,clear day,
2018,Summer,03:00:00 AM,5,4,1,clear night,
2018,Summer,12:00:00 AM,150,92,58,partly cloudy night,
2018,Spring,10:00:00 AM,822,517,305,clear day,
2018,Spring,02:00:00 AM,15,13,2,cloudy,Memorial Day
2018,Spring,05:00:00 PM,2702,1330,1372,clear day,
2018,Spring,08:00:00 AM,308,118,190,partly cloudy day,Tax Day
2018,Summer,08:00:00 PM,698,299,399,partly cloudy day,
2018,Spring,12:00:00 PM,1715,823,892,cloudy,
2018,Winter,03:00:00 AM,2,0,2,clear night,
2018,Spring,10:00:00 PM,46,29,17,partly cloudy night,
2018,Spring,12:00:00 PM,1858,829,1029,partly cloudy day,
2018,Spring,02:00:00 AM,9,4,5,partly cloudy night,
2018,Winter,08:00:00 PM,38,34,4,partly cloudy night,
2018,Winter,08:00:00 AM,227,86,141,clear day,
2018,Spring,02:00:00 AM,1,0,1,partly cloudy night,
2018,Spring,05:00:00 AM,59,35,24,clear night,
2018,Spring,03:00:00 PM,2315,1156,1159,clear day,
2018,Spring,08:00:00 PM,603,225,378,rain,
2018,Spring,01:00:00 PM,1410,640,770,partly cloudy day,Tax Day
2018,Spring,05:00:00 PM,1988,1062,926,clear day,
2018,Spring,07:00:00 AM,219,108,111,partly cloudy day,
2018,Spring,05:00:00 PM,2107,977,1130,partly cloudy day,
2018,Spring,06:00:00 AM,132,52,80,partly cloudy day,
2018,Spring,02:00:00 PM,3209,1494,1715,clear day,
2018,Spring,05:00:00 AM,15,9,6,partly cloudy night,
2018,Spring,01:00:00 PM,1441,710,731,partly cloudy day,
2018,Spring,06:00:00 AM,176,65,111,clear night,
2018,Spring,01:00:00 AM,43,12,31,cloudy,Memorial Day
2018,Winter,10:00:00 AM,936,472,464,partly cloudy day,
2018,Summer,05:00:00 PM,1713,872,841,cloudy,
2018,Spring,12:00:00 AM,55,45,10,clear night,
2018,Winter,03:00:00 PM,1622,875,747,clear day,
2018,Winter,08:00:00 PM,420,266,154,clear night,
2018,Spring,01:00:00 PM,2175,950,1225,clear day,
2018,Spring,01:00:00 PM,3210,1411,1799,partly cloudy day,Memorial Day
2018,Spring,11:00:00 AM,1762,899,863,clear day,
2018,Winter,10:00:00 AM,398,219,179,cloudy,
2018,Winter,05:00:00 PM,840,401,439,clear day,
2018,Spring,07:00:00 AM,139,57,82,clear night,
2018,Spring,10:00:00 AM,521,292,229,clear day,
2018,Winter,11:00:00 AM,1149,633,516,cloudy,
2018,Spring,10:00:00 PM,109,94,15,partly cloudy night,
2018,Winter,11:00:00 PM,31,18,13,partly cloudy night,
2018,Spring,10:00:00 PM,151,49,102,clear night,
2018,Spring,01:00:00 AM,15,4,11,clear night,
2018,Spring,10:00:00 AM,1358,835,523,clear day,
2018,Summer,03:00:00 AM,6,3,3,cloudy,
2018,Spring,06:00:00 AM,42,23,19,rain,
2018,Spring,03:00:00 PM,1759,791,968,cloudy,
2018,Spring,12:00:00 PM,1531,700,831,partly cloudy day,
2018,Winter,08:00:00 AM,213,128,85,partly cloudy day,
2018,Spring,10:00:00 AM,1217,756,461,cloudy,Mother's Day
2018,Spring,09:00:00 PM,242,128,114,rain,
2018,Winter,08:00:00 AM,226,111,115,partly cloudy day,
2018,Spring,12:00:00 PM,2010,969,1041,clear day,
2018,Spring,01:00:00 PM,3539,1703,1836,partly cloudy day,
2018,Spring,05:00:00 PM,2111,1103,1008,clear day,
2018,Spring,10:00:00 PM,260,166,94,clear night,
2018,Spring,07:00:00 AM,167,76,91,clear day,
2018,Spring,12:00:00 PM,699,331,368,partly cloudy day,
2018,Winter,03:00:00 AM,4,3,1,clear night,Presidents' Day (regional holiday)
2018,Spring,06:00:00 AM,17,11,6,cloudy,
2018,Spring,06:00:00 AM,8,6,2,partly cloudy night,
2018,Winter,03:00:00 PM,1165,469,696,partly cloudy day,
2018,Spring,01:00:00 AM,9,2,7,partly cloudy night,
2018,Spring,03:00:00 AM,0,0,0,cloudy,
2018,Spring,07:00:00 PM,417,185,232,rain,
2018,Spring,03:00:00 AM,0,0,0,partly cloudy night,
2018,Spring,02:00:00 PM,3530,1681,1849,partly cloudy day,Memorial Day
2018,Spring,03:00:00 PM,938,532,406,cloudy,
2018,Spring,04:00:00 PM,1339,583,756,partly cloudy day,
2018,Spring,02:00:00 AM,8,7,1,clear night,
2018,Spring,08:00:00 AM,481,174,307,clear day,
2018,Summer,12:00:00 AM,66,40,26,partly cloudy night,
2018,Spring,05:00:00 PM,1755,861,894,cloudy,
2018,Spring,12:00:00 AM,3,2,1,partly cloudy night,
2018,Spring,05:00:00 AM,57,33,24,partly cloudy night,
2018,Winter,12:00:00 AM,29,21,8,fog,
2018,Spring,03:00:00 AM,4,1,3,partly cloudy night,
2018,Spring,08:00:00 PM,337,128,209,clear night,
2018,Spring,02:00:00 PM,2434,1121,1313,partly cloudy day,
2018,Spring,11:00:00 AM,1488,755,733,partly cloudy day,
2018,Spring,07:00:00 PM,637,294,343,partly cloudy day,
2018,Summer,06:00:00 PM,1968,1175,793,clear day,
2018,Spring,05:00:00 PM,2800,1183,1617,partly cloudy day,Easter Sunday
2018,Spring,08:00:00 PM,208,102,106,cloudy,
2018,Spring,09:00:00 PM,530,190,340,cloudy,
2018,Spring,09:00:00 PM,224,114,110,partly cloudy night,
2018,Spring,03:00:00 AM,2,1,1,cloudy,
2018,Winter,05:00:00 PM,1264,637,627,clear day,
2018,Spring,08:00:00 PM,270,193,77,partly cloudy night,
2018,Winter,08:00:00 AM,197,53,144,partly cloudy day,
2018,Spring,12:00:00 PM,885,575,310,cloudy,
2018,Spring,05:00:00 PM,2144,1109,1035,clear day,
2018,Spring,01:00:00 PM,954,366,588,partly cloudy day,
2018,Spring,03:00:00 PM,1363,696,667,rain,
2018,Spring,04:00:00 PM,2017,989,1028,clear day,
2018,Spring,03:00:00 PM,2663,1207,1456,clear day,
2018,Summer,09:00:00 PM,564,223,341,partly cloudy night,
2018,Spring,12:00:00 PM,905,343,562,partly cloudy day,
2018,Spring,05:00:00 AM,20,11,9,fog,
2018,Spring,01:00:00 AM,6,4,2,partly cloudy night,
2018,Spring,08:00:00 AM,182,54,128,partly cloudy day,
2018,Spring,03:00:00 PM,354,210,144,partly cloudy day,
2018,Winter,01:00:00 AM,15,10,5,clear night,Presidents' Day (regional holiday)
2018,Spring,03:00:00 AM,3,2,1,partly cloudy night,
2018,Spring,02:00:00 AM,3,1,2,clear night,
2018,Spring,10:00:00 AM,580,294,286,fog,
2018,Summer,07:00:00 AM,115,63,52,partly cloudy day,
2018,Spring,03:00:00 PM,409,179,230,partly cloudy day,
2018,Spring,02:00:00 AM,21,13,8,clear night,
2018,Spring,08:00:00 AM,265,90,175,clear day,
2018,Spring,02:00:00 PM,2615,1229,1386,clear day,
2018,Spring,03:00:00 AM,4,1,3,cloudy,
2018,Summer,05:00:00 PM,2681,1290,1391,clear day,
2018,Spring,01:00:00 AM,6,3,3,partly cloudy night,
2018,Spring,02:00:00 PM,3831,1846,1985,clear day,
2018,Spring,09:00:00 AM,584,371,213,cloudy,
2018,Spring,03:00:00 AM,3,2,1,clear night,
2018,Spring,04:00:00 PM,1315,601,714,clear day,
2018,Spring,11:00:00 PM,59,28,31,partly cloudy night,
2018,Spring,04:00:00 AM,7,4,3,cloudy,
2018,Spring,02:00:00 PM,39,24,15,rain,
2018,Spring,12:00:00 AM,60,28,32,clear night,
2018,Spring,10:00:00 PM,170,141,29,partly cloudy night,
2018,Winter,11:00:00 AM,354,219,135,rain,
2018,Spring,01:00:00 PM,2331,1077,1254,partly cloudy day,
2018,Summer,12:00:00 AM,150,74,76,partly cloudy night,
2018,Spring,10:00:00 AM,333,247,86,snow,
2018,Spring,12:00:00 AM,63,38,25,clear night,
2018,Spring,06:00:00 AM,85,37,48,partly cloudy day,
2018,Spring,01:00:00 AM,0,0,0,rain,
2018,Spring,12:00:00 PM,650,370,280,rain,
2018,Summer,12:00:00 PM,1886,948,938,partly cloudy day,
2018,Spring,10:00:00 AM,1759,1016,743,clear day,Cinco de Mayo
2018,Spring,10:00:00 PM,132,65,67,partly cloudy night,
2018,Spring,05:00:00 AM,23,19,4,partly cloudy night,
2018,Spring,05:00:00 PM,1873,786,1087,cloudy,
2018,Spring,09:00:00 PM,104,68,36,partly cloudy night,
2018,Spring,12:00:00 AM,61,37,24,cloudy,
2018,Spring,07:00:00 PM,730,297,433,partly cloudy day,
2018,Spring,12:00:00 PM,1855,850,1005,partly cloudy day,
2018,Spring,01:00:00 AM,3,2,1,partly cloudy night,
2018,Spring,10:00:00 PM,126,59,67,clear night,
2018,Winter,12:00:00 PM,912,400,512,clear day,
2018,Spring,12:00:00 PM,2847,1304,1543,partly cloudy day,
2018,Spring,05:00:00 PM,1580,668,912,partly cloudy day,
2018,Spring,08:00:00 AM,80,28,52,partly cloudy day,
2018,Winter,01:00:00 AM,7,2,5,partly cloudy night,
2018,Spring,02:00:00 AM,8,4,4,partly cloudy night,
2018,Winter,08:00:00 AM,299,116,183,partly cloudy day,
2018,Spring,03:00:00 PM,1515,798,717,clear day,
2018,Spring,07:00:00 PM,973,366,607,clear day,St. Patrick's Day
2018,Spring,01:00:00 PM,2707,1282,1425,clear day,
2018,Winter,03:00:00 AM,5,0,5,partly cloudy night,
2018,Spring,04:00:00 PM,2901,1297,1604,clear day,
2018,Spring,03:00:00 PM,923,370,553,wind,
2018,Spring,10:00:00 PM,182,73,109,clear night,
2018,Summer,01:00:00 AM,10,7,3,cloudy,
2018,Summer,05:00:00 AM,9,5,4,cloudy,
2018,Summer,10:00:00 PM,343,149,194,partly cloudy night,
2018,Spring,11:00:00 AM,1720,860,860,clear day,
2018,Spring,01:00:00 AM,1,0,1,clear night,
2018,Spring,05:00:00 PM,1874,977,897,clear day,
2018,Spring,02:00:00 PM,1390,536,854,partly cloudy day,Tax Day
2018,Spring,03:00:00 PM,870,395,475,partly cloudy day,
2018,Summer,12:00:00 PM,1762,814,948,cloudy,
2018,Winter,03:00:00 AM,1,0,1,partly cloudy night,
2018,Winter,03:00:00 PM,785,364,421,partly cloudy day,
2018,Winter,08:00:00 PM,346,228,118,clear night,
2018,Spring,05:00:00 AM,9,5,4,clear night,
2018,Spring,08:00:00 PM,131,94,37,partly cloudy night,
2018,Summer,01:00:00 PM,1788,780,1008,partly cloudy day,
2018,Spring,10:00:00 AM,1361,777,584,clear day,
2018,Summer,12:00:00 AM,162,99,63,clear night,
2018,Spring,01:00:00 AM,16,11,5,partly cloudy night,
2018,Spring,01:00:00 PM,22,8,14,rain,
2018,Summer,05:00:00 PM,2063,885,1178,partly cloudy day,
2018,Winter,12:00:00 AM,61,59,2,partly cloudy night,
2018,Winter,06:00:00 PM,268,147,121,cloudy,
2018,Summer,08:00:00 AM,247,129,118,cloudy,
2018,Winter,08:00:00 PM,205,171,34,clear night,
2018,Spring,11:00:00 AM,1869,905,964,partly cloudy day,
2018,Spring,01:00:00 PM,374,197,177,rain,
2018,Spring,05:00:00 PM,2324,1183,1141,clear day,
2018,Spring,08:00:00 PM,280,143,137,partly cloudy night,
2018,Spring,05:00:00 PM,1543,767,776,partly cloudy day,
2018,Spring,08:00:00 AM,185,106,79,clear day,
2018,Spring,10:00:00 AM,1083,619,464,clear day,
2018,Summer,10:00:00 AM,797,435,362,cloudy,
2018,Summer,08:00:00 PM,1061,473,588,partly cloudy day,
2018,Spring,09:00:00 PM,511,230,281,clear night,
2018,Spring,12:00:00 PM,1283,634,649,partly cloudy day,
2018,Spring,06:00:00 AM,48,29,19,clear night,
2018,Spring,01:00:00 AM,23,13,10,partly cloudy night,
2018,Spring,06:00:00 AM,109,65,44,clear night,
2018,Spring,10:00:00 PM,137,46,91,clear night,
2018,Summer,09:00:00 PM,458,172,286,cloudy,
2018,Winter,11:00:00 AM,964,520,444,partly cloudy day,
2018,Winter,10:00:00 AM,1320,751,569,clear day,
2018,Winter,04:00:00 PM,1173,626,547,partly cloudy day,Valentine's Day
2018,Spring,04:00:00 PM,2689,1119,1570,clear day,
2018,Spring,11:00:00 AM,1975,982,993,partly cloudy day,
2018,Spring,04:00:00 AM,2,1,1,partly cloudy night,
2018,Spring,11:00:00 AM,1976,904,1072,clear day,
2018,Spring,11:00:00 PM,58,32,26,cloudy,
2018,Spring,09:00:00 PM,374,185,189,clear night,
2018,Spring,06:00:00 PM,2964,1064,1900,clear day,
2018,Winter,07:00:00 PM,75,53,22,rain,
2018,Spring,01:00:00 AM,6,1,5,cloudy,
2018,Spring,05:00:00 AM,2,1,1,partly cloudy night,
2018,Spring,08:00:00 AM,48,28,20,rain,
2018,Spring,01:00:00 AM,20,16,4,clear night,
2018,Spring,08:00:00 PM,480,233,247,partly cloudy night,
2018,Spring,06:00:00 AM,177,81,96,partly cloudy night,
2018,Winter,04:00:00 AM,4,1,3,partly cloudy night,
2018,Summer,11:00:00 AM,2099,1167,932,clear day,
2018,Spring,05:00:00 AM,10,7,3,clear night,
2018,Spring,11:00:00 PM,80,38,42,partly cloudy night,
2018,Winter,04:00:00 AM,4,3,1,cloudy,
2018,Winter,05:00:00 AM,20,10,10,clear night,
2018,Spring,08:00:00 PM,328,179,149,partly cloudy night,
2018,Spring,06:00:00 AM,10,7,3,rain,
2018,Winter,12:00:00 PM,1177,554,623,clear day,
2018,Summer,06:00:00 AM,183,85,98,clear day,
2018,Spring,09:00:00 AM,910,585,325,partly cloudy day,Memorial Day
2018,Spring,06:00:00 PM,867,461,406,partly cloudy day,
2018,Winter,04:00:00 PM,1104,553,551,partly cloudy day,
2018,Spring,06:00:00 AM,138,65,73,cloudy,
2018,Winter,03:00:00 AM,7,5,2,partly cloudy night,
2018,Winter,12:00:00 PM,1112,481,631,clear day,
2018,Summer,03:00:00 PM,1745,854,891,partly cloudy day,
2018,Summer,09:00:00 PM,757,246,511,partly cloudy night,
2018,Spring,12:00:00 AM,9,4,5,partly cloudy night,
2018,Spring,06:00:00 PM,2410,980,1430,clear day,
2018,Summer,09:00:00 AM,572,292,280,clear day,
2018,Spring,06:00:00 AM,50,39,11,clear night,
2018,Spring,03:00:00 PM,1884,879,1005,clear day,
2018,Spring,02:00:00 AM,8,5,3,clear night,Easter Sunday
2018,Spring,11:00:00 AM,1984,1119,865,clear day,
2018,Spring,06:00:00 PM,501,289,212,cloudy,
2018,Spring,07:00:00 AM,60,31,29,partly cloudy day,
2018,Spring,05:00:00 PM,1738,911,827,clear day,St. Patrick's Day
2018,Spring,09:00:00 PM,398,189,209,clear night,
2018,Spring,05:00:00 PM,1275,681,594,cloudy,
2018,Spring,04:00:00 PM,1152,570,582,partly cloudy day,
2018,Winter,09:00:00 PM,132,75,57,clear night,
2018,Spring,11:00:00 AM,2035,1068,967,partly cloudy day,
2018,Spring,06:00:00 AM,106,53,53,clear night,
2018,Spring,08:00:00 PM,496,282,214,cloudy,Mother's Day
2018,Winter,04:00:00 PM,885,467,418,cloudy,
2018,Spring,11:00:00 PM,133,73,60,cloudy,
2018,Spring,09:00:00 PM,215,86,129,clear night,
2018,Spring,08:00:00 AM,534,194,340,clear day,
2018,Spring,06:00:00 AM,82,36,46,clear night,
2018,Spring,08:00:00 PM,1456,546,910,clear day,
2018,Spring,10:00:00 PM,85,57,28,cloudy,
2018,Spring,04:00:00 PM,1089,544,545,snow,
2018,Spring,06:00:00 AM,118,46,72,partly cloudy night,
2018,Spring,05:00:00 PM,1431,679,752,clear day,
2018,Spring,04:00:00 AM,2,1,1,partly cloudy night,
2018,Spring,02:00:00 AM,7,3,4,clear night,
2018,Winter,03:00:00 AM,2,0,2,partly cloudy night,Valentine's Day
2018,Spring,11:00:00 PM,105,78,27,partly cloudy night,
2018,Spring,08:00:00 AM,363,133,230,cloudy,
2018,Summer,10:00:00 PM,493,204,289,clear night,
2018,Spring,09:00:00 AM,105,42,63,partly cloudy day,
2018,Spring,07:00:00 PM,755,366,389,cloudy,
2018,Winter,09:00:00 AM,297,153,144,clear day,
2018,Spring,04:00:00 AM,3,1,2,clear night,
2018,Spring,02:00:00 PM,2032,945,1087,clear day,
2018,Spring,11:00:00 PM,166,78,88,partly cloudy night,
2018,Spring,03:00:00 AM,2,0,2,clear night,
2018,Spring,11:00:00 PM,28,13,15,cloudy,
2018,Spring,02:00:00 AM,25,19,6,partly cloudy night,
2018,Summer,04:00:00 PM,1838,896,942,cloudy,
2018,Spring,03:00:00 PM,1064,510,554,rain,Mother's Day
2018,Spring,04:00:00 PM,1385,654,731,partly cloudy day,
2018,Spring,06:00:00 PM,904,486,418,partly cloudy day,
2018,Winter,09:00:00 AM,354,177,177,cloudy,
2018,Summer,09:00:00 AM,717,391,326,clear day,
2018,Spring,05:00:00 AM,9,3,6,clear night,
2018,Spring,07:00:00 PM,1375,649,726,clear day,
2018,Spring,02:00:00 PM,1770,885,885,partly cloudy day,
2018,Spring,04:00:00 AM,4,2,2,clear night,
2018,Spring,07:00:00 PM,1052,497,555,clear day,
2018,Spring,08:00:00 AM,606,189,417,clear day,
2018,Spring,07:00:00 PM,2509,1184,1325,clear day,
2018,Spring,04:00:00 PM,1288,650,638,cloudy,
2018,Spring,07:00:00 AM,184,69,115,cloudy,
2018,Summer,09:00:00 AM,447,244,203,rain,
2018,Spring,08:00:00 AM,308,172,136,clear day,
2018,Spring,04:00:00 AM,3,0,3,partly cloudy night,
2018,Summer,04:00:00 AM,20,10,10,partly cloudy night,
2018,Spring,05:00:00 AM,7,2,5,clear night,
2018,Summer,04:00:00 PM,2276,1155,1121,clear day,
2018,Spring,07:00:00 AM,78,46,32,partly cloudy day,
2018,Spring,05:00:00 AM,12,9,3,partly cloudy night,
2018,Spring,12:00:00 AM,158,80,78,clear night,
2018,Spring,07:00:00 AM,230,83,147,partly cloudy day,
2018,Spring,03:00:00 PM,3756,1848,1908,clear day,
2018,Spring,08:00:00 PM,939,414,525,clear day,
2018,Spring,07:00:00 AM,153,63,90,partly cloudy day,Easter Sunday
2018,Spring,01:00:00 PM,907,399,508,clear day,
2018,Spring,06:00:00 AM,75,34,41,partly cloudy night,
2018,Spring,04:00:00 AM,4,1,3,clear night,
2018,Spring,08:00:00 PM,1081,444,637,cloudy,Memorial Day
2018,Spring,02:00:00 AM,9,2,7,clear night,St. Patrick's Day
2018,Spring,10:00:00 PM,167,117,50,partly cloudy night,
2018,Summer,01:00:00 PM,2591,1236,1355,clear day,
2018,Spring,06:00:00 PM,349,193,156,fog,
2018,Spring,03:00:00 AM,3,0,3,clear night,
2018,Spring,06:00:00 PM,795,427,368,partly cloudy day,Tax Day
2018,Spring,04:00:00 AM,0,0,0,clear night,St. Patrick's Day
2018,Winter,02:00:00 PM,1442,753,689,clear day,
2018,Spring,08:00:00 AM,338,155,183,cloudy,
2018,Spring,06:00:00 PM,1594,860,734,partly cloudy day,
2018,Spring,03:00:00 PM,2033,868,1165,cloudy,
2018,Spring,04:00:00 AM,7,5,2,partly cloudy night,
2018,Spring,02:00:00 PM,1634,669,965,clear day,
2018,Winter,08:00:00 AM,168,92,76,clear day,
2018,Spring,01:00:00 PM,2054,953,1101,partly cloudy day,
2018,Spring,10:00:00 PM,167,60,107,clear night,Easter Sunday
2018,Spring,09:00:00 AM,363,187,176,clear day,
2018,Spring,11:00:00 AM,1747,903,844,clear day,
2018,Spring,05:00:00 AM,4,2,2,clear night,
2018,Spring,07:00:00 PM,50,15,35,partly cloudy day,
2018,Summer,12:00:00 AM,3,2,1,rain,
2018,Spring,08:00:00 AM,386,190,196,clear day,
2018,Summer,10:00:00 PM,76,23,53,partly cloudy night,
2018,Spring,11:00:00 AM,2108,1128,980,clear day,
2018,Winter,05:00:00 PM,808,407,401,partly cloudy day,
2018,Spring,08:00:00 PM,858,341,517,clear night,
2018,Spring,08:00:00 AM,52,14,38,rain,
2018,Spring,12:00:00 AM,185,102,83,clear night,Cinco de Mayo
2018,Spring,07:00:00 AM,232,89,143,partly cloudy day,
2018,Spring,11:00:00 AM,1126,545,581,partly cloudy day,
2018,Winter,05:00:00 PM,964,408,556,partly cloudy day,
2018,Spring,07:00:00 AM,38,11,27,partly cloudy night,
2018,Spring,01:00:00 PM,2473,1016,1457,clear day,
2018,Winter,03:00:00 AM,3,2,1,clear night,
2018,Spring,09:00:00 PM,202,106,96,clear night,
2018,Spring,06:00:00 PM,1550,631,919,partly cloudy day,
2018,Spring,11:00:00 AM,1216,528,688,partly cloudy day,
2018,Spring,10:00:00 PM,66,29,37,clear night,
2018,Winter,07:00:00 PM,481,325,156,clear night,
2018,Winter,03:00:00 PM,392,216,176,rain,
2018,Spring,05:00:00 AM,7,5,2,partly cloudy night,
2018,Winter,04:00:00 PM,1242,539,703,partly cloudy day,Presidents' Day (regional holiday)
2018,Summer,04:00:00 PM,2488,1035,1453,partly cloudy day,
2018,Winter,07:00:00 AM,231,106,125,cloudy,
2018,Summer,04:00:00 AM,14,10,4,clear night,
2018,Spring,10:00:00 PM,387,185,202,clear night,
2018,Winter,07:00:00 PM,391,284,107,clear night,
2018,Spring,01:00:00 PM,3149,1462,1687,partly cloudy day,
2018,Spring,06:00:00 PM,1487,810,677,clear day,
2018,Winter,08:00:00 AM,128,28,100,partly cloudy day,
2018,Spring,11:00:00 AM,1183,536,647,partly cloudy day,
2018,Winter,07:00:00 PM,254,181,73,clear night,
2018,Spring,09:00:00 AM,488,285,203,clear day,
2018,Summer,08:00:00 PM,1284,591,693,partly cloudy day,
2018,Spring,07:00:00 AM,226,98,128,clear day,
2018,Winter,06:00:00 PM,1250,580,670,clear night,
2018,Spring,05:00:00 PM,2094,1042,1052,clear day,
2018,Winter,04:00:00 AM,4,3,1,partly cloudy night,
2018,Spring,08:00:00 AM,113,45,68,rain,
2018,Winter,08:00:00 PM,93,84,9,rain,
2018,Summer,04:00:00 AM,11,6,5,partly cloudy night,
2018,Spring,09:00:00 PM,292,140,152,partly cloudy night,
2018,Spring,05:00:00 AM,44,24,20,partly cloudy night,
2018,Spring,11:00:00 PM,193,114,79,clear night,
2018,Spring,12:00:00 PM,1342,643,699,partly cloudy day,
2018,Spring,07:00:00 PM,1264,680,584,clear day,
2018,Spring,12:00:00 PM,89,47,42,partly cloudy day,
2018,Winter,11:00:00 AM,553,313,240,partly cloudy day,
2018,Spring,07:00:00 PM,256,125,131,clear night,
2018,Spring,02:00:00 PM,1370,613,757,partly cloudy day,
2018,Spring,07:00:00 AM,266,114,152,clear day,
2018,Spring,05:00:00 PM,511,277,234,rain,
2018,Winter,12:00:00 AM,4,2,2,clear night,
2018,Spring,12:00:00 PM,1598,725,873,clear day,
2018,Spring,11:00:00 PM,21,11,10,clear night,
2018,Summer,07:00:00 AM,213,101,112,partly cloudy day,
2018,Spring,05:00:00 PM,2956,1239,1717,clear day,Cinco de Mayo
2018,Spring,07:00:00 AM,229,95,134,partly cloudy day,
2018,Spring,07:00:00 PM,125,99,26,rain,
2018,Spring,12:00:00 AM,86,40,46,clear night,
2018,Summer,05:00:00 PM,2094,1004,1090,partly cloudy day,
2018,Spring,06:00:00 PM,1835,615,1220,partly cloudy day,
2018,Winter,09:00:00 AM,322,161,161,partly cloudy day,
2018,Spring,02:00:00 PM,2039,959,1080,clear day,
2018,Winter,04:00:00 AM,4,1,3,clear night,
2018,Spring,11:00:00 PM,32,16,16,clear night,
2018,Summer,05:00:00 AM,153,133,20,clear night,
2018,Spring,04:00:00 AM,3,0,3,clear night,
2018,Spring,10:00:00 AM,46,27,19,rain,
2018,Spring,06:00:00 PM,1907,1188,719,clear day,
2018,Spring,09:00:00 AM,641,335,306,partly cloudy day,
2018,Spring,04:00:00 AM,6,4,2,cloudy,
2018,Summer,03:00:00 AM,12,7,5,fog,
2018,Winter,05:00:00 PM,1233,651,582,clear day,
2018,Summer,01:00:00 PM,1900,806,1094,partly cloudy day,
2018,Winter,03:00:00 AM,8,4,4,clear night,
2018,Winter,12:00:00 AM,151,146,5,clear night,
2018,Winter,11:00:00 AM,169,83,86,snow,
2018,Spring,03:00:00 AM,0,0,0,partly cloudy night,
2018,Winter,07:00:00 PM,574,326,248,clear night,
2018,Winter,08:00:00 PM,325,232,93,clear night,Valentine's Day
2018,Winter,07:00:00 AM,149,64,85,partly cloudy day,
2018,Summer,09:00:00 AM,648,261,387,cloudy,
2018,Spring,12:00:00 AM,45,15,30,partly cloudy night,
2018,Spring,02:00:00 AM,2,1,1,partly cloudy night,
2018,Winter,02:00:00 AM,7,4,3,cloudy,
2018,Winter,07:00:00 AM,157,64,93,clear day,
2018,Spring,09:00:00 AM,997,679,318,clear day,
2018,Spring,02:00:00 AM,4,1,3,clear night,
2018,Winter,04:00:00 PM,1221,579,642,clear day,
2018,Spring,08:00:00 PM,200,130,70,partly cloudy night,
2018,Spring,11:00:00 PM,126,67,59,clear night,
2018,Spring,03:00:00 PM,2498,1132,1366,partly cloudy day,
2018,Spring,01:00:00 AM,6,5,1,clear night,
2018,Spring,06:00:00 PM,1153,654,499,partly cloudy day,
2018,Spring,03:00:00 AM,3,3,0,cloudy,Mother's Day
2018,Spring,01:00:00 PM,4210,2062,2148,clear day,
2018,Spring,03:00:00 PM,2244,1045,1199,clear day,
2018,Spring,09:00:00 AM,628,329,299,partly cloudy day,
2018,Spring,03:00:00 AM,2,0,2,clear night,
2018,Spring,03:00:00 AM,2,0,2,partly cloudy night,Tax Day
2018,Spring,06:00:00 PM,1899,1015,884,clear day,
2018,Spring,10:00:00 PM,19,7,12,snow,
2018,Winter,11:00:00 PM,99,90,9,partly cloudy night,
2018,Spring,11:00:00 AM,1946,965,981,cloudy,
2018,Spring,03:00:00 AM,14,6,8,partly cloudy night,
2018,Spring,05:00:00 PM,1978,962,1016,cloudy,
2018,Spring,12:00:00 AM,40,17,23,partly cloudy night,
2018,Spring,01:00:00 PM,1941,830,1111,clear day,
2018,Spring,12:00:00 AM,107,85,22,clear night,
2018,Spring,08:00:00 PM,151,89,62,partly cloudy night,
2018,Winter,09:00:00 AM,252,115,137,partly cloudy day,
2018,Winter,12:00:00 AM,39,18,21,partly cloudy night,
2018,Spring,02:00:00 AM,6,0,6,clear night,
2018,Spring,12:00:00 PM,1202,444,758,clear day,
2018,Spring,06:00:00 AM,19,11,8,cloudy,
2018,Summer,11:00:00 PM,143,61,82,clear night,
2018,Spring,09:00:00 AM,857,512,345,partly cloudy day,
2018,Spring,08:00:00 AM,506,180,326,clear day,
2018,Spring,05:00:00 PM,1712,793,919,clear day,Daylight Saving Time starts
2018,Spring,01:00:00 PM,1208,556,652,partly cloudy day,
2018,Spring,11:00:00 PM,90,46,44,clear night,
2018,Winter,11:00:00 AM,1624,781,843,clear day,Presidents' Day (regional holiday)
2018,Spring,10:00:00 PM,39,27,12,partly cloudy night,
2018,Spring,03:00:00 PM,2797,1251,1546,clear day,
2018,Spring,09:00:00 PM,188,96,92,partly cloudy night,
2018,Spring,02:00:00 PM,3989,2185,1804,clear day,
2018,Spring,12:00:00 PM,1467,753,714,partly cloudy day,
2018,Spring,04:00:00 AM,14,8,6,clear night,
2018,Winter,10:00:00 PM,82,52,30,clear night,
2018,Spring,11:00:00 PM,77,50,27,cloudy,
2018,Spring,05:00:00 AM,11,4,7,partly cloudy night,
2018,Spring,03:00:00 AM,3,2,1,clear night,
2018,Summer,02:00:00 PM,1670,853,817,partly cloudy day,
2018,Spring,08:00:00 AM,490,201,289,clear day,
2018,Spring,03:00:00 AM,6,5,1,partly cloudy night,
2018,Spring,08:00:00 PM,549,286,263,cloudy,
2018,Winter,09:00:00 AM,448,235,213,clear day,
2018,Spring,04:00:00 AM,2,0,2,clear night,
2018,Winter,11:00:00 AM,987,423,564,clear day,
2018,Spring,02:00:00 PM,717,305,412,partly cloudy day,
2018,Spring,09:00:00 PM,190,129,61,partly cloudy night,
2018,Winter,11:00:00 PM,27,8,19,partly cloudy night,
2018,Spring,10:00:00 AM,1057,667,390,partly cloudy day,
2018,Spring,07:00:00 AM,236,107,129,clear day,
2018,Spring,10:00:00 PM,89,62,27,cloudy,
2018,Spring,09:00:00 AM,952,351,601,clear day,
2018,Winter,12:00:00 AM,22,14,8,clear night,
2018,Spring,01:00:00 PM,1517,679,838,clear day,
2018,Spring,01:00:00 PM,462,230,232,rain,
2018,Spring,12:00:00 PM,2414,1150,1264,partly cloudy day,
2018,Spring,07:00:00 AM,219,111,108,clear day,Cinco de Mayo
2018,Summer,03:00:00 AM,12,3,9,cloudy,
2018,Spring,12:00:00 PM,2223,1008,1215,partly cloudy day,
2018,Spring,11:00:00 AM,1752,848,904,clear day,
2018,Spring,03:00:00 AM,7,3,4,cloudy,
2018,Spring,06:00:00 AM,72,56,16,clear night,
2018,Winter,08:00:00 AM,68,33,35,rain,
2018,Spring,11:00:00 PM,109,49,60,partly cloudy night,
2018,Winter,01:00:00 PM,2145,924,1221,clear day,
2018,Spring,05:00:00 AM,2,1,1,partly cloudy night,
2018,Spring,04:00:00 PM,1834,836,998,clear day,
2018,Spring,08:00:00 AM,516,201,315,clear day,
2018,Spring,09:00:00 PM,16,9,7,partly cloudy night,
2018,Spring,11:00:00 AM,2822,1736,1086,clear day,
2018,Spring,03:00:00 PM,1722,765,957,clear day,
2018,Spring,09:00:00 AM,385,213,172,clear day,
2018,Spring,01:00:00 AM,2,1,1,clear night,
2018,Spring,11:00:00 PM,91,78,13,clear night,
2018,Spring,11:00:00 PM,353,179,174,partly cloudy night,
2018,Spring,10:00:00 PM,360,117,243,clear night,
2018,Spring,08:00:00 PM,1081,567,514,cloudy,
2018,Winter,04:00:00 PM,692,319,373,cloudy,
2018,Winter,04:00:00 AM,3,0,3,partly cloudy night,
2018,Spring,10:00:00 PM,73,31,42,partly cloudy night,Tax Day
2018,Spring,09:00:00 AM,445,222,223,partly cloudy day,
2018,Spring,07:00:00 PM,619,322,297,partly cloudy day,
2018,Spring,02:00:00 PM,1253,595,658,partly cloudy day,
2018,Spring,10:00:00 AM,997,565,432,clear day,
2018,Spring,11:00:00 PM,5,4,1,rain,
2018,Spring,08:00:00 PM,1006,401,605,clear night,Cinco de Mayo
2018,Spring,03:00:00 PM,2433,1187,1246,clear day,
2018,Spring,12:00:00 AM,46,19,27,partly cloudy night,
2018,Winter,01:00:00 AM,10,5,5,cloudy,
2018,Spring,06:00:00 PM,969,368,601,clear day,Daylight Saving Time starts
2018,Winter,03:00:00 AM,11,6,5,cloudy,
2018,Winter,01:00:00 PM,780,374,406,partly cloudy day,
2018,Spring,08:00:00 AM,147,72,75,clear day,St. Patrick's Day
2018,Summer,08:00:00 AM,546,276,270,clear day,
2018,Spring,08:00:00 AM,386,170,216,cloudy,
2018,Spring,03:00:00 PM,1496,697,799,partly cloudy day,
2018,Spring,06:00:00 PM,1030,510,520,clear day,
2018,Winter,01:00:00 AM,11,6,5,partly cloudy night,
2018,Spring,08:00:00 PM,275,157,118,clear night,Daylight Saving Time starts
2018,Winter,11:00:00 PM,82,73,9,partly cloudy night,
2018,Spring,08:00:00 PM,1159,501,658,clear day,
2018,Winter,03:00:00 AM,2,0,2,rain,
2018,Spring,06:00:00 AM,48,28,20,partly cloudy night,
2018,Spring,02:00:00 AM,13,8,5,clear night,
2018,Winter,07:00:00 AM,128,58,70,partly cloudy night,
2018,Spring,11:00:00 AM,828,386,442,partly cloudy day,
2018,Spring,04:00:00 AM,0,0,0,fog,
2018,Winter,04:00:00 AM,1,0,1,clear night,
2018,Spring,06:00:00 PM,1913,1096,817,clear day,
2018,Spring,03:00:00 AM,5,3,2,partly cloudy night,Daylight Saving Time starts
2018,Spring,03:00:00 AM,3,1,2,clear night,
2018,Spring,10:00:00 AM,944,590,354,clear day,
2018,Spring,01:00:00 PM,544,238,306,rain,
2018,Spring,01:00:00 PM,2006,835,1171,clear day,
2018,Summer,12:00:00 AM,59,27,32,partly cloudy night,
2018,Winter,10:00:00 PM,164,113,51,cloudy,
2018,Spring,05:00:00 AM,37,23,14,clear night,
2018,Summer,08:00:00 AM,413,189,224,clear day,
2018,Spring,01:00:00 AM,33,11,22,clear night,
2018,Spring,03:00:00 PM,1535,687,848,partly cloudy day,
2018,Winter,11:00:00 PM,33,9,24,clear night,
2018,Spring,05:00:00 PM,2636,1029,1607,partly cloudy day,
2018,Spring,08:00:00 AM,366,212,154,clear day,
2018,Spring,07:00:00 PM,1972,703,1269,clear day,
2018,Spring,04:00:00 PM,1688,800,888,clear day,
2018,Winter,04:00:00 PM,1729,857,872,clear day,
2018,Winter,08:00:00 PM,74,34,40,clear night,
2018,Spring,09:00:00 PM,229,107,122,partly cloudy night,
2018,Spring,06:00:00 PM,199,63,136,cloudy,
2018,Winter,03:00:00 PM,440,214,226,partly cloudy day,
2018,Spring,01:00:00 AM,25,5,20,cloudy,
2018,Spring,11:00:00 PM,36,26,10,clear night,
2018,Spring,11:00:00 AM,2180,1028,1152,clear day,
2018,Spring,04:00:00 AM,0,0,0,partly cloudy night,
2018,Spring,06:00:00 AM,53,29,24,rain,
2018,Winter,10:00:00 AM,464,260,204,clear day,
2018,Spring,09:00:00 AM,485,257,228,partly cloudy day,
2018,Spring,02:00:00 AM,0,0,0,partly cloudy night,
2018,Spring,05:00:00 PM,2092,898,1194,partly cloudy day,
2018,Winter,02:00:00 PM,1661,746,915,clear day,
2018,Spring,04:00:00 AM,0,0,0,rain,
2018,Spring,04:00:00 PM,46,29,17,sleet,
2018,Winter,01:00:00 PM,1089,551,538,clear day,
2018,Spring,09:00:00 PM,982,324,658,clear night,
2018,Summer,04:00:00 PM,1897,737,1160,cloudy,
2018,Winter,06:00:00 PM,300,190,110,partly cloudy night,
2018,Spring,09:00:00 PM,200,103,97,clear night,
2018,Spring,12:00:00 PM,1797,845,952,clear day,
2018,Winter,07:00:00 PM,349,256,93,clear night,
2018,Spring,04:00:00 PM,1937,899,1038,clear day,
2018,Summer,05:00:00 PM,1855,933,922,clear day,
2018,Winter,03:00:00 PM,2526,1417,1109,rain,
2018,Winter,12:00:00 PM,1010,489,521,clear day,
2018,Winter,12:00:00 AM,81,79,2,partly cloudy night,
2018,Winter,03:00:00 AM,4,3,1,partly cloudy night,
2018,Winter,05:00:00 AM,2,0,2,clear night,
2018,Winter,07:00:00 AM,111,47,64,clear day,
2018,Spring,06:00:00 PM,1968,1102,866,partly cloudy day,
2018,Winter,07:00:00 AM,105,47,58,partly cloudy night,
2018,Spring,07:00:00 AM,130,70,60,clear night,
2018,Spring,10:00:00 AM,1143,636,507,clear day,
2018,Spring,10:00:00 PM,82,65,17,rain,
2018,Winter,05:00:00 PM,576,268,308,partly cloudy day,
2018,Spring,08:00:00 PM,418,188,230,clear night,
2018,Spring,07:00:00 PM,1826,696,1130,clear day,
2018,Winter,06:00:00 AM,48,30,18,clear night,Presidents' Day (regional holiday)
2018,Spring,05:00:00 PM,3028,1207,1821,clear day,
2018,Spring,08:00:00 AM,164,91,73,clear day,
2018,Spring,02:00:00 AM,11,9,2,cloudy,
2018,Spring,07:00:00 AM,92,43,49,partly cloudy day,Mother's Day
2018,Spring,03:00:00 AM,7,1,6,partly cloudy night,
2018,Winter,03:00:00 AM,4,3,1,partly cloudy night,
2018,Winter,05:00:00 AM,14,6,8,partly cloudy night,
2018,Winter,11:00:00 PM,53,39,14,fog,Presidents' Day (regional holiday)
2018,Winter,08:00:00 AM,181,65,116,clear day,
2018,Spring,04:00:00 PM,1852,844,1008,cloudy,
2018,Winter,04:00:00 AM,2,0,2,clear night,
2018,Spring,11:00:00 AM,1677,830,847,cloudy,
2018,Winter,06:00:00 AM,69,30,39,partly cloudy night,
2018,Spring,04:00:00 PM,3092,1499,1593,partly cloudy day,Easter Sunday
2018,Spring,02:00:00 PM,644,338,306,rain,
2018,Spring,07:00:00 AM,359,163,196,clear day,
2018,Spring,05:00:00 AM,13,9,4,rain,
2018,Spring,02:00:00 AM,4,3,1,clear night,
2018,Spring,05:00:00 PM,2970,1301,1669,cloudy,Memorial Day
2018,Spring,09:00:00 PM,284,142,142,partly cloudy night,
2018,Spring,10:00:00 AM,785,404,381,clear day,
2018,Winter,07:00:00 PM,241,143,98,cloudy,
2018,Spring,07:00:00 PM,1029,486,543,clear day,
2018,Spring,12:00:00 AM,11,5,6,partly cloudy night,
2018,Spring,06:00:00 PM,357,237,120,rain,
2018,Spring,01:00:00 AM,10,8,2,cloudy,
2018,Spring,02:00:00 PM,2310,1045,1265,clear day,
2018,Spring,05:00:00 PM,1439,628,811,partly cloudy day,
2018,Spring,03:00:00 PM,2397,1104,1293,partly cloudy day,
2018,Spring,02:00:00 AM,10,6,4,clear night,
2018,Summer,10:00:00 AM,1318,720,598,clear day,
2018,Spring,05:00:00 PM,911,400,511,partly cloudy day,
2018,Spring,07:00:00 AM,178,70,108,partly cloudy day,Tax Day
2018,Winter,05:00:00 PM,2131,1090,1041,clear day,
2018,Spring,10:00:00 PM,120,53,67,clear night,
2018,Summer,10:00:00 AM,1177,639,538,cloudy,
2018,Spring,04:00:00 AM,7,2,5,clear night,
2018,Spring,05:00:00 AM,38,24,14,cloudy,
2018,Spring,03:00:00 AM,8,4,4,partly cloudy night,
2018,Spring,08:00:00 PM,474,204,270,partly cloudy night,
2018,Summer,07:00:00 AM,240,98,142,partly cloudy day,
2018,Spring,01:00:00 PM,2073,1065,1008,clear day,Daylight Saving Time starts
2018,Spring,04:00:00 PM,2156,1035,1121,clear day,
2018,Spring,01:00:00 AM,18,13,5,clear night,St. Patrick's Day
2018,Spring,12:00:00 PM,1665,786,879,clear day,
2018,Summer,12:00:00 PM,1973,906,1067,partly cloudy day,
2018,Spring,10:00:00 AM,985,571,414,partly cloudy day,
2018,Spring,04:00:00 AM,11,6,5,clear night,
2018,Winter,05:00:00 AM,28,16,12,clear night,
2018,Spring,10:00:00 AM,77,42,35,snow,
2018,Spring,01:00:00 AM,8,4,4,partly cloudy night,
2018,Spring,01:00:00 AM,3,2,1,clear night,
2018,Spring,01:00:00 AM,3,1,2,partly cloudy night,
2018,Spring,01:00:00 PM,805,397,408,cloudy,Mother's Day
2018,Spring,05:00:00 AM,24,14,10,rain,
2018,Spring,02:00:00 PM,1931,889,1042,partly cloudy day,
2018,Summer,10:00:00 PM,235,95,140,clear night,
2018,Spring,08:00:00 PM,267,125,142,clear night,
2018,Spring,06:00:00 AM,92,42,50,partly cloudy night,
2018,Spring,03:00:00 AM,3,3,0,cloudy,
2018,Spring,12:00:00 AM,63,37,26,clear night,
2018,Spring,03:00:00 AM,5,3,2,clear night,
2018,Winter,11:00:00 PM,19,14,5,clear night,
2018,Spring,12:00:00 PM,3020,1528,1492,clear day,
2018,Summer,12:00:00 AM,50,30,20,cloudy,
2018,Spring,05:00:00 AM,4,4,0,clear night,
2018,Winter,08:00:00 PM,170,118,52,clear night,
2018,Spring,11:00:00 PM,41,14,27,partly cloudy night,
2018,Spring,03:00:00 PM,2049,1025,1024,clear day,
2018,Spring,06:00:00 AM,142,73,69,clear day,
2018,Spring,05:00:00 PM,1445,691,754,partly cloudy day,
2018,Winter,08:00:00 AM,192,60,132,partly cloudy day,
2018,Spring,02:00:00 PM,1163,463,700,clear day,
2018,Spring,11:00:00 AM,2035,995,1040,clear day,
2018,Winter,12:00:00 PM,1559,745,814,clear day,
2018,Spring,01:00:00 AM,8,2,6,partly cloudy night,
2018,Spring,02:00:00 AM,6,5,1,cloudy,
2018,Spring,12:00:00 AM,35,11,24,clear night,
2018,Spring,09:00:00 AM,105,54,51,partly cloudy day,
2018,Spring,09:00:00 PM,8,7,1,sleet,
2018,Spring,01:00:00 PM,1682,824,858,partly cloudy day,
2018,Spring,07:00:00 AM,116,49,67,partly cloudy day,
2018,Spring,10:00:00 AM,1324,787,537,clear day,
2018,Spring,04:00:00 AM,3,0,3,clear night,
2018,Spring,04:00:00 PM,2050,893,1157,clear day,
2018,Spring,12:00:00 AM,149,86,63,partly cloudy night,
2018,Summer,03:00:00 AM,12,10,2,clear night,
2018,Spring,09:00:00 AM,97,57,40,snow,
2018,Spring,08:00:00 PM,1233,542,691,clear day,
2018,Winter,09:00:00 AM,648,345,303,clear day,
2018,Spring,06:00:00 AM,82,40,42,clear night,
2018,Spring,10:00:00 AM,2157,1336,821,partly cloudy day,
2018,Winter,09:00:00 PM,148,61,87,clear night,
2018,Spring,02:00:00 AM,12,7,5,partly cloudy night,
2018,Summer,02:00:00 AM,5,4,1,partly cloudy night,
2018,Spring,04:00:00 AM,6,4,2,clear night,
2018,Spring,02:00:00 PM,1801,775,1026,cloudy,
2018,Summer,03:00:00 PM,2075,1028,1047,partly cloudy day,
2018,Spring,07:00:00 AM,55,23,32,rain,
2018,Spring,09:00:00 PM,207,147,60,fog,
2018,Spring,12:00:00 AM,35,22,13,partly cloudy night,
2018,Spring,01:00:00 AM,22,16,6,clear night,
2018,Winter,08:00:00 PM,213,169,44,partly cloudy night,
2018,Summer,10:00:00 AM,1425,868,557,clear day,
2018,Summer,08:00:00 PM,975,413,562,clear day,
2018,Spring,09:00:00 PM,155,75,80,partly cloudy night,
2018,Spring,09:00:00 PM,163,73,90,partly cloudy night,
2018,Summer,04:00:00 PM,2491,1026,1465,partly cloudy day,
2018,Spring,09:00:00 AM,752,373,379,clear day,
2018,Summer,07:00:00 PM,1350,784,566,partly cloudy day,
2018,Spring,05:00:00 PM,341,225,116,fog,
2018,Spring,02:00:00 PM,574,324,250,rain,
2018,Spring,02:00:00 AM,1,0,1,partly cloudy night,
2018,Spring,09:00:00 PM,23,16,7,partly cloudy night,
2018,Spring,11:00:00 AM,1211,485,726,partly cloudy day,
2018,Spring,11:00:00 PM,113,91,22,partly cloudy night,
2018,Spring,10:00:00 AM,1273,722,551,partly cloudy day,
2018,Spring,12:00:00 PM,1262,545,717,clear day,
2018,Winter,01:00:00 AM,9,8,1,clear night,
2018,Spring,08:00:00 PM,801,374,427,cloudy,
2018,Spring,09:00:00 AM,943,541,402,partly cloudy day,
2018,Spring,09:00:00 PM,120,52,68,partly cloudy night,
2018,Spring,03:00:00 PM,1078,502,576,partly cloudy day,
2018,Spring,02:00:00 PM,1208,572,636,partly cloudy day,
2018,Winter,04:00:00 AM,6,3,3,partly cloudy night,
2018,Spring,04:00:00 PM,2190,1082,1108,clear day,
2018,Spring,09:00:00 PM,173,117,56,partly cloudy night,
2018,Spring,09:00:00 AM,381,235,146,clear day,
2018,Spring,01:00:00 PM,1858,760,1098,partly cloudy day,
2018,Spring,04:00:00 AM,4,2,2,partly cloudy night,
2018,Spring,04:00:00 AM,1,0,1,partly cloudy night,
2018,Summer,09:00:00 PM,446,182,264,partly cloudy night,
2018,Spring,07:00:00 AM,146,77,69,clear night,Daylight Saving Time starts
2018,Spring,12:00:00 PM,2796,1286,1510,partly cloudy day,
2018,Winter,12:00:00 PM,1317,659,658,partly cloudy day,
2018,Winter,12:00:00 AM,10,5,5,clear night,
2018,Winter,04:00:00 PM,1010,533,477,clear day,
2018,Spring,06:00:00 AM,172,85,87,partly cloudy night,
2018,Winter,08:00:00 PM,109,85,24,partly cloudy night,
2018,Winter,09:00:00 AM,339,191,148,clear day,
2018,Spring,08:00:00 PM,1296,473,823,clear day,
2018,Spring,11:00:00 AM,1062,550,512,clear day,
2018,Spring,10:00:00 AM,859,491,368,partly cloudy day,Tax Day
2018,Winter,09:00:00 PM,11,8,3,partly cloudy night,
2018,Spring,02:00:00 PM,1466,661,805,clear day,
2018,Spring,12:00:00 AM,124,45,79,cloudy,Memorial Day
2018,Summer,09:00:00 AM,367,179,188,cloudy,
2018,Spring,11:00:00 PM,68,24,44,clear night,St. Patrick's Day
2018,Winter,03:00:00 PM,73,40,33,rain,
2018,Spring,09:00:00 AM,711,387,324,clear day,
2018,Spring,04:00:00 PM,2552,1048,1504,partly cloudy day,
2018,Spring,09:00:00 PM,223,110,113,clear night,
2018,Winter,11:00:00 AM,1367,721,646,partly cloudy day,
2018,Spring,04:00:00 AM,7,3,4,partly cloudy night,
2018,Winter,02:00:00 PM,1161,516,645,clear day,
2018,Spring,07:00:00 AM,34,10,24,rain,
2018,Spring,08:00:00 PM,181,72,109,clear night,
2018,Spring,01:00:00 PM,321,172,149,rain,
2018,Spring,02:00:00 PM,1840,829,1011,clear day,
2018,Spring,12:00:00 PM,3178,1669,1509,partly cloudy day,Memorial Day
2018,Winter,11:00:00 AM,650,334,316,partly cloudy day,
2018,Spring,08:00:00 AM,70,25,45,snow,
2018,Spring,06:00:00 PM,1204,440,764,partly cloudy day,
2018,Spring,08:00:00 AM,220,82,138,fog,
2018,Spring,03:00:00 PM,1820,884,936,partly cloudy day,
2018,Spring,02:00:00 PM,2252,959,1293,clear day,
2018,Spring,05:00:00 PM,1389,617,772,partly cloudy day,
2018,Winter,10:00:00 PM,60,30,30,cloudy,
2018,Spring,09:00:00 PM,515,170,345,clear night,
2018,Winter,10:00:00 AM,849,494,355,cloudy,
2018,Spring,08:00:00 AM,41,16,25,rain,
2018,Spring,03:00:00 AM,24,16,8,partly cloudy night,Cinco de Mayo
2018,Winter,07:00:00 PM,283,216,67,partly cloudy night,
2018,Winter,04:00:00 PM,1032,455,577,partly cloudy day,
2018,Summer,02:00:00 PM,2088,1034,1054,partly cloudy day,
2018,Spring,12:00:00 PM,2775,1456,1319,clear day,Easter Sunday
2018,Winter,03:00:00 PM,1256,555,701,clear day,
2018,Winter,12:00:00 PM,1063,487,576,partly cloudy day,Valentine's Day
2018,Spring,11:00:00 PM,192,154,38,clear night,
2018,Spring,07:00:00 PM,1336,606,730,clear day,
2018,Winter,11:00:00 AM,1618,872,746,clear day,
2018,Winter,07:00:00 AM,17,10,7,rain,
2018,Spring,09:00:00 AM,63,38,25,rain,
2018,Summer,12:00:00 AM,48,20,28,clear night,
2018,Spring,01:00:00 AM,82,33,49,clear night,
2018,Spring,12:00:00 PM,1854,883,971,partly cloudy day,
2018,Spring,01:00:00 AM,10,6,4,clear night,Easter Sunday
2018,Winter,02:00:00 AM,12,3,9,clear night,Presidents' Day (regional holiday)
2018,Winter,03:00:00 AM,10,8,2,partly cloudy night,
2018,Spring,06:00:00 PM,817,350,467,cloudy,
2018,Spring,10:00:00 PM,267,158,109,cloudy,
2018,Winter,02:00:00 PM,1977,865,1112,partly cloudy day,
2018,Spring,01:00:00 AM,30,16,14,clear night,
2018,Spring,12:00:00 AM,21,11,10,clear night,
2018,Spring,05:00:00 AM,16,9,7,clear night,
2018,Spring,07:00:00 PM,565,300,265,partly cloudy day,
2018,Spring,08:00:00 PM,327,167,160,partly cloudy day,
2018,Summer,02:00:00 AM,7,3,4,clear night,
2018,Winter,07:00:00 PM,128,65,63,partly cloudy night,Presidents' Day (regional holiday)
2018,Winter,12:00:00 PM,1036,509,527,clear day,
2018,Spring,12:00:00 AM,40,27,13,clear night,
2018,Spring,02:00:00 AM,6,0,6,clear night,
2018,Spring,02:00:00 AM,1,0,1,clear night,
2018,Spring,12:00:00 PM,1382,617,765,clear day,
2018,Spring,11:00:00 PM,92,36,56,clear night,
2018,Spring,10:00:00 AM,1060,561,499,partly cloudy day,
2018,Spring,02:00:00 AM,0,0,0,rain,
2018,Summer,08:00:00 AM,514,156,358,clear day,
2018,Spring,09:00:00 AM,537,276,261,clear day,
2018,Spring,11:00:00 AM,1747,875,872,clear day,
2018,Winter,10:00:00 PM,11,5,6,snow,
2018,Spring,03:00:00 AM,6,4,2,cloudy,Memorial Day
2018,Spring,12:00:00 AM,79,34,45,partly cloudy night,
2018,Spring,12:00:00 PM,1363,670,693,partly cloudy day,
2018,Summer,11:00:00 PM,345,166,179,clear night,
2018,Spring,06:00:00 AM,97,49,48,clear night,
2018,Winter,04:00:00 PM,1485,680,805,clear day,
2018,Spring,03:00:00 AM,3,0,3,partly cloudy night,
2018,Summer,11:00:00 AM,1297,726,571,partly cloudy day,
2018,Summer,01:00:00 AM,51,23,28,rain,
2018,Spring,01:00:00 PM,1582,755,827,partly cloudy day,
2018,Spring,01:00:00 AM,5,4,1,clear night,
2018,Spring,08:00:00 PM,1066,424,642,clear night,
2018,Winter,12:00:00 AM,16,11,5,partly cloudy night,Valentine's Day
2018,Spring,03:00:00 PM,1910,816,1094,partly cloudy day,
2018,Spring,07:00:00 AM,334,140,194,clear day,
2018,Spring,03:00:00 AM,12,10,2,clear night,
2018,Spring,06:00:00 AM,62,35,27,clear night,
2018,Spring,06:00:00 PM,2113,1123,990,clear day,
2018,Spring,08:00:00 AM,229,94,135,partly cloudy day,
2018,Winter,09:00:00 AM,415,207,208,clear day,
2018,Spring,01:00:00 AM,3,2,1,clear night,
2018,Spring,04:00:00 PM,1852,844,1008,partly cloudy day,
2018,Spring,12:00:00 AM,71,37,34,clear night,
2018,Spring,06:00:00 PM,743,456,287,rain,
2018,Spring,10:00:00 PM,75,51,24,fog,
2018,Spring,12:00:00 PM,1049,463,586,partly cloudy day,
2018,Spring,05:00:00 AM,11,7,4,partly cloudy night,
2018,Spring,06:00:00 AM,133,66,67,partly cloudy day,
2018,Summer,05:00:00 AM,67,38,29,clear night,
2018,Spring,11:00:00 AM,1660,698,962,partly cloudy day,
2018,Summer,03:00:00 AM,11,9,2,partly cloudy night,
2018,Spring,12:00:00 AM,14,6,8,cloudy,
2018,Winter,12:00:00 PM,421,204,217,rain,
2018,Spring,09:00:00 AM,193,86,107,partly cloudy day,
2018,Summer,06:00:00 PM,2434,1104,1330,clear day,
2018,Spring,08:00:00 AM,466,180,286,clear day,
2018,Spring,05:00:00 AM,22,10,12,clear night,
2018,Spring,10:00:00 AM,342,226,116,partly cloudy day,
2018,Spring,01:00:00 PM,3106,1511,1595,clear day,
2018,Spring,07:00:00 PM,1326,543,783,clear day,
2018,Winter,07:00:00 AM,139,59,80,partly cloudy day,Valentine's Day
2018,Spring,12:00:00 AM,47,22,25,clear night,
2018,Spring,05:00:00 PM,832,431,401,clear day,
2018,Spring,05:00:00 AM,15,10,5,cloudy,
2018,Summer,12:00:00 AM,70,32,38,clear night,
2018,Spring,11:00:00 PM,169,74,95,cloudy,
2018,Winter,05:00:00 PM,751,378,373,cloudy,
2018,Winter,11:00:00 PM,43,30,13,cloudy,
2018,Spring,02:00:00 PM,167,109,58,snow,
2018,Winter,05:00:00 AM,26,17,9,cloudy,
2018,Spring,01:00:00 PM,1482,620,862,clear day,
2018,Winter,05:00:00 PM,1079,609,470,partly cloudy day,Valentine's Day
2018,Spring,05:00:00 PM,719,419,300,cloudy,
2018,Summer,05:00:00 AM,58,35,23,clear night,
2018,Summer,12:00:00 PM,1937,907,1030,clear day,
2018,Spring,07:00:00 PM,444,207,237,partly cloudy night,
2018,Spring,06:00:00 PM,1298,533,765,partly cloudy day,
2018,Winter,05:00:00 AM,17,10,7,clear night,
2018,Spring,04:00:00 PM,2619,1225,1394,clear day,
2018,Spring,07:00:00 AM,132,54,78,clear night,
2018,Spring,02:00:00 AM,10,9,1,clear night,
2018,Spring,11:00:00 PM,60,27,33,clear night,
2018,Spring,01:00:00 PM,1859,795,1064,clear day,St. Patrick's Day
2018,Spring,12:00:00 PM,858,363,495,cloudy,
2018,Summer,09:00:00 AM,576,311,265,clear day,
2018,Summer,04:00:00 PM,2181,1117,1064,clear day,
2018,Summer,09:00:00 AM,664,335,329,partly cloudy day,
2018,Summer,04:00:00 PM,1774,846,928,partly cloudy day,
2018,Summer,05:00:00 AM,68,45,23,clear night,
2018,Summer,05:00:00 PM,2346,1113,1233,clear day,
2018,Summer,04:00:00 AM,11,10,1,partly cloudy night,
2018,Summer,05:00:00 PM,1859,949,910,cloudy,
2018,Summer,06:00:00 AM,134,70,64,clear day,
2018,Summer,04:00:00 AM,9,7,2,partly cloudy night,
2018,Summer,04:00:00 AM,21,14,7,clear night,
2018,Summer,05:00:00 PM,2414,1125,1289,clear day,
2018,Summer,11:00:00 AM,1317,643,674,clear day,
2018,Summer,01:00:00 PM,3173,1458,1715,partly cloudy day,
2018,Summer,11:00:00 PM,192,111,81,clear night,
2018,Summer,06:00:00 PM,343,245,98,rain,
2018,Summer,09:00:00 AM,667,352,315,clear day,
2018,Summer,09:00:00 AM,523,219,304,clear day,
2018,Summer,04:00:00 PM,2597,1099,1498,clear day,
2018,Summer,11:00:00 AM,1226,629,597,cloudy,
2018,Summer,09:00:00 PM,633,220,413,partly cloudy night,
2018,Summer,05:00:00 PM,2257,1240,1017,clear day,
2018,Summer,02:00:00 AM,51,26,25,clear night,Independence Day
2018,Summer,03:00:00 PM,2211,969,1242,rain,
2018,Summer,02:00:00 PM,2955,1258,1697,partly cloudy day,
2018,Summer,12:00:00 AM,124,59,65,clear night,
2018,Summer,06:00:00 AM,146,71,75,partly cloudy day,
2018,Summer,05:00:00 PM,2746,1210,1536,partly cloudy day,
2018,Summer,12:00:00 PM,1807,857,950,clear day,
2018,Summer,03:00:00 PM,2222,1074,1148,partly cloudy day,
2018,Summer,09:00:00 PM,1430,526,904,clear night,
2018,Summer,03:00:00 PM,2074,973,1101,partly cloudy day,
2018,Summer,06:00:00 AM,213,88,125,clear day,
2018,Summer,04:00:00 AM,13,11,2,clear night,
2018,Summer,06:00:00 PM,2546,1274,1272,partly cloudy day,
2018,Summer,01:00:00 PM,1526,684,842,clear day,
2018,Summer,04:00:00 AM,8,6,2,partly cloudy night,
2018,Summer,12:00:00 PM,1744,811,933,partly cloudy day,
2018,Summer,05:00:00 AM,15,5,10,rain,
2018,Summer,02:00:00 PM,1437,572,865,clear day,
2018,Summer,07:00:00 AM,227,124,103,clear day,Independence Day
2018,Summer,06:00:00 PM,2093,1107,986,partly cloudy day,
2018,Summer,06:00:00 PM,1945,948,997,clear day,
2018,Summer,06:00:00 AM,142,57,85,clear day,
2018,Summer,09:00:00 AM,501,269,232,partly cloudy day,
2018,Summer,07:00:00 AM,211,96,115,clear day,Father's Day
2018,Summer,11:00:00 PM,274,135,139,clear night,
2018,Summer,10:00:00 PM,611,326,285,clear night,
2018,Summer,01:00:00 PM,1824,778,1046,clear day,
2018,Summer,12:00:00 AM,176,105,71,cloudy,
2018,Summer,12:00:00 AM,125,40,85,clear night,
2018,Summer,10:00:00 PM,355,163,192,partly cloudy night,
2018,Summer,08:00:00 AM,494,183,311,clear day,
2018,Summer,09:00:00 AM,480,480,0,clear day,
2018,Summer,05:00:00 AM,64,48,16,clear night,
2018,Summer,05:00:00 PM,1975,1078,897,clear day,
2018,Summer,09:00:00 PM,1006,358,648,clear night,
2018,Summer,05:00:00 AM,50,31,19,clear night,
2018,Summer,12:00:00 PM,1848,945,903,clear day,Father's Day
2018,Summer,07:00:00 PM,1371,657,714,partly cloudy day,
2018,Summer,02:00:00 AM,17,8,9,clear night,
2018,Summer,07:00:00 AM,33,14,19,rain,
2018,Summer,02:00:00 AM,12,7,5,clear night,
2018,Summer,08:00:00 PM,2020,904,1116,clear day,
2018,Summer,07:00:00 PM,1638,923,715,clear day,
2018,Summer,07:00:00 PM,994,553,441,partly cloudy day,
2018,Summer,02:00:00 AM,44,28,16,clear night,
2018,Summer,05:00:00 PM,2098,954,1144,cloudy,
2018,Summer,05:00:00 PM,1481,788,693,clear day,
2018,Summer,10:00:00 PM,369,191,178,cloudy,
2018,Summer,09:00:00 AM,866,539,327,clear day,
2018,Summer,09:00:00 PM,350,151,199,cloudy,
2018,Summer,09:00:00 AM,763,435,328,clear day,
2018,Summer,09:00:00 AM,618,320,298,partly cloudy day,
2018,Summer,10:00:00 PM,285,122,163,clear night,
2018,Summer,10:00:00 AM,1215,660,555,clear day,
2018,Summer,01:00:00 PM,1402,541,861,partly cloudy day,
2018,Summer,12:00:00 PM,1151,545,606,rain,
2018,Summer,08:00:00 PM,1211,534,677,clear day,
2018,Summer,09:00:00 PM,1120,401,719,partly cloudy night,
2018,Summer,05:00:00 PM,2093,2093,0,partly cloudy day,Independence Day
2018,Summer,10:00:00 AM,1341,734,607,partly cloudy day,
2018,Summer,10:00:00 AM,888,487,401,clear day,
2018,Summer,08:00:00 AM,344,134,210,clear day,
2018,Summer,12:00:00 AM,109,50,59,clear night,
2018,Summer,05:00:00 PM,2074,960,1114,clear day,
2018,Summer,07:00:00 AM,263,111,152,partly cloudy day,
2018,Summer,04:00:00 AM,8,6,2,clear night,
2018,Summer,10:00:00 AM,970,523,447,clear day,
2018,Summer,02:00:00 PM,1517,668,849,partly cloudy day,
2018,Summer,03:00:00 PM,2188,2188,0,partly cloudy day,
2018,Summer,01:00:00 PM,2312,1045,1267,clear day,
2018,Summer,09:00:00 PM,43,23,20,cloudy,
2018,Summer,07:00:00 PM,1739,921,818,clear day,
2018,Summer,04:00:00 PM,1932,988,944,clear day,
2018,Summer,10:00:00 PM,991,991,0,partly cloudy night,Independence Day
2018,Summer,09:00:00 PM,154,61,93,rain,
2018,Summer,06:00:00 AM,148,67,81,partly cloudy day,
2018,Summer,10:00:00 AM,859,467,392,clear day,
2018,Summer,01:00:00 AM,38,19,19,clear night,
2018,Summer,06:00:00 PM,1498,912,586,clear day,
2018,Summer,03:00:00 AM,32,8,24,partly cloudy night,
2018,Summer,08:00:00 AM,422,163,259,clear day,
2018,Summer,10:00:00 PM,596,286,310,clear night,
2018,Summer,05:00:00 AM,76,43,33,clear night,
2018,Summer,05:00:00 AM,33,17,16,partly cloudy night,
2018,Summer,11:00:00 AM,2412,1233,1179,partly cloudy day,
2018,Summer,06:00:00 AM,177,86,91,clear day,
2018,Summer,02:00:00 AM,23,17,6,rain,
2018,Summer,01:00:00 AM,44,20,24,partly cloudy night,
2018,Summer,01:00:00 PM,1348,646,702,partly cloudy day,
2018,Summer,09:00:00 PM,1081,368,713,clear night,
2018,Summer,12:00:00 PM,985,396,589,partly cloudy day,
2018,Summer,01:00:00 AM,31,13,18,cloudy,
2018,Summer,09:00:00 AM,668,365,303,clear day,
2018,Summer,02:00:00 AM,8,3,5,partly cloudy night,
2018,Summer,12:00:00 PM,2222,1133,1089,partly cloudy day,
2018,Summer,01:00:00 AM,31,20,11,clear night,
2018,Summer,08:00:00 PM,1299,580,719,clear day,
2018,Summer,01:00:00 AM,43,20,23,clear night,
2018,Summer,04:00:00 PM,2170,1018,1152,clear day,
2018,Summer,01:00:00 AM,31,18,13,partly cloudy night,
2018,Summer,01:00:00 PM,744,348,396,partly cloudy day,
2018,Summer,03:00:00 PM,1854,825,1029,clear day,
2018,Summer,05:00:00 AM,29,18,11,cloudy,
2018,Summer,05:00:00 PM,1349,593,756,rain,
2018,Summer,04:00:00 PM,1882,910,972,clear day,
2018,Summer,11:00:00 AM,1734,882,852,partly cloudy day,
2018,Summer,04:00:00 PM,2042,1041,1001,partly cloudy day,
2018,Summer,02:00:00 AM,19,6,13,partly cloudy night,
2018,Summer,06:00:00 AM,39,17,22,rain,
2018,Summer,04:00:00 AM,11,8,3,clear night,
2018,Summer,11:00:00 AM,1505,830,675,partly cloudy day,
2018,Summer,05:00:00 AM,14,9,5,rain,
2018,Summer,12:00:00 AM,90,58,32,cloudy,
2018,Summer,12:00:00 PM,1473,663,810,clear day,
2018,Summer,02:00:00 AM,58,36,22,clear night,Father's Day
2018,Summer,11:00:00 PM,359,163,196,clear night,
2018,Summer,07:00:00 AM,160,73,87,clear day,
2018,Summer,10:00:00 AM,793,429,364,partly cloudy day,
2018,Summer,05:00:00 PM,2440,1313,1127,clear day,
2018,Summer,06:00:00 PM,1888,1074,814,partly cloudy day,
2018,Summer,07:00:00 PM,1213,1213,0,clear day,
2018,Summer,10:00:00 PM,539,182,357,clear night,
2018,Summer,05:00:00 PM,1862,911,951,clear day,Father's Day
2018,Summer,08:00:00 PM,1287,624,663,partly cloudy day,
2018,Summer,10:00:00 AM,1819,1010,809,partly cloudy day,
2018,Summer,09:00:00 AM,541,251,290,partly cloudy day,
2018,Summer,04:00:00 PM,1594,748,846,partly cloudy day,
2018,Summer,03:00:00 PM,2220,1034,1186,partly cloudy day,
2018,Summer,04:00:00 PM,2948,1339,1609,partly cloudy day,
2018,Summer,01:00:00 AM,5,4,1,rain,
2018,Summer,02:00:00 AM,13,9,4,partly cloudy night,
2018,Summer,04:00:00 PM,1683,823,860,clear day,
2018,Summer,01:00:00 AM,17,6,11,partly cloudy night,
2018,Summer,01:00:00 PM,1768,723,1045,clear day,
2018,Summer,02:00:00 AM,30,14,16,clear night,
2018,Summer,07:00:00 PM,1957,1034,923,clear day,
2018,Summer,02:00:00 AM,22,13,9,clear night,
2018,Summer,01:00:00 AM,21,13,8,partly cloudy night,
2018,Summer,07:00:00 PM,435,198,237,rain,
2018,Summer,09:00:00 AM,578,351,227,clear day,
2018,Summer,08:00:00 AM,327,120,207,cloudy,
2018,Summer,07:00:00 AM,198,82,116,clear day,
2018,Summer,01:00:00 AM,53,15,38,clear night,
2018,Summer,06:00:00 PM,2069,1100,969,partly cloudy day,
2018,Summer,10:00:00 AM,1188,719,469,clear day,
2018,Summer,09:00:00 PM,232,92,140,rain,
2018,Summer,09:00:00 AM,836,553,283,clear day,
2018,Summer,06:00:00 PM,2889,1324,1565,clear day,
2018,Summer,05:00:00 PM,2242,1129,1113,partly cloudy day,
2018,Summer,08:00:00 AM,301,148,153,cloudy,
2018,Summer,02:00:00 PM,2671,1299,1372,clear day,
2018,Summer,05:00:00 AM,72,48,24,clear night,
2018,Summer,08:00:00 PM,1516,731,785,clear day,
2018,Summer,11:00:00 PM,557,210,347,clear night,
2018,Summer,01:00:00 AM,25,10,15,clear night,
2018,Summer,08:00:00 PM,983,383,600,partly cloudy day,
2018,Summer,12:00:00 AM,117,59,58,partly cloudy night,
2018,Summer,01:00:00 PM,2265,1085,1180,partly cloudy day,
2018,Summer,04:00:00 AM,17,13,4,clear night,
2018,Summer,09:00:00 PM,805,290,515,clear night,
2018,Summer,04:00:00 PM,1925,931,994,partly cloudy day,
2018,Summer,06:00:00 PM,1189,1189,0,partly cloudy day,
2018,Summer,08:00:00 AM,430,242,188,partly cloudy day,
2018,Summer,09:00:00 AM,529,331,198,cloudy,
2018,Summer,05:00:00 PM,1260,661,599,partly cloudy day,
2018,Summer,12:00:00 PM,1427,720,707,partly cloudy day,
2018,Summer,07:00:00 AM,235,117,118,clear day,
2018,Summer,12:00:00 AM,191,91,100,partly cloudy night,
2018,Summer,12:00:00 AM,67,20,47,clear night,
2018,Summer,08:00:00 AM,379,120,259,partly cloudy day,
2018,Summer,12:00:00 AM,178,81,97,clear night,
2018,Summer,09:00:00 AM,484,293,191,partly cloudy day,
2018,Summer,11:00:00 PM,184,76,108,clear night,
2018,Summer,03:00:00 AM,7,3,4,clear night,
2018,Summer,11:00:00 PM,535,265,270,clear night,
2018,Summer,08:00:00 PM,560,276,284,cloudy,
2018,Summer,05:00:00 PM,3272,1450,1822,partly cloudy day,
2018,Summer,09:00:00 PM,865,280,585,clear night,
2018,Summer,04:00:00 AM,2,0,2,rain,
2018,Summer,11:00:00 AM,2236,1215,1021,clear day,
2018,Summer,07:00:00 AM,131,57,74,cloudy,
2018,Summer,10:00:00 AM,904,556,348,clear day,
2018,Summer,01:00:00 AM,22,12,10,cloudy,
2018,Summer,05:00:00 PM,1589,808,781,clear day,
2018,Summer,08:00:00 PM,1775,649,1126,partly cloudy day,
2018,Summer,06:00:00 AM,196,90,106,clear day,
2018,Summer,10:00:00 PM,665,254,411,clear night,
2018,Summer,10:00:00 AM,1278,719,559,clear day,
2018,Summer,01:00:00 PM,2037,918,1119,clear day,Father's Day
2018,Summer,10:00:00 PM,583,302,281,clear night,
2018,Summer,11:00:00 AM,1851,888,963,partly cloudy day,
2018,Summer,01:00:00 PM,3240,1455,1785,partly cloudy day,
2018,Summer,12:00:00 AM,96,39,57,partly cloudy night,
2018,Summer,12:00:00 AM,86,36,50,clear night,
2018,Summer,10:00:00 AM,676,389,287,cloudy,
2018,Summer,02:00:00 AM,15,9,6,clear night,
2018,Summer,12:00:00 AM,182,93,89,clear night,
2018,Summer,05:00:00 AM,73,48,25,partly cloudy night,
2018,Summer,06:00:00 PM,912,433,479,cloudy,
2018,Summer,07:00:00 PM,1913,1009,904,partly cloudy day,
2018,Summer,07:00:00 AM,248,112,136,partly cloudy day,
2018,Summer,05:00:00 PM,1787,928,859,partly cloudy day,
2018,Summer,05:00:00 AM,67,39,28,clear night,
2018,Summer,12:00:00 PM,1414,689,725,clear day,
2018,Summer,02:00:00 PM,3518,1553,1965,clear day,
2018,Summer,09:00:00 AM,396,233,163,cloudy,
2018,Summer,10:00:00 AM,1325,746,579,clear day,
2018,Summer,03:00:00 PM,1230,630,600,partly cloudy day,
2018,Summer,05:00:00 AM,55,31,24,partly cloudy night,
2018,Summer,01:00:00 AM,39,17,22,clear night,
2018,Summer,03:00:00 AM,8,5,3,partly cloudy night,
2018,Summer,04:00:00 AM,34,18,16,cloudy,
2018,Summer,01:00:00 AM,30,17,13,clear night,
2018,Summer,10:00:00 PM,660,295,365,clear night,
2018,Summer,01:00:00 AM,24,14,10,clear night,
2018,Summer,08:00:00 AM,433,148,285,clear day,
2018,Summer,02:00:00 AM,29,18,11,clear night,
2018,Summer,05:00:00 PM,1673,927,746,clear day,
2018,Summer,05:00:00 PM,2397,1061,1336,partly cloudy day,
2018,Summer,08:00:00 AM,229,129,100,cloudy,
2018,Summer,02:00:00 PM,2232,1056,1176,clear day,
2018,Summer,04:00:00 AM,8,5,3,clear night,
2018,Summer,09:00:00 AM,972,581,391,partly cloudy day,
2018,Summer,03:00:00 AM,47,27,20,clear night,
2018,Summer,12:00:00 AM,141,77,64,clear night,
2018,Summer,06:00:00 PM,2304,1070,1234,partly cloudy day,
2018,Summer,12:00:00 AM,93,45,48,clear night,
2018,Summer,05:00:00 AM,82,53,29,clear night,
2018,Summer,01:00:00 AM,35,10,25,clear night,
2018,Summer,12:00:00 AM,90,56,34,clear night,
2018,Summer,02:00:00 AM,15,7,8,partly cloudy night,
2018,Summer,03:00:00 PM,1971,879,1092,partly cloudy day,
2018,Summer,04:00:00 PM,2317,1115,1202,partly cloudy day,
2018,Summer,08:00:00 AM,305,177,128,clear day,Father's Day
2018,Summer,03:00:00 PM,2135,1067,1068,partly cloudy day,
2018,Summer,08:00:00 AM,451,270,181,clear day,
2018,Summer,01:00:00 PM,2003,961,1042,clear day,
2018,Summer,12:00:00 PM,3199,1552,1647,partly cloudy day,
2018,Summer,01:00:00 PM,2112,965,1147,cloudy,
2018,Summer,09:00:00 PM,292,144,148,partly cloudy night,
2018,Summer,03:00:00 PM,1875,877,998,partly cloudy day,
2018,Summer,11:00:00 AM,1679,845,834,partly cloudy day,Independence Day
2018,Summer,12:00:00 PM,1825,788,1037,partly cloudy day,
2018,Summer,02:00:00 PM,2136,1016,1120,partly cloudy day,
2018,Summer,02:00:00 AM,8,4,4,rain,
2018,Summer,07:00:00 AM,270,126,144,clear day,
2018,Summer,06:00:00 AM,174,67,107,clear day,
2018,Summer,04:00:00 PM,2555,1109,1446,partly cloudy day,
2018,Summer,05:00:00 AM,73,37,36,partly cloudy night,
2018,Summer,08:00:00 AM,445,260,185,clear day,
2018,Summer,06:00:00 PM,1835,1022,813,clear day,
2018,Summer,08:00:00 PM,1854,756,1098,clear day,
2018,Summer,08:00:00 PM,834,440,394,partly cloudy day,
2018,Summer,12:00:00 AM,114,55,59,clear night,
2018,Summer,08:00:00 AM,54,21,33,rain,
2018,Summer,09:00:00 AM,809,517,292,clear day,Father's Day
2018,Summer,08:00:00 PM,1116,539,577,partly cloudy day,
2018,Summer,06:00:00 PM,2415,928,1487,cloudy,
2018,Summer,07:00:00 PM,1935,959,976,clear day,
2018,Summer,06:00:00 PM,1551,990,561,clear day,
2018,Summer,06:00:00 PM,1680,772,908,cloudy,
2018,Summer,01:00:00 PM,2260,1062,1198,partly cloudy day,Independence Day
2018,Summer,01:00:00 AM,51,23,28,clear night,
2018,Summer,06:00:00 AM,113,50,63,partly cloudy day,
2018,Summer,01:00:00 PM,2001,1001,1000,cloudy,
2018,Summer,01:00:00 AM,59,19,40,partly cloudy night,
2018,Summer,01:00:00 AM,84,50,34,clear night,
2018,Summer,09:00:00 PM,608,227,381,partly cloudy night,
2018,Summer,01:00:00 PM,2143,1014,1129,partly cloudy day,
2018,Summer,05:00:00 AM,72,59,13,clear night,
2018,Summer,06:00:00 AM,151,67,84,clear day,
2018,Summer,09:00:00 AM,175,80,95,rain,
2018,Summer,04:00:00 PM,1620,823,797,clear day,
2018,Summer,06:00:00 PM,1531,789,742,cloudy,
2018,Summer,06:00:00 PM,1516,1516,0,partly cloudy day,Independence Day
2018,Summer,06:00:00 PM,2231,1056,1175,partly cloudy day,
2018,Summer,11:00:00 PM,259,114,145,clear night,
2018,Summer,06:00:00 AM,178,87,91,partly cloudy day,
2018,Summer,03:00:00 AM,18,12,6,partly cloudy night,
2018,Summer,06:00:00 PM,2049,1053,996,clear day,
2018,Summer,01:00:00 PM,2267,1032,1235,partly cloudy day,
2018,Summer,11:00:00 PM,219,92,127,clear night,
2018,Summer,10:00:00 AM,1011,589,422,clear day,
2018,Summer,10:00:00 AM,1268,781,487,clear day,
2018,Summer,09:00:00 AM,713,415,298,cloudy,
2018,Summer,06:00:00 PM,2041,1146,895,clear day,
2018,Summer,02:00:00 PM,1800,1800,0,clear day,
2018,Summer,11:00:00 PM,157,87,70,rain,
2018,Summer,09:00:00 PM,920,257,663,partly cloudy night,
2018,Summer,01:00:00 AM,47,26,21,partly cloudy night,
2018,Summer,10:00:00 PM,734,308,426,clear night,
2018,Summer,10:00:00 PM,234,97,137,cloudy,
2018,Summer,04:00:00 AM,3,0,3,rain,
2018,Summer,02:00:00 AM,3,1,2,clear night,
2018,Summer,08:00:00 AM,221,103,118,cloudy,
2018,Summer,07:00:00 AM,230,90,140,clear day,
2018,Summer,10:00:00 AM,1383,753,630,clear day,
2018,Summer,01:00:00 AM,39,28,11,clear night,
2018,Summer,10:00:00 AM,1104,588,516,clear day,
2018,Summer,04:00:00 PM,1208,610,598,cloudy,
2018,Summer,02:00:00 AM,65,48,17,partly cloudy night,
2018,Summer,10:00:00 AM,1671,979,692,clear day,
2018,Summer,04:00:00 AM,5,1,4,partly cloudy night,
2018,Summer,04:00:00 PM,1676,867,809,clear day,
2018,Summer,09:00:00 PM,979,311,668,clear night,
2018,Summer,08:00:00 PM,888,434,454,partly cloudy day,
2018,Summer,09:00:00 PM,721,199,522,partly cloudy night,
2018,Summer,10:00:00 AM,1148,714,434,partly cloudy day,
2018,Summer,04:00:00 AM,11,5,6,clear night,
2018,Summer,12:00:00 PM,1347,608,739,partly cloudy day,
2018,Summer,11:00:00 AM,1733,849,884,clear day,
2018,Summer,09:00:00 AM,600,334,266,clear day,
2018,Summer,06:00:00 PM,2437,1125,1312,clear day,
2018,Summer,09:00:00 AM,821,478,343,clear day,
2018,Summer,11:00:00 PM,304,170,134,cloudy,
2018,Summer,08:00:00 AM,202,115,87,rain,
2018,Summer,09:00:00 AM,485,272,213,cloudy,
2018,Summer,05:00:00 AM,45,22,23,clear night,
2018,Summer,09:00:00 AM,520,269,251,partly cloudy day,
2018,Summer,11:00:00 AM,1400,735,665,clear day,
2018,Summer,09:00:00 PM,884,403,481,clear night,
2018,Summer,09:00:00 PM,525,192,333,partly cloudy night,
2018,Summer,08:00:00 AM,362,191,171,clear day,
2018,Summer,04:00:00 PM,2434,1184,1250,clear day,
2018,Summer,11:00:00 PM,285,89,196,clear night,
2018,Summer,01:00:00 AM,56,24,32,partly cloudy night,
2018,Summer,07:00:00 PM,605,406,199,partly cloudy day,
2018,Summer,02:00:00 AM,17,10,7,partly cloudy night,
2018,Summer,04:00:00 PM,1521,791,730,clear day,
2018,Summer,12:00:00 PM,1049,515,534,cloudy,
2018,Summer,12:00:00 AM,51,30,21,rain,
2018,Summer,05:00:00 PM,1579,900,679,partly cloudy day,
2018,Summer,01:00:00 PM,1616,753,863,cloudy,
2018,Summer,05:00:00 AM,62,36,26,clear night,
2018,Summer,01:00:00 PM,2619,1184,1435,clear day,
2018,Summer,03:00:00 AM,9,7,2,clear night,
2018,Summer,12:00:00 AM,39,15,24,partly cloudy night,
2018,Summer,03:00:00 PM,2395,942,1453,clear day,
2018,Summer,01:00:00 PM,2728,1366,1362,clear day,
2018,Summer,05:00:00 AM,73,45,28,clear night,
2018,Summer,02:00:00 PM,2148,930,1218,partly cloudy day,
2018,Summer,05:00:00 AM,68,42,26,clear night,
2018,Summer,07:00:00 PM,1691,822,869,clear day,
2018,Summer,06:00:00 AM,129,59,70,clear day,Independence Day
2018,Summer,02:00:00 AM,19,5,14,clear night,
2018,Summer,01:00:00 PM,2133,858,1275,clear day,
2018,Summer,07:00:00 PM,1653,795,858,partly cloudy day,
2018,Summer,05:00:00 PM,1495,662,833,clear day,
2018,Summer,01:00:00 AM,23,12,11,clear night,
2018,Summer,11:00:00 AM,1595,854,741,partly cloudy day,
2018,Summer,07:00:00 AM,53,29,24,rain,
2018,Summer,01:00:00 AM,92,44,48,clear night,
2018,Summer,10:00:00 PM,442,244,198,partly cloudy night,
2018,Summer,11:00:00 AM,1729,926,803,partly cloudy day,
2018,Summer,12:00:00 PM,2524,1197,1327,partly cloudy day,
2018,Summer,02:00:00 AM,14,8,6,partly cloudy night,
2018,Summer,12:00:00 PM,1154,676,478,clear day,
2018,Summer,02:00:00 PM,1173,372,801,partly cloudy day,
2018,Summer,12:00:00 AM,75,32,43,clear night,
2018,Summer,02:00:00 AM,11,3,8,cloudy,
2018,Summer,04:00:00 PM,2192,954,1238,partly cloudy day,
2018,Summer,09:00:00 AM,812,453,359,cloudy,
2018,Summer,08:00:00 PM,1234,579,655,clear day,
2018,Summer,02:00:00 PM,3047,1430,1617,partly cloudy day,
2018,Summer,03:00:00 AM,14,8,6,clear night,Independence Day
2018,Summer,10:00:00 AM,1042,1042,0,clear day,
2018,Summer,02:00:00 PM,1786,856,930,partly cloudy day,
2018,Summer,01:00:00 PM,1507,666,841,partly cloudy day,
2018,Summer,09:00:00 PM,264,122,142,rain,
2018,Summer,10:00:00 PM,567,228,339,clear night,
2018,Summer,03:00:00 AM,14,8,6,clear night,
2018,Summer,05:00:00 PM,1938,1093,845,clear day,
2018,Summer,02:00:00 PM,1797,767,1030,clear day,
2018,Summer,12:00:00 AM,12,5,7,rain,
2018,Summer,09:00:00 PM,862,351,511,partly cloudy night,
2018,Summer,12:00:00 AM,57,23,34,clear night,
2018,Summer,03:00:00 AM,24,5,19,clear night,
2018,Summer,05:00:00 AM,57,46,11,clear night,
2018,Summer,08:00:00 PM,1443,709,734,clear day,
2018,Summer,07:00:00 PM,2526,1201,1325,partly cloudy day,
2018,Summer,05:00:00 PM,1873,979,894,partly cloudy day,
2018,Summer,08:00:00 AM,109,35,74,rain,
2018,Summer,07:00:00 AM,247,111,136,clear day,
2018,Summer,09:00:00 PM,597,220,377,clear night,
2018,Summer,04:00:00 AM,27,13,14,partly cloudy night,
2018,Summer,08:00:00 AM,452,146,306,clear day,
2018,Summer,10:00:00 AM,1062,564,498,partly cloudy day,
2018,Summer,04:00:00 PM,1446,657,789,rain,
2018,Summer,05:00:00 PM,1864,989,875,clear day,
2018,Summer,10:00:00 PM,599,239,360,partly cloudy night,
2018,Summer,08:00:00 AM,417,148,269,partly cloudy day,
2018,Summer,01:00:00 PM,1530,655,875,partly cloudy day,
2018,Summer,05:00:00 AM,52,32,20,clear night,
2018,Summer,09:00:00 AM,577,292,285,clear day,
2018,Summer,05:00:00 PM,2029,1109,920,partly cloudy day,
2018,Summer,10:00:00 PM,742,308,434,clear night,
2018,Summer,03:00:00 AM,11,1,10,rain,
2018,Summer,12:00:00 AM,150,76,74,clear night,
2018,Summer,02:00:00 AM,44,25,19,clear night,
2018,Summer,07:00:00 AM,228,102,126,clear day,
2018,Summer,05:00:00 PM,1894,971,923,partly cloudy day,
2018,Summer,05:00:00 AM,75,45,30,partly cloudy night,
2018,Summer,01:00:00 AM,124,79,45,clear night,Father's Day
2018,Summer,04:00:00 AM,4,1,3,clear night,
2018,Summer,03:00:00 AM,12,6,6,clear night,
2018,Summer,04:00:00 AM,7,7,0,cloudy,
2018,Summer,08:00:00 AM,385,158,227,clear day,
2018,Summer,08:00:00 PM,1265,631,634,partly cloudy day,
2018,Summer,08:00:00 AM,98,37,61,rain,
2018,Summer,02:00:00 PM,2057,905,1152,partly cloudy day,
2018,Summer,08:00:00 PM,1554,734,820,clear day,
2018,Summer,04:00:00 PM,1980,966,1014,clear day,Father's Day
2018,Summer,09:00:00 PM,947,302,645,clear night,
2018,Summer,03:00:00 PM,1998,890,1108,clear day,
2018,Summer,09:00:00 AM,794,533,261,partly cloudy day,
2018,Summer,05:00:00 PM,1609,814,795,partly cloudy day,
2018,Summer,02:00:00 PM,2153,904,1249,partly cloudy day,
2018,Summer,09:00:00 PM,723,723,0,clear night,
2018,Summer,06:00:00 PM,2146,1165,981,partly cloudy day,
2018,Summer,01:00:00 PM,1493,647,846,partly cloudy day,
2018,Summer,09:00:00 PM,588,588,0,clear night,Independence Day
2018,Summer,09:00:00 AM,542,280,262,clear day,
2018,Summer,01:00:00 AM,41,24,17,clear night,
2018,Summer,02:00:00 AM,7,3,4,partly cloudy night,
2018,Summer,07:00:00 AM,222,100,122,clear day,
2018,Summer,08:00:00 AM,387,163,224,clear day,
2018,Summer,06:00:00 AM,192,97,95,clear day,
2018,Summer,10:00:00 AM,1124,660,464,partly cloudy day,Independence Day
2018,Summer,01:00:00 AM,42,20,22,clear night,
2018,Summer,09:00:00 PM,1114,333,781,clear night,
2018,Summer,08:00:00 PM,1287,619,668,partly cloudy day,
2018,Summer,02:00:00 AM,26,12,14,clear night,
2018,Summer,07:00:00 PM,1456,859,597,clear day,
2018,Summer,07:00:00 PM,887,438,449,rain,
2018,Summer,10:00:00 PM,164,58,106,cloudy,
2018,Summer,03:00:00 PM,2422,1118,1304,partly cloudy day,
2018,Summer,07:00:00 AM,175,70,105,partly cloudy day,
2018,Summer,08:00:00 AM,253,108,145,cloudy,
2018,Summer,10:00:00 PM,410,160,250,partly cloudy night,
2018,Summer,12:00:00 PM,2452,1247,1205,clear day,
2018,Summer,10:00:00 AM,1440,919,521,clear day,
2018,Summer,09:00:00 AM,563,299,264,partly cloudy day,
2018,Summer,09:00:00 PM,689,319,370,partly cloudy night,
2018,Summer,10:00:00 PM,916,342,574,clear night,
2018,Summer,11:00:00 AM,1465,752,713,clear day,
2018,Summer,01:00:00 AM,30,12,18,partly cloudy night,
2018,Summer,07:00:00 AM,216,95,121,partly cloudy day,
2018,Summer,01:00:00 PM,1768,778,990,partly cloudy day,
2018,Summer,05:00:00 PM,1807,1024,783,partly cloudy day,
2018,Summer,11:00:00 PM,388,223,165,clear night,
2018,Summer,10:00:00 AM,1245,676,569,partly cloudy day,
2018,Summer,06:00:00 AM,156,156,0,clear day,
2018,Summer,03:00:00 PM,2993,1301,1692,partly cloudy day,
2018,Summer,06:00:00 PM,1755,1003,752,clear day,
2018,Summer,04:00:00 PM,2176,1085,1091,partly cloudy day,
2018,Summer,06:00:00 AM,145,73,72,partly cloudy day,
2018,Summer,01:00:00 PM,1354,693,661,clear day,
2018,Summer,12:00:00 PM,1557,795,762,partly cloudy day,
2018,Summer,05:00:00 PM,1397,781,616,clear day,
2018,Summer,11:00:00 AM,1952,979,973,partly cloudy day,
2018,Summer,01:00:00 PM,1895,878,1017,partly cloudy day,
2018,Summer,01:00:00 AM,23,16,7,partly cloudy night,
2018,Summer,09:00:00 PM,1007,400,607,clear night,Father's Day
2018,Summer,06:00:00 AM,154,72,82,partly cloudy day,
2018,Summer,05:00:00 AM,38,16,22,cloudy,
2018,Summer,05:00:00 AM,58,34,24,clear night,
2018,Summer,11:00:00 PM,509,296,213,clear night,
2018,Summer,11:00:00 PM,130,92,38,cloudy,
2018,Summer,11:00:00 AM,1336,684,652,clear day,
2018,Summer,05:00:00 PM,2966,1324,1642,clear day,
2018,Summer,02:00:00 AM,8,5,3,clear night,
2018,Summer,01:00:00 PM,2082,921,1161,partly cloudy day,
2018,Summer,08:00:00 PM,1496,613,883,clear day,Father's Day
2018,Summer,07:00:00 PM,1572,862,710,partly cloudy day,
2018,Summer,09:00:00 AM,647,351,296,partly cloudy day,
2018,Summer,09:00:00 PM,1247,355,892,clear night,
2018,Summer,04:00:00 PM,2154,1071,1083,partly cloudy day,
2018,Summer,12:00:00 PM,1552,735,817,partly cloudy day,
2018,Summer,02:00:00 PM,2190,1018,1172,clear day,
2018,Summer,06:00:00 PM,558,281,277,rain,
2018,Summer,02:00:00 PM,3822,1839,1983,partly cloudy day,
2018,Summer,02:00:00 PM,2566,1176,1390,cloudy,
2018,Summer,09:00:00 PM,1073,335,738,clear night,
2018,Summer,12:00:00 PM,1505,670,835,cloudy,
2018,Summer,01:00:00 AM,33,19,14,clear night,
2018,Summer,01:00:00 AM,16,8,8,cloudy,
2018,Summer,04:00:00 PM,1630,734,896,rain,
2018,Summer,11:00:00 AM,1816,927,889,partly cloudy day,
2018,Summer,09:00:00 PM,1064,303,761,clear night,
2018,Summer,01:00:00 AM,28,9,19,clear night,
2018,Summer,09:00:00 PM,861,250,611,clear night,
2018,Summer,09:00:00 AM,818,538,280,partly cloudy day,
2018,Summer,10:00:00 AM,1183,735,448,partly cloudy day,
2018,Summer,06:00:00 AM,201,101,100,partly cloudy day,
2018,Summer,02:00:00 AM,12,7,5,clear night,
2018,Summer,03:00:00 PM,1704,860,844,cloudy,
2018,Summer,06:00:00 PM,2101,1102,999,clear day,
2018,Summer,03:00:00 AM,11,8,3,clear night,
2018,Summer,11:00:00 PM,248,109,139,partly cloudy night,
2018,Summer,02:00:00 PM,1228,472,756,clear day,
2018,Summer,06:00:00 AM,49,16,33,rain,
2018,Summer,03:00:00 AM,18,10,8,clear night,
2018,Summer,02:00:00 PM,2610,1296,1314,rain,Independence Day
2018,Summer,05:00:00 AM,16,9,7,rain,
2018,Summer,09:00:00 PM,880,331,549,partly cloudy night,
2018,Summer,05:00:00 PM,2488,1179,1309,partly cloudy day,
2018,Summer,02:00:00 PM,2481,1234,1247,partly cloudy day,
2018,Summer,10:00:00 PM,563,223,340,clear night,
2018,Summer,02:00:00 AM,13,6,7,clear night,
2018,Summer,10:00:00 AM,1131,645,486,partly cloudy day,
2018,Summer,12:00:00 PM,1868,953,915,clear day,
2018,Summer,02:00:00 AM,52,32,20,partly cloudy night,
2018,Summer,06:00:00 AM,158,86,72,clear day,
2018,Summer,10:00:00 PM,266,85,181,cloudy,
2018,Summer,07:00:00 PM,2350,1080,1270,partly cloudy day,
2018,Summer,04:00:00 PM,1705,869,836,clear day,
2018,Summer,05:00:00 PM,2542,988,1554,partly cloudy day,
2018,Summer,06:00:00 PM,1514,1514,0,clear day,
2018,Summer,06:00:00 AM,95,51,44,clear day,
2018,Summer,05:00:00 AM,63,44,19,clear night,
2018,Summer,09:00:00 PM,852,424,428,clear night,
2018,Summer,06:00:00 AM,173,80,93,partly cloudy day,
2018,Summer,10:00:00 AM,1532,969,563,clear day,
2018,Summer,11:00:00 AM,2478,1324,1154,partly cloudy day,
2018,Summer,08:00:00 PM,1510,604,906,clear day,
2018,Summer,10:00:00 AM,1058,589,469,partly cloudy day,
2018,Summer,08:00:00 PM,759,442,317,partly cloudy day,
2018,Summer,10:00:00 PM,338,171,167,clear night,
2018,Summer,04:00:00 PM,1356,701,655,partly cloudy day,
2018,Summer,12:00:00 PM,1938,940,998,cloudy,
2018,Summer,09:00:00 AM,847,490,357,clear day,
2018,Summer,04:00:00 AM,14,8,6,partly cloudy night,
2018,Summer,05:00:00 AM,85,52,33,clear night,
2018,Summer,01:00:00 PM,1729,1729,0,clear day,
2018,Summer,03:00:00 AM,19,7,12,cloudy,
2018,Summer,04:00:00 AM,10,7,3,clear night,
2018,Summer,09:00:00 AM,347,202,145,partly cloudy day,
2018,Summer,12:00:00 AM,180,134,46,clear night,
2018,Summer,05:00:00 AM,75,45,30,partly cloudy night,
2018,Summer,08:00:00 PM,1339,555,784,partly cloudy day,
2018,Summer,05:00:00 AM,36,19,17,cloudy,
2018,Summer,12:00:00 AM,179,87,92,clear night,
2018,Summer,05:00:00 PM,1522,799,723,partly cloudy day,
2018,Summer,03:00:00 AM,6,4,2,cloudy,
2018,Summer,01:00:00 AM,27,16,11,clear night,
2018,Summer,01:00:00 PM,3633,1679,1954,clear day,
2018,Summer,08:00:00 PM,1556,774,782,clear day,
2018,Summer,02:00:00 PM,2294,1104,1190,partly cloudy day,
2018,Summer,03:00:00 PM,1604,725,879,partly cloudy day,
2018,Summer,10:00:00 PM,552,193,359,clear night,
2018,Summer,04:00:00 AM,10,7,3,clear night,
2018,Summer,03:00:00 AM,8,3,5,cloudy,
2018,Summer,08:00:00 PM,1273,635,638,clear day,
2018,Summer,03:00:00 AM,28,21,7,clear night,
2018,Summer,11:00:00 AM,1904,1164,740,partly cloudy day,
2018,Summer,10:00:00 AM,1172,564,608,clear day,
2018,Summer,11:00:00 AM,1248,683,565,clear day,
2018,Summer,06:00:00 AM,158,70,88,clear day,
2018,Summer,12:00:00 AM,169,132,37,clear night,
2018,Summer,10:00:00 AM,806,458,348,cloudy,
2018,Summer,08:00:00 AM,496,173,323,clear day,
2018,Summer,03:00:00 PM,320,129,191,rain,
2018,Summer,09:00:00 AM,873,573,300,partly cloudy day,
2018,Summer,04:00:00 PM,2833,1215,1618,partly cloudy day,
2018,Summer,10:00:00 AM,1295,739,556,cloudy,
2018,Summer,11:00:00 AM,1155,1155,0,clear day,
2018,Summer,11:00:00 PM,305,132,173,clear night,
2018,Summer,10:00:00 PM,399,131,268,clear night,
2018,Summer,01:00:00 PM,1175,567,608,cloudy,
2018,Summer,03:00:00 AM,10,0,10,partly cloudy night,
2018,Summer,03:00:00 PM,1761,865,896,partly cloudy day,
2018,Summer,03:00:00 PM,2379,1070,1309,partly cloudy day,
2018,Summer,10:00:00 AM,1498,876,622,cloudy,
2018,Summer,11:00:00 PM,298,183,115,clear night,
2018,Summer,10:00:00 AM,1136,633,503,clear day,Father's Day
2018,Summer,08:00:00 AM,360,245,115,partly cloudy day,
2018,Summer,05:00:00 AM,88,36,52,cloudy,
2018,Summer,12:00:00 AM,64,39,25,cloudy,
2018,Summer,05:00:00 AM,55,33,22,partly cloudy night,
2018,Summer,07:00:00 AM,143,64,79,cloudy,
2018,Summer,03:00:00 PM,1152,600,552,cloudy,
2018,Summer,05:00:00 PM,1547,828,719,clear day,
2018,Summer,05:00:00 AM,59,33,26,clear night,
2018,Summer,11:00:00 AM,1666,893,773,partly cloudy day,
2018,Summer,07:00:00 PM,935,515,420,partly cloudy day,
2018,Summer,11:00:00 PM,427,225,202,clear night,
2018,Summer,12:00:00 AM,64,35,29,clear night,
2018,Summer,01:00:00 AM,82,33,49,clear night,
2018,Summer,12:00:00 PM,3176,1535,1641,partly cloudy day,
2018,Summer,10:00:00 AM,516,314,202,partly cloudy day,
2018,Summer,06:00:00 PM,1579,884,695,partly cloudy day,
2018,Summer,08:00:00 AM,135,56,79,partly cloudy day,
2018,Summer,01:00:00 PM,1972,886,1086,partly cloudy day,
2018,Summer,11:00:00 PM,428,223,205,clear night,
2018,Summer,07:00:00 AM,91,52,39,rain,
2018,Summer,12:00:00 PM,1191,594,597,clear day,
2018,Summer,05:00:00 AM,52,30,22,partly cloudy night,
2018,Summer,06:00:00 AM,165,76,89,clear day,
2018,Summer,02:00:00 PM,2285,959,1326,partly cloudy day,
2018,Summer,03:00:00 PM,3109,1406,1703,partly cloudy day,
2018,Summer,01:00:00 PM,2077,802,1275,clear day,
2018,Summer,10:00:00 PM,604,222,382,clear night,
2018,Summer,12:00:00 AM,92,49,43,partly cloudy night,
2018,Summer,11:00:00 AM,1588,813,775,partly cloudy day,
2018,Summer,10:00:00 PM,107,50,57,rain,
2018,Summer,08:00:00 AM,384,147,237,partly cloudy day,
2018,Summer,07:00:00 PM,1885,1014,871,partly cloudy day,
2018,Summer,12:00:00 AM,87,39,48,clear night,
2018,Summer,01:00:00 AM,20,12,8,clear night,
2018,Summer,08:00:00 PM,1402,644,758,partly cloudy day,
2018,Summer,11:00:00 PM,43,31,12,rain,
2018,Summer,02:00:00 AM,17,7,10,partly cloudy night,
2018,Summer,12:00:00 AM,143,57,86,partly cloudy night,
2018,Summer,02:00:00 AM,37,21,16,clear night,
2018,Summer,03:00:00 AM,8,0,8,partly cloudy night,
2018,Summer,12:00:00 PM,1443,595,848,clear day,
2018,Summer,08:00:00 AM,361,212,149,clear day,
2018,Summer,07:00:00 AM,61,27,34,rain,
2018,Summer,04:00:00 PM,3345,1512,1833,clear day,
2018,Summer,07:00:00 AM,296,119,177,clear day,
2018,Summer,12:00:00 AM,102,38,64,clear night,
2018,Summer,10:00:00 AM,1229,697,532,clear day,
2018,Summer,04:00:00 PM,1409,639,770,clear day,
2018,Summer,03:00:00 AM,6,5,1,clear night,
2018,Summer,05:00:00 AM,115,55,60,clear night,Father's Day
2018,Summer,09:00:00 PM,816,322,494,partly cloudy night,
2018,Summer,03:00:00 PM,1599,733,866,partly cloudy day,
2018,Summer,10:00:00 PM,477,216,261,cloudy,
2018,Summer,04:00:00 AM,4,2,2,rain,
2018,Summer,01:00:00 AM,131,50,81,clear night,
2018,Summer,03:00:00 PM,2130,1005,1125,partly cloudy day,
2018,Summer,11:00:00 PM,360,161,199,clear night,
2018,Summer,09:00:00 PM,635,635,0,partly cloudy night,
2018,Summer,04:00:00 AM,10,2,8,cloudy,
2018,Summer,04:00:00 AM,16,11,5,clear night,
2018,Summer,05:00:00 AM,18,10,8,rain,
2018,Summer,06:00:00 PM,1695,833,862,partly cloudy day,
2018,Summer,12:00:00 AM,93,41,52,partly cloudy night,
2018,Summer,02:00:00 AM,21,12,9,partly cloudy night,
2018,Summer,02:00:00 PM,1912,893,1019,cloudy,
2018,Summer,07:00:00 AM,246,158,88,clear day,
2018,Summer,04:00:00 PM,2118,1056,1062,partly cloudy day,
2018,Summer,03:00:00 AM,20,12,8,partly cloudy night,
2018,Summer,07:00:00 PM,1437,791,646,clear day,
2018,Summer,04:00:00 AM,14,11,3,clear night,
2018,Summer,05:00:00 PM,2202,1046,1156,partly cloudy day,
2018,Summer,05:00:00 AM,114,89,25,clear night,
2018,Summer,06:00:00 PM,1812,1067,745,partly cloudy day,
2018,Summer,05:00:00 PM,1444,697,747,rain,
2018,Summer,04:00:00 AM,6,3,3,clear night,
2018,Summer,03:00:00 AM,4,3,1,partly cloudy night,
2018,Summer,01:00:00 PM,1727,732,995,clear day,
2018,Summer,11:00:00 PM,187,130,57,cloudy,
2018,Summer,02:00:00 PM,2091,1106,985,clear day,
2018,Summer,02:00:00 PM,2698,1177,1521,clear day,
2018,Summer,04:00:00 AM,6,3,3,clear night,
2018,Summer,03:00:00 AM,6,5,1,clear night,
2018,Summer,06:00:00 AM,145,57,88,clear day,
2018,Summer,07:00:00 PM,1493,714,779,cloudy,
2018,Summer,04:00:00 AM,7,2,5,rain,
2018,Summer,11:00:00 AM,2514,1413,1101,clear day,
2018,Summer,11:00:00 AM,1671,810,861,clear day,
2018,Summer,11:00:00 AM,1501,762,739,partly cloudy day,
2018,Summer,02:00:00 PM,2360,1098,1262,clear day,
2018,Summer,09:00:00 AM,664,338,326,clear day,
2018,Summer,07:00:00 AM,223,87,136,clear day,
2018,Summer,03:00:00 PM,1396,686,710,partly cloudy day,
2018,Summer,02:00:00 AM,7,6,1,clear night,
2018,Summer,12:00:00 PM,2053,956,1097,partly cloudy day,
2018,Summer,07:00:00 PM,1968,988,980,clear day,
2018,Summer,02:00:00 AM,38,14,24,clear night,
2018,Summer,09:00:00 PM,821,280,541,clear night,
2018,Summer,06:00:00 AM,202,100,102,partly cloudy day,
2018,Summer,07:00:00 PM,939,498,441,cloudy,
2018,Summer,12:00:00 PM,1915,903,1012,partly cloudy day,
2018,Summer,07:00:00 PM,1251,1251,0,partly cloudy day,Independence Day
2018,Summer,12:00:00 PM,1640,843,797,clear day,
2018,Summer,07:00:00 PM,2241,1155,1086,clear day,
2018,Summer,09:00:00 PM,1325,485,840,clear night,
2018,Summer,11:00:00 PM,234,94,140,clear night,
2018,Summer,06:00:00 AM,117,60,57,clear day,
2018,Summer,08:00:00 AM,413,172,241,clear day,
2018,Summer,07:00:00 PM,1929,930,999,clear day,
2018,Summer,09:00:00 AM,378,205,173,cloudy,
2018,Summer,10:00:00 PM,520,165,355,clear night,
2018,Summer,06:00:00 PM,1844,1115,729,partly cloudy day,
2018,Summer,09:00:00 AM,900,518,382,clear day,
2018,Summer,07:00:00 AM,262,117,145,clear day,
2018,Summer,03:00:00 PM,1366,631,735,clear day,
2018,Summer,08:00:00 PM,525,244,281,cloudy,
2018,Summer,04:00:00 PM,1434,702,732,partly cloudy day,
2018,Summer,04:00:00 AM,13,7,6,partly cloudy night,Independence Day
2018,Summer,06:00:00 AM,154,74,80,clear day,
2018,Summer,12:00:00 PM,1892,899,993,partly cloudy day,
2018,Summer,11:00:00 PM,103,52,51,cloudy,
2018,Summer,09:00:00 AM,267,172,95,partly cloudy day,
2018,Summer,07:00:00 PM,1842,1070,772,clear day,
2018,Summer,09:00:00 AM,684,361,323,partly cloudy day,
2018,Summer,04:00:00 PM,2562,1146,1416,partly cloudy day,
2018,Summer,02:00:00 PM,2843,1265,1578,clear day,
2018,Summer,03:00:00 PM,2679,1272,1407,partly cloudy day,
2018,Summer,01:00:00 PM,2851,1281,1570,clear day,
2018,Summer,07:00:00 PM,924,326,598,partly cloudy day,
2018,Summer,02:00:00 AM,13,8,5,partly cloudy night,
2018,Summer,08:00:00 AM,417,126,291,clear day,
2018,Summer,11:00:00 PM,139,52,87,clear night,
2018,Summer,06:00:00 PM,1695,921,774,partly cloudy day,
2018,Summer,01:00:00 PM,2111,907,1204,partly cloudy day,
2018,Summer,12:00:00 AM,261,164,97,clear night,Father's Day
2018,Summer,06:00:00 AM,233,104,129,clear day,
2018,Summer,06:00:00 PM,1486,707,779,clear day,
2018,Summer,08:00:00 AM,434,248,186,partly cloudy day,
2018,Summer,05:00:00 PM,2091,1058,1033,partly cloudy day,
2018,Summer,08:00:00 PM,2262,888,1374,partly cloudy day,
2018,Summer,12:00:00 PM,2230,1091,1139,partly cloudy day,
2018,Summer,01:00:00 AM,23,15,8,partly cloudy night,
2018,Summer,05:00:00 AM,38,32,6,clear night,Independence Day
2018,Summer,07:00:00 AM,309,128,181,partly cloudy day,
2018,Summer,11:00:00 AM,1280,652,628,partly cloudy day,
2018,Summer,10:00:00 PM,685,289,396,clear night,Father's Day
2018,Summer,03:00:00 AM,10,4,6,clear night,
2018,Summer,11:00:00 AM,2134,1127,1007,partly cloudy day,
2018,Summer,12:00:00 PM,2537,1242,1295,partly cloudy day,
2018,Summer,11:00:00 PM,195,76,119,clear night,
2018,Summer,12:00:00 AM,104,57,47,clear night,
2018,Summer,12:00:00 AM,33,10,23,cloudy,
2018,Summer,11:00:00 AM,1289,616,673,clear day,
2018,Summer,10:00:00 PM,488,202,286,clear night,
2018,Summer,02:00:00 AM,35,15,20,cloudy,
2018,Summer,04:00:00 PM,1967,935,1032,partly cloudy day,
2018,Summer,12:00:00 AM,180,69,111,partly cloudy night,
2018,Summer,11:00:00 AM,983,503,480,clear day,
2018,Summer,07:00:00 AM,259,109,150,clear day,
2018,Summer,07:00:00 PM,1594,790,804,partly cloudy day,
2018,Summer,12:00:00 PM,1813,814,999,partly cloudy day,
2018,Summer,07:00:00 PM,1285,808,477,clear day,
2018,Summer,08:00:00 PM,2545,976,1569,clear day,
2018,Summer,10:00:00 PM,386,170,216,clear night,
2018,Summer,02:00:00 PM,1782,862,920,partly cloudy day,
2018,Summer,06:00:00 AM,142,65,77,partly cloudy day,
2018,Summer,03:00:00 AM,11,6,5,clear night,
2018,Summer,09:00:00 PM,1522,539,983,partly cloudy night,
2018,Summer,11:00:00 PM,217,74,143,clear night,
2018,Summer,04:00:00 AM,9,4,5,partly cloudy night,
2018,Summer,11:00:00 PM,203,123,80,partly cloudy night,
2018,Summer,10:00:00 PM,583,284,299,partly cloudy night,
2018,Summer,03:00:00 PM,2154,929,1225,clear day,
2018,Summer,03:00:00 PM,2477,1026,1451,cloudy,
2018,Summer,11:00:00 PM,129,70,59,cloudy,
2018,Summer,10:00:00 AM,1712,1007,705,partly cloudy day,
2018,Summer,01:00:00 PM,1610,721,889,partly cloudy day,
2018,Summer,06:00:00 PM,2054,1027,1027,clear day,
2018,Summer,11:00:00 AM,3830,3657,173,clear day,
2018,Summer,01:00:00 PM,2063,902,1161,partly cloudy day,
2018,Summer,08:00:00 PM,861,861,0,clear day,
2018,Summer,05:00:00 PM,1865,1121,744,clear day,
2018,Summer,10:00:00 PM,667,285,382,clear night,
2018,Summer,11:00:00 AM,1166,600,566,partly cloudy day,
2018,Summer,11:00:00 PM,161,88,73,clear night,
2018,Summer,10:00:00 PM,430,158,272,clear night,
2018,Summer,05:00:00 AM,49,32,17,clear night,
2018,Summer,08:00:00 AM,340,141,199,clear day,
2018,Summer,02:00:00 PM,2008,867,1141,partly cloudy day,
2018,Summer,02:00:00 PM,1485,679,806,cloudy,
2018,Summer,10:00:00 PM,517,177,340,clear night,
2018,Summer,03:00:00 PM,1264,570,694,clear day,
2018,Summer,06:00:00 AM,151,81,70,clear day,
2018,Summer,02:00:00 AM,17,5,12,clear night,
2018,Summer,01:00:00 AM,80,40,40,clear night,
2018,Summer,06:00:00 AM,187,84,103,clear day,
2018,Summer,03:00:00 PM,2727,1434,1293,rain,Independence Day
2018,Summer,08:00:00 PM,231,86,145,cloudy,
2018,Summer,03:00:00 PM,2319,1063,1256,clear day,
2018,Summer,08:00:00 PM,1275,620,655,clear day,
2018,Summer,03:00:00 AM,5,0,5,clear night,
2018,Summer,08:00:00 AM,289,129,160,partly cloudy day,
2018,Summer,03:00:00 AM,17,8,9,partly cloudy night,
2018,Summer,02:00:00 AM,8,4,4,cloudy,
2018,Summer,03:00:00 AM,8,6,2,cloudy,
2018,Summer,06:00:00 PM,2390,1116,1274,partly cloudy day,
2018,Summer,12:00:00 PM,1523,720,803,clear day,
2018,Summer,05:00:00 AM,99,26,73,cloudy,
2018,Summer,07:00:00 PM,1612,928,684,clear day,
2018,Summer,04:00:00 AM,20,11,9,clear night,Father's Day
2018,Summer,08:00:00 AM,381,137,244,clear day,
2018,Summer,01:00:00 PM,2032,933,1099,partly cloudy day,
2018,Summer,05:00:00 PM,1947,1947,0,clear day,
2018,Summer,05:00:00 AM,61,44,17,clear night,
2018,Summer,12:00:00 AM,145,82,63,clear night,Independence Day
2018,Summer,03:00:00 PM,3512,1614,1898,partly cloudy day,
2018,Summer,06:00:00 PM,1809,1068,741,partly cloudy day,
2018,Summer,03:00:00 PM,1892,902,990,clear day,Father's Day
2018,Summer,05:00:00 AM,65,45,20,clear night,
2018,Summer,10:00:00 PM,473,154,319,partly cloudy night,
2018,Summer,07:00:00 AM,305,142,163,partly cloudy day,
2018,Summer,10:00:00 PM,395,395,0,clear night,
2018,Summer,01:00:00 PM,2123,854,1269,partly cloudy day,
2018,Summer,08:00:00 PM,639,214,425,rain,
2018,Summer,02:00:00 PM,1638,765,873,clear day,
2018,Summer,05:00:00 PM,2138,1189,949,partly cloudy day,
2018,Summer,07:00:00 PM,1626,994,632,clear day,
2018,Summer,08:00:00 AM,351,130,221,partly cloudy day,
2018,Summer,02:00:00 PM,1579,722,857,partly cloudy day,
2018,Summer,01:00:00 PM,1195,553,642,clear day,
2018,Summer,05:00:00 AM,33,20,13,cloudy,
2018,Summer,08:00:00 PM,2040,873,1167,partly cloudy day,
2018,Summer,12:00:00 PM,1775,801,974,clear day,
2018,Summer,09:00:00 AM,620,379,241,partly cloudy day,Independence Day
2018,Summer,04:00:00 AM,6,4,2,partly cloudy night,
2018,Summer,05:00:00 PM,2086,1032,1054,clear day,
2018,Summer,07:00:00 AM,211,85,126,partly cloudy day,
2018,Summer,04:00:00 PM,1829,853,976,partly cloudy day,
2018,Summer,03:00:00 AM,7,4,3,partly cloudy night,
2018,Summer,06:00:00 AM,196,88,108,partly cloudy day,
2018,Summer,03:00:00 AM,10,4,6,clear night,
2018,Summer,04:00:00 AM,5,4,1,clear night,
2018,Summer,05:00:00 AM,43,20,23,cloudy,
2018,Summer,07:00:00 PM,1730,848,882,partly cloudy day,
2018,Summer,06:00:00 AM,148,66,82,partly cloudy day,
2018,Summer,02:00:00 AM,15,4,11,clear night,
2018,Summer,08:00:00 PM,1480,664,816,clear day,
2018,Summer,09:00:00 PM,787,254,533,partly cloudy night,
2018,Summer,06:00:00 AM,81,37,44,cloudy,
2018,Summer,04:00:00 PM,2206,1034,1172,partly cloudy day,
2018,Summer,06:00:00 PM,1437,844,593,partly cloudy day,
2018,Summer,11:00:00 PM,172,64,108,partly cloudy night,
2018,Summer,11:00:00 AM,1669,864,805,clear day,
2018,Summer,06:00:00 PM,1635,851,784,clear day,
2018,Summer,11:00:00 PM,67,30,37,cloudy,
2018,Summer,11:00:00 AM,1985,1102,883,clear day,
2018,Summer,03:00:00 AM,14,6,8,clear night,
2018,Summer,06:00:00 AM,51,34,17,cloudy,
2018,Summer,07:00:00 AM,191,191,0,clear day,
2018,Summer,01:00:00 PM,1830,809,1021,partly cloudy day,
2018,Summer,11:00:00 AM,1616,851,765,cloudy,
2018,Summer,06:00:00 AM,141,63,78,partly cloudy day,
2018,Summer,10:00:00 AM,1175,613,562,partly cloudy day,
2018,Summer,09:00:00 PM,687,298,389,partly cloudy night,
2018,Summer,02:00:00 PM,1971,862,1109,clear day,
2018,Summer,09:00:00 AM,571,285,286,partly cloudy day,
2018,Summer,07:00:00 AM,289,114,175,clear day,
2018,Summer,07:00:00 PM,1307,686,621,partly cloudy day,
2018,Summer,01:00:00 PM,1227,503,724,clear day,
2018,Summer,09:00:00 PM,917,332,585,clear night,
2018,Summer,11:00:00 AM,1147,666,481,partly cloudy day,
2018,Summer,02:00:00 AM,13,8,5,clear night,
2018,Summer,07:00:00 AM,271,118,153,clear day,
2018,Summer,10:00:00 PM,463,206,257,partly cloudy night,
2018,Summer,09:00:00 PM,1331,445,886,clear night,
2018,Summer,04:00:00 AM,10,6,4,cloudy,
2018,Summer,06:00:00 PM,1169,581,588,partly cloudy day,
2018,Summer,09:00:00 PM,1003,358,645,clear night,
2018,Summer,10:00:00 PM,145,63,82,cloudy,
2018,Summer,09:00:00 AM,571,254,317,partly cloudy day,
2018,Summer,10:00:00 AM,1007,530,477,clear day,
2018,Summer,12:00:00 PM,1422,602,820,partly cloudy day,
2018,Summer,07:00:00 PM,1547,850,697,clear day,
2018,Summer,07:00:00 PM,1881,909,972,clear day,Father's Day
2018,Summer,02:00:00 PM,2029,796,1233,clear day,
2018,Summer,05:00:00 PM,607,260,347,rain,
2018,Summer,02:00:00 AM,24,14,10,clear night,
2018,Summer,12:00:00 PM,1224,536,688,cloudy,
2018,Summer,03:00:00 AM,3,0,3,rain,
2018,Summer,04:00:00 AM,26,15,11,clear night,
2018,Summer,11:00:00 AM,1292,690,602,cloudy,
2018,Summer,02:00:00 PM,2739,1272,1467,partly cloudy day,
2018,Summer,07:00:00 AM,265,93,172,clear day,
2018,Summer,04:00:00 AM,9,7,2,partly cloudy night,
2018,Summer,07:00:00 AM,259,120,139,clear day,
2018,Summer,07:00:00 PM,879,509,370,partly cloudy day,
2018,Summer,12:00:00 PM,1513,1513,0,partly cloudy day,
2018,Summer,12:00:00 PM,1860,975,885,partly cloudy day,
2018,Summer,07:00:00 PM,1488,806,682,partly cloudy day,
2018,Summer,01:00:00 AM,41,24,17,clear night,
2018,Summer,08:00:00 PM,1610,762,848,clear day,
2018,Summer,03:00:00 AM,11,7,4,cloudy,
2018,Summer,01:00:00 AM,78,31,47,clear night,
2018,Summer,10:00:00 PM,232,113,119,rain,
2018,Summer,12:00:00 PM,3087,1618,1469,clear day,
2018,Summer,08:00:00 AM,308,106,202,partly cloudy day,
2018,Summer,12:00:00 PM,1936,916,1020,clear day,
2018,Summer,11:00:00 PM,171,88,83,clear night,
2018,Summer,07:00:00 PM,1541,868,673,clear day,
2018,Summer,12:00:00 PM,2128,925,1203,partly cloudy day,
2018,Summer,07:00:00 PM,1235,736,499,clear day,
2018,Summer,02:00:00 AM,18,5,13,partly cloudy night,
2018,Summer,06:00:00 AM,35,21,14,rain,
2018,Summer,12:00:00 AM,128,42,86,clear night,
2018,Summer,02:00:00 PM,1117,483,634,partly cloudy day,
2018,Summer,12:00:00 PM,1765,779,986,wind,
2018,Summer,02:00:00 PM,1963,874,1089,partly cloudy day,
2018,Summer,02:00:00 AM,30,22,8,clear night,
2018,Summer,07:00:00 AM,64,32,32,rain,
2018,Summer,07:00:00 AM,228,113,115,clear day,
2018,Summer,12:00:00 AM,151,97,54,clear night,
2018,Summer,11:00:00 AM,1342,617,725,clear day,
2018,Summer,05:00:00 AM,58,33,25,clear night,
2018,Summer,07:00:00 AM,258,108,150,clear day,
2018,Summer,12:00:00 AM,113,43,70,clear night,
2018,Summer,07:00:00 AM,302,139,163,clear day,
2018,Summer,07:00:00 PM,1401,721,680,partly cloudy day,
2018,Summer,05:00:00 PM,339,182,157,rain,
2018,Summer,10:00:00 PM,407,173,234,partly cloudy night,
2018,Summer,09:00:00 PM,1019,320,699,clear night,
2018,Summer,03:00:00 AM,11,8,3,partly cloudy night,
2018,Summer,03:00:00 PM,2773,1190,1583,clear day,
2018,Summer,06:00:00 AM,95,41,54,clear day,
2018,Summer,04:00:00 PM,1810,684,1126,rain,
2018,Summer,03:00:00 PM,2918,1319,1599,clear day,
2018,Summer,04:00:00 PM,2048,965,1083,partly cloudy day,
2018,Summer,03:00:00 PM,1864,806,1058,cloudy,
2018,Summer,04:00:00 PM,2080,1060,1020,clear day,
2018,Summer,07:00:00 AM,215,119,96,partly cloudy day,
2018,Summer,11:00:00 PM,449,449,0,partly cloudy night,Independence Day
2018,Summer,03:00:00 AM,19,11,8,clear night,
2018,Summer,02:00:00 PM,1465,597,868,clear day,
2018,Summer,11:00:00 PM,191,127,64,cloudy,
2018,Summer,11:00:00 AM,1183,621,562,clear day,
2018,Summer,05:00:00 PM,2222,1116,1106,partly cloudy day,
2018,Summer,04:00:00 AM,9,7,2,cloudy,
2018,Summer,04:00:00 AM,3,2,1,partly cloudy night,
2018,Summer,03:00:00 AM,23,14,9,clear night,
2018,Summer,08:00:00 AM,291,148,143,partly cloudy day,Independence Day
2018,Summer,05:00:00 PM,2104,1087,1017,partly cloudy day,
2018,Summer,03:00:00 AM,4,0,4,clear night,
2018,Summer,03:00:00 AM,17,12,5,clear night,
2018,Summer,03:00:00 PM,2328,978,1350,clear day,
2018,Summer,02:00:00 PM,1486,628,858,partly cloudy day,
2018,Summer,10:00:00 AM,1753,1125,628,partly cloudy day,
2018,Summer,08:00:00 PM,1896,753,1143,clear day,
2018,Summer,02:00:00 PM,2226,969,1257,partly cloudy day,
2018,Summer,08:00:00 PM,579,241,338,cloudy,
2018,Summer,04:00:00 PM,324,127,197,rain,
2018,Summer,03:00:00 PM,2735,1291,1444,partly cloudy day,
2018,Summer,04:00:00 PM,3024,1456,1568,partly cloudy day,
2018,Summer,12:00:00 AM,166,82,84,clear night,
2018,Summer,03:00:00 PM,1427,730,697,partly cloudy day,
2018,Summer,01:00:00 PM,3028,1468,1560,partly cloudy day,
2018,Summer,09:00:00 AM,484,260,224,clear day,
2018,Summer,03:00:00 PM,3012,1329,1683,partly cloudy day,
2018,Summer,01:00:00 AM,67,33,34,clear night,Independence Day
2018,Summer,07:00:00 PM,1655,971,684,clear day,
2018,Summer,08:00:00 PM,1620,743,877,clear day,
2018,Summer,04:00:00 PM,2149,2149,0,partly cloudy day,
2018,Summer,04:00:00 AM,16,9,7,partly cloudy night,
2018,Summer,04:00:00 AM,13,9,4,partly cloudy night,
2018,Summer,06:00:00 PM,1932,1097,835,partly cloudy day,
2018,Summer,02:00:00 PM,1059,511,548,cloudy,
2018,Summer,10:00:00 PM,29,18,11,rain,
2018,Summer,09:00:00 AM,831,469,362,partly cloudy day,
2018,Summer,06:00:00 AM,98,65,33,cloudy,
2018,Summer,02:00:00 AM,5,4,1,partly cloudy night,
2018,Summer,04:00:00 PM,1781,867,914,clear day,
2018,Summer,03:00:00 AM,8,4,4,partly cloudy night,
2018,Summer,06:00:00 PM,971,581,390,partly cloudy day,
2018,Summer,06:00:00 AM,214,100,114,clear day,
2018,Summer,07:00:00 PM,1558,905,653,clear day,
2018,Summer,06:00:00 AM,133,67,66,clear day,Father's Day
2018,Summer,08:00:00 PM,1911,778,1133,clear day,
2018,Summer,05:00:00 AM,56,33,23,clear night,
2018,Summer,03:00:00 PM,1616,839,777,clear day,
2018,Summer,07:00:00 AM,263,109,154,clear day,
2018,Summer,11:00:00 PM,421,265,156,clear night,
2018,Summer,10:00:00 PM,637,318,319,clear night,
2018,Summer,06:00:00 AM,36,22,14,rain,
2018,Summer,01:00:00 AM,20,11,9,rain,
2018,Summer,11:00:00 AM,984,537,447,cloudy,
2018,Summer,11:00:00 PM,192,67,125,partly cloudy night,
2018,Summer,08:00:00 PM,1098,514,584,clear day,
2018,Summer,03:00:00 PM,2189,1117,1072,partly cloudy day,
2018,Summer,10:00:00 AM,617,398,219,cloudy,
2018,Summer,04:00:00 AM,11,5,6,partly cloudy night,
2018,Summer,02:00:00 PM,2386,1148,1238,partly cloudy day,
2018,Summer,11:00:00 AM,1784,902,882,clear day,Father's Day
2018,Summer,10:00:00 PM,432,195,237,clear night,
2018,Summer,02:00:00 PM,2509,1050,1459,partly cloudy day,
2018,Summer,06:00:00 AM,39,14,25,rain,
2018,Summer,07:00:00 AM,260,117,143,partly cloudy day,
2018,Summer,06:00:00 PM,1775,857,918,partly cloudy day,
2018,Summer,01:00:00 PM,2404,2071,333,clear day,
2018,Summer,06:00:00 PM,1232,561,671,partly cloudy day,
2018,Summer,03:00:00 AM,1,0,1,rain,
2018,Summer,07:00:00 AM,291,124,167,clear day,
2018,Summer,05:00:00 AM,36,30,6,partly cloudy night,
2018,Summer,09:00:00 AM,612,294,318,clear day,
2018,Summer,10:00:00 AM,871,467,404,clear day,
2018,Summer,07:00:00 AM,273,124,149,clear day,
2018,Summer,08:00:00 PM,1017,439,578,cloudy,
2018,Summer,11:00:00 AM,872,469,403,partly cloudy day,
2018,Summer,11:00:00 PM,284,137,147,clear night,
2018,Summer,04:00:00 AM,10,3,7,clear night,
2018,Summer,12:00:00 AM,53,26,27,partly cloudy night,
2018,Summer,10:00:00 PM,429,155,274,clear night,
2018,Summer,09:00:00 AM,664,368,296,cloudy,
2018,Summer,08:00:00 PM,925,925,0,partly cloudy day,Independence Day
2018,Summer,10:00:00 PM,370,370,0,partly cloudy night,
2018,Summer,01:00:00 AM,27,12,15,partly cloudy night,
2018,Summer,08:00:00 AM,381,151,230,partly cloudy day,
2018,Summer,10:00:00 AM,958,631,327,partly cloudy day,
2018,Summer,09:00:00 PM,902,239,663,partly cloudy night,
2018,Summer,08:00:00 PM,1727,705,1022,clear day,
2018,Summer,11:00:00 AM,1966,1012,954,partly cloudy day,
2018,Summer,12:00:00 AM,295,162,133,clear night,
2018,Summer,05:00:00 PM,2810,1330,1480,partly cloudy day,
2018,Summer,07:00:00 PM,1336,759,577,partly cloudy day,
2018,Summer,12:00:00 AM,75,36,39,partly cloudy night,
2018,Summer,03:00:00 AM,3,1,2,partly cloudy night,
2018,Summer,08:00:00 AM,370,223,147,clear day,
2018,Summer,08:00:00 PM,974,974,0,clear day,
2018,Summer,03:00:00 AM,39,16,23,clear night,
2018,Summer,03:00:00 PM,2072,943,1129,partly cloudy day,
2018,Summer,12:00:00 PM,3445,3307,138,clear day,
2018,Summer,05:00:00 AM,64,36,28,partly cloudy night,
2018,Summer,02:00:00 PM,1887,944,943,clear day,
2018,Summer,12:00:00 AM,65,32,33,partly cloudy night,
2018,Summer,07:00:00 PM,1129,559,570,rain,
2018,Summer,02:00:00 AM,4,2,2,rain,
2018,Summer,05:00:00 AM,64,34,30,partly cloudy night,
2018,Summer,12:00:00 PM,1317,576,741,partly cloudy day,
2018,Summer,07:00:00 AM,275,112,163,partly cloudy day,
2018,Summer,10:00:00 AM,1224,664,560,cloudy,
2018,Summer,02:00:00 PM,1316,610,706,partly cloudy day,
2018,Summer,06:00:00 PM,1111,641,470,cloudy,
2018,Summer,03:00:00 PM,2009,907,1102,clear day,
2018,Summer,02:00:00 PM,1544,719,825,partly cloudy day,
2018,Summer,09:00:00 AM,715,382,333,clear day,
2018,Summer,02:00:00 AM,11,8,3,partly cloudy night,
2018,Summer,10:00:00 AM,973,489,484,clear day,
2018,Summer,03:00:00 AM,12,3,9,clear night,
2018,Summer,07:00:00 AM,168,68,100,cloudy,
2018,Summer,08:00:00 AM,402,159,243,clear day,
2018,Summer,02:00:00 AM,52,29,23,clear night,
2018,Summer,10:00:00 AM,937,444,493,partly cloudy day,
2018,Summer,03:00:00 PM,2421,1142,1279,partly cloudy day,
2018,Summer,09:00:00 PM,892,467,425,cloudy,
2018,Summer,01:00:00 PM,1971,856,1115,clear day,
2018,Summer,01:00:00 AM,23,12,11,cloudy,
2018,Summer,03:00:00 PM,3539,1640,1899,clear day,
2018,Summer,03:00:00 AM,9,4,5,clear night,
2018,Summer,12:00:00 AM,93,45,48,clear night,
2018,Summer,05:00:00 AM,76,42,34,partly cloudy night,
2018,Summer,06:00:00 AM,81,31,50,partly cloudy day,
2018,Summer,02:00:00 AM,12,11,1,clear night,
2018,Summer,11:00:00 PM,427,197,230,partly cloudy night,
2018,Summer,11:00:00 AM,1985,1008,977,partly cloudy day,
2018,Summer,02:00:00 PM,2038,877,1161,partly cloudy day,
2018,Summer,04:00:00 PM,1893,964,929,clear day,
2018,Summer,06:00:00 PM,1875,840,1035,partly cloudy day,
2018,Summer,06:00:00 PM,1765,871,894,clear day,Father's Day
2018,Summer,06:00:00 PM,2164,1145,1019,partly cloudy day,
2018,Summer,09:00:00 PM,1034,301,733,clear night,
2018,Summer,04:00:00 AM,10,3,7,clear night,
2018,Summer,05:00:00 PM,1981,1014,967,clear day,
2018,Summer,02:00:00 PM,1473,693,780,partly cloudy day,
2018,Summer,04:00:00 PM,2448,1096,1352,cloudy,
2018,Summer,10:00:00 AM,871,477,394,partly cloudy day,
2018,Summer,07:00:00 PM,816,816,0,partly cloudy day,
2018,Summer,03:00:00 AM,15,9,6,clear night,
2018,Summer,03:00:00 PM,1673,691,982,partly cloudy day,
2018,Summer,05:00:00 PM,2047,916,1131,clear day,
2018,Summer,08:00:00 AM,369,124,245,partly cloudy day,
2018,Summer,09:00:00 PM,998,394,604,clear night,
2018,Summer,06:00:00 AM,147,72,75,clear day,
2018,Summer,11:00:00 AM,2115,1196,919,clear day,
2018,Summer,12:00:00 PM,2188,1010,1178,partly cloudy day,
2018,Summer,04:00:00 AM,3,2,1,clear night,
2018,Summer,01:00:00 PM,1235,536,699,rain,
2018,Summer,04:00:00 AM,11,6,5,clear night,
2018,Summer,12:00:00 AM,82,34,48,clear night,
2018,Summer,12:00:00 PM,2568,1231,1337,partly cloudy day,
2018,Summer,11:00:00 PM,346,202,144,clear night,
2018,Summer,04:00:00 PM,2726,2726,0,partly cloudy day,Independence Day
2018,Summer,09:00:00 PM,922,316,606,clear night,
2018,Summer,12:00:00 PM,1427,705,722,partly cloudy day,
2018,Summer,12:00:00 PM,1680,704,976,partly cloudy day,
2018,Summer,01:00:00 AM,56,16,40,clear night,
2018,Summer,07:00:00 AM,102,59,43,cloudy,
2018,Summer,10:00:00 AM,1368,794,574,clear day,
2018,Summer,04:00:00 PM,2461,1047,1414,clear day,
2018,Summer,07:00:00 AM,151,74,77,cloudy,
2018,Summer,10:00:00 AM,1175,647,528,clear day,
2018,Summer,04:00:00 AM,13,6,7,partly cloudy night,
2018,Summer,07:00:00 PM,1428,855,573,clear day,
2018,Summer,01:00:00 AM,48,25,23,partly cloudy night,
2018,Summer,11:00:00 PM,196,105,91,clear night,
2018,Summer,12:00:00 PM,2430,1197,1233,clear day,
2018,Summer,11:00:00 AM,1374,689,685,partly cloudy day,
2018,Summer,08:00:00 PM,1365,597,768,clear day,
2018,Summer,08:00:00 AM,323,323,0,clear day,
2018,Summer,03:00:00 PM,1929,893,1036,partly cloudy day,
2018,Summer,08:00:00 PM,1568,661,907,clear day,
2018,Summer,08:00:00 AM,535,174,361,clear day,
2018,Summer,01:00:00 PM,2918,1403,1515,partly cloudy day,
2018,Summer,11:00:00 AM,1192,610,582,partly cloudy day,
2018,Summer,12:00:00 PM,1886,931,955,partly cloudy day,
2018,Summer,07:00:00 AM,241,103,138,clear day,
2018,Summer,08:00:00 AM,462,190,272,clear day,
2018,Summer,08:00:00 AM,424,227,197,clear day,
2018,Summer,11:00:00 PM,198,93,105,partly cloudy night,
2018,Summer,12:00:00 PM,2010,1073,937,partly cloudy day,Independence Day
2018,Summer,08:00:00 AM,385,120,265,clear day,
2018,Summer,03:00:00 PM,1669,818,851,clear day,
2018,Summer,08:00:00 AM,418,168,250,clear day,
2018,Summer,08:00:00 PM,935,504,431,partly cloudy day,
2018,Summer,03:00:00 PM,1888,889,999,partly cloudy day,
2018,Summer,06:00:00 PM,1795,1004,791,clear day,
2018,Summer,11:00:00 PM,353,168,185,clear night,Father's Day
2018,Summer,11:00:00 AM,1749,849,900,clear day,
2018,Summer,03:00:00 AM,10,6,4,partly cloudy night,
2018,Summer,07:00:00 AM,270,130,140,partly cloudy day,
2018,Summer,08:00:00 PM,1077,458,619,partly cloudy day,
2018,Summer,10:00:00 PM,265,110,155,cloudy,
2018,Summer,08:00:00 AM,484,175,309,clear day,
2018,Summer,10:00:00 AM,719,393,326,partly cloudy day,
2018,Summer,02:00:00 AM,12,11,1,clear night,
2018,Summer,08:00:00 AM,299,114,185,partly cloudy day,
2018,Summer,10:00:00 PM,412,156,256,clear night,
2018,Summer,01:00:00 AM,67,32,35,cloudy,
2018,Summer,07:00:00 AM,282,116,166,clear day,
2018,Summer,10:00:00 PM,705,244,461,clear night,
2018,Summer,07:00:00 PM,1771,1019,752,clear day,
2018,Summer,04:00:00 AM,28,18,10,clear night,
2018,Summer,09:00:00 AM,610,348,262,clear day,
2018,Summer,09:00:00 PM,393,149,244,cloudy,
2018,Summer,07:00:00 PM,2710,1333,1377,clear day,
2018,Summer,06:00:00 AM,95,43,52,clear day,
2018,Summer,03:00:00 AM,16,11,5,clear night,Father's Day
2018,Summer,02:00:00 AM,26,12,14,cloudy,
2018,Summer,11:00:00 PM,320,167,153,partly cloudy night,
2018,Summer,10:00:00 PM,493,188,305,clear night,
2018,Summer,06:00:00 PM,1674,1010,664,clear day,
2018,Summer,11:00:00 PM,274,101,173,clear night,
2018,Summer,01:00:00 PM,1967,891,1076,clear day,
2018,Summer,02:00:00 PM,2038,897,1141,clear day,Father's Day
2018,Summer,01:00:00 AM,54,23,31,clear night,
2018,Summer,04:00:00 PM,3210,1365,1845,partly cloudy day,
2018,Summer,06:00:00 AM,199,97,102,partly cloudy day,
2018,Summer,11:00:00 PM,276,276,0,partly cloudy night,
2018,Summer,11:00:00 AM,2589,1459,1130,partly cloudy day,
2018,Summer,01:00:00 PM,1851,793,1058,partly cloudy day,
2018,Summer,11:00:00 PM,345,148,197,partly cloudy night,
2018,Summer,08:00:00 PM,1302,591,711,partly cloudy day,
2018,Summer,09:00:00 AM,664,321,343,clear day,
2018,Summer,11:00:00 PM,219,76,143,clear night,
2018,Summer,03:00:00 AM,6,1,5,partly cloudy night,
2018,Summer,11:00:00 AM,1236,670,566,partly cloudy day,
2018,Summer,05:00:00 PM,1623,735,888,rain,
2018,Summer,07:00:00 PM,2124,1063,1061,partly cloudy day,
2018,Summer,08:00:00 PM,1766,761,1005,partly cloudy day,
2018,Summer,03:00:00 AM,4,0,4,clear night,
2018,Summer,11:00:00 PM,300,300,0,clear night,
2018,Summer,04:00:00 PM,1297,652,645,clear day,
2018,Summer,11:00:00 PM,204,67,137,clear night,
2018,Summer,08:00:00 PM,221,93,128,rain,
2018,Summer,06:00:00 PM,1659,957,702,clear day,
2018,Summer,04:00:00 AM,16,11,5,clear night,
2018,Summer,04:00:00 AM,8,4,4,clear night,
2018,Summer,10:00:00 AM,1213,637,576,clear day,
2018,Summer,01:00:00 AM,51,36,15,clear night,
2018,Summer,04:00:00 PM,1750,804,946,cloudy,
2018,Summer,12:00:00 AM,77,39,38,partly cloudy night,
2018,Summer,04:00:00 AM,7,4,3,partly cloudy night,
2018,Summer,06:00:00 AM,192,89,103,clear day,
2018,Summer,04:00:00 PM,2623,1161,1462,clear day,
2018,Summer,06:00:00 PM,2016,1069,947,partly cloudy day,
2018,Summer,12:00:00 AM,57,20,37,cloudy,
